"","unitid","year","semester","quarter","instnm","int_year","after","totcohortsize","w_cohortsize","m_cohortsize","tot4yrgrads","m_4yrgrads","w_4yrgrads","women_gradrate_4yr","total_gradrate_4yr","men_gradrate_4yr","instatetuition","white_cohortsize"
"1",100654,1991,1,0,"ALABAMA A&M UNIVERSITY",NA,NA,1010,527,483,152,32,120,0.228,0.15,0.066,1298,11
"2",100654,1992,1,0,"ALABAMA A&M UNIVERSITY",NA,NA,876,444,432,157,46,111,0.25,0.179,0.106,1600,5
"3",100654,1993,1,0,"ALABAMA A & M UNIVERSITY",NA,NA,1019,543,476,189,55,134,0.247,0.185,0.116,1600,7
"4",100654,1995,1,0,"ALABAMA A & M UNIVERSITY",NA,NA,849,434,415,185,47,138,0.318,0.218,0.113,2022,18
"5",100654,1996,1,0,"ALABAMA A & M UNIVERSITY",NA,NA,716,372,344,147,44,103,0.277,0.205,0.128,2312,17
"6",100654,1997,1,0,"ALABAMA A & M UNIVERSITY",NA,NA,789,412,377,159,41,118,0.286,0.202,0.109,2420,22
"7",100654,1998,1,0,"ALABAMA A & M UNIVERSITY",NA,NA,995,518,477,182,38,144,0.278,0.183,0.08,2332,25
"8",100654,1999,1,0,"ALABAMA A & M UNIVERSITY",NA,NA,1111,550,561,97,16,81,0.147,0.087,0.029,1932,26
"9",100654,2000,1,0,"ALABAMA A & M UNIVERSITY",NA,NA,1020,504,516,118,24,94,0.186,0.116,0.047,2400,26
"10",100654,2001,1,0,"ALABAMA A & M UNIVERSITY",NA,NA,1038,541,497,138,34,104,0.192,0.133,0.068,2400,18
"11",100654,2002,1,0,"ALABAMA A & M UNIVERSITY",NA,NA,1043,506,537,118,37,81,0.16,0.113,0.069,2520,18
"12",100654,2003,1,0,"ALABAMA A & M UNIVERSITY",NA,NA,1287,673,614,112,30,82,0.122,0.087,0.049,2832,17
"13",100654,2004,1,0,"ALABAMA A & M UNIVERSITY",NA,NA,1198,611,587,146,31,115,0.188,0.122,0.053,3120,10
"14",100654,2005,1,0,"Alabama A & M University",NA,NA,1088,572,516,116,27,89,0.156,0.107,0.052,3120,13
"15",100654,2006,1,0,"Alabama A & M University",NA,NA,1133,584,549,110,29,81,0.139,0.097,0.053,3120,12
"16",100654,2007,1,0,"Alabama A & M University",NA,NA,882,475,407,88,21,67,0.141,0.1,0.052,3432,9
"17",100654,2008,1,0,"Alabama A & M University",NA,NA,1044,568,476,115,23,92,0.162,0.11,0.048,3432,7
"18",100654,2009,1,0,"Alabama A & M University",NA,NA,1042,537,505,115,22,93,0.173,0.11,0.044,3948,24
"19",100654,2010,1,0,"Alabama A & M University",NA,NA,1073,549,524,69,18,51,0.093,0.064,0.034,4872,15
"20",100663,1991,0,1,"UNIVERSITY OF ALABAMA AT BIRMINGHAM",2001,0,937,500,437,82,33,49,0.098,0.088,0.076,2050,600
"21",100663,1992,0,1,"UNIVERSITY OF ALABAMA AT BIRMINGHAM",2001,0,898,479,419,54,19,35,0.073,0.06,0.045,2238,576
"22",100663,1993,0,1,"UNIVERSITY OF ALABAMA AT BIRMINGHAM",2001,0,938,518,420,99,31,68,0.131,0.106,0.074,2358,613
"23",100663,1995,0,1,"UNIVERSITY OF ALABAMA AT BIRMINGHAM",2001,0,1052,599,453,128,37,91,0.152,0.122,0.082,2604,602
"24",100663,1996,0,1,"UNIVERSITY OF ALABAMA AT BIRMINGHAM",2001,0,1027,597,430,134,35,99,0.166,0.13,0.081,2700,568
"25",100663,1997,0,1,"UNIVERSITY OF ALABAMA AT BIRMINGHAM",2001,0,1115,657,458,161,52,109,0.166,0.144,0.114,2850,631
"26",100663,1998,0,1,"UNIVERSITY OF ALABAMA AT BIRMINGHAM",2001,0,1076,646,430,164,48,116,0.18,0.152,0.112,3060,611
"27",100663,1999,0,1,"UNIVERSITY OF ALABAMA AT BIRMINGHAM",2001,0,1143,678,465,163,59,104,0.153,0.143,0.127,2730,667
"28",100663,2000,0,1,"UNIVERSITY OF ALABAMA AT BIRMINGHAM",2001,0,1234,748,486,173,51,122,0.163,0.14,0.105,2820,653
"29",100663,2001,1,0,"UNIVERSITY OF ALABAMA AT BIRMINGHAM",2001,1,1224,765,459,175,57,118,0.154,0.143,0.124,2970,648
"30",100663,2002,1,0,"UNIVERSITY OF ALABAMA AT BIRMINGHAM",2001,1,1398,820,578,228,86,142,0.173,0.163,0.149,3150,775
"31",100663,2003,1,0,"UNIVERSITY OF ALABAMA AT BIRMINGHAM",2001,1,1607,1042,565,266,61,205,0.197,0.166,0.108,3480,781
"32",100663,2004,1,0,"UNIVERSITY OF ALABAMA AT BIRMINGHAM",2001,1,1536,973,563,284,82,202,0.208,0.185,0.146,3840,846
"33",100663,2005,1,0,"University of Alabama at Birmingham",2001,1,1515,895,620,350,110,240,0.268,0.231,0.177,3960,875
"34",100663,2006,1,0,"University of Alabama at Birmingham",2001,1,1485,895,590,378,124,254,0.284,0.255,0.21,3960,905
"35",100663,2007,1,0,"University of Alabama at Birmingham",2001,1,1378,807,571,404,137,267,0.331,0.293,0.24,3384,835
"36",100663,2008,1,0,"University of Alabama at Birmingham",2001,1,1246,710,536,406,140,266,0.375,0.326,0.261,3792,790
"37",100663,2009,1,0,"University of Alabama at Birmingham",2001,1,1494,819,675,474,188,286,0.349,0.317,0.279,4224,932
"38",100663,2010,1,0,"University of Alabama at Birmingham",2001,1,1537,851,686,463,176,287,0.337,0.301,0.257,5806,921
"39",100751,1991,1,0,"THE UNIVERSITY OF ALABAMA",NA,NA,2511,1348,1163,630,213,417,0.309,0.251,0.183,1936,2174
"40",100751,1992,1,0,"THE UNIVERSITY OF ALABAMA",NA,NA,2436,1310,1126,684,240,444,0.339,0.281,0.213,2068,2075
"41",100751,1993,1,0,"THE UNIVERSITY OF ALABAMA",NA,NA,2516,1318,1198,638,231,407,0.309,0.254,0.193,2172,2148
"42",100751,1995,1,0,"THE UNIVERSITY OF ALABAMA",NA,NA,2493,1387,1106,748,246,502,0.362,0.3,0.222,2374,2133
"43",100751,1996,1,0,"THE UNIVERSITY OF ALABAMA",NA,NA,2049,1195,854,744,240,504,0.422,0.363,0.281,2470,1777
"44",100751,1997,1,0,"THE UNIVERSITY OF ALABAMA",NA,NA,2572,1403,1169,859,307,552,0.393,0.334,0.263,2594,2111
"45",100751,1998,1,0,"UNIVERSITY OF ALABAMA",NA,NA,2597,1437,1160,857,269,588,0.409,0.33,0.232,2684,2088
"46",100751,1999,1,0,"UNIVERSITY OF ALABAMA",NA,NA,2687,1499,1188,948,309,639,0.426,0.353,0.26,2872,2216
"47",100751,2000,1,0,"UNIVERSITY OF ALABAMA",NA,NA,2886,1653,1233,1038,303,735,0.445,0.36,0.246,3014,2357
"48",100751,2001,1,0,"UNIVERSITY OF ALABAMA",NA,NA,2384,1342,1042,920,313,607,0.452,0.386,0.3,3292,2047
"49",100751,2002,1,0,"UNIVERSITY OF ALABAMA",NA,NA,2585,1441,1144,932,318,614,0.426,0.361,0.278,3556,2230
"50",100751,2003,1,0,"UNIVERSITY OF ALABAMA",NA,NA,2982,1685,1297,1121,364,757,0.449,0.376,0.281,4134,2584
"51",100751,2004,1,0,"THE UNIVERSITY OF ALABAMA",NA,NA,3290,1853,1437,1248,426,822,0.444,0.379,0.296,4630,2873
"52",100751,2005,1,0,"The University of Alabama",NA,NA,3642,2038,1604,1373,491,882,0.433,0.377,0.306,4864,3048
"53",100751,2006,1,0,"The University of Alabama",NA,NA,4275,2377,1898,1757,660,1097,0.462,0.411,0.348,5278,3609
"54",100751,2007,1,0,"The University of Alabama",NA,NA,4438,2461,1977,1897,708,1189,0.483,0.427,0.358,5700,3890
"55",100751,2008,1,0,"The University of Alabama",NA,NA,5009,2776,2233,1942,703,1239,0.446,0.388,0.315,6400,4280
"56",100751,2009,1,0,"The University of Alabama",NA,NA,5062,2746,2316,2093,772,1321,0.481,0.413,0.333,7000,4221
"57",100751,2010,1,0,"The University of Alabama",NA,NA,5443,3006,2437,2387,856,1531,0.509,0.439,0.351,7900,4332
"58",100858,1991,0,1,"AUBURN UNIVERSITY MAIN CAMPUS",2000,0,3024,1496,1528,846,312,534,0.357,0.28,0.204,1596,2704
"59",100858,1992,0,1,"AUBURN UNIVERSITY MAIN CAMPUS",2000,0,3141,1621,1520,927,295,632,0.39,0.295,0.194,1755,2864
"60",100858,1993,0,1,"AUBURN UNIVERSITY MAIN CAMPUS",2000,0,2997,1552,1445,878,286,592,0.381,0.293,0.198,1950,2703
"61",100858,1995,0,1,"AUBURN UNIVERSITY MAIN CAMPUS",2000,0,3486,1832,1654,1106,345,761,0.415,0.317,0.209,2250,3175
"62",100858,1996,0,1,"AUBURN UNIVERSITY MAIN CAMPUS",2000,0,3287,1746,1541,1321,446,875,0.501,0.402,0.289,2355,2985
"63",100858,1997,0,1,"AUBURN UNIVERSITY MAIN CAMPUS",2000,0,3140,1676,1464,1165,385,780,0.465,0.371,0.263,2565,2879
"64",100858,1998,0,1,"AUBURN UNIVERSITY MAIN CAMPUS",2000,0,3654,1913,1741,1229,415,814,0.426,0.336,0.238,2760,3278
"65",100858,1999,0,1,"AUBURN UNIVERSITY MAIN CAMPUS",2000,0,3693,1875,1818,1189,393,796,0.425,0.322,0.216,2895,3253
"66",100858,2000,1,0,"AUBURN UNIVERSITY MAIN CAMPUS",2000,1,3861,1990,1871,1277,451,826,0.415,0.331,0.241,3050,3459
"67",100858,2001,1,0,"AUBURN UNIVERSITY MAIN CAMPUS",2000,1,3739,1949,1790,1284,468,816,0.419,0.343,0.261,3260,3258
"68",100858,2002,1,0,"AUBURN UNIVERSITY MAIN CAMPUS",2000,1,4148,2184,1964,1424,498,926,0.424,0.343,0.254,3650,3596
"69",100858,2003,1,0,"AUBURN UNIVERSITY MAIN CAMPUS",2000,1,3692,1965,1727,1352,444,908,0.462,0.366,0.257,4230,3174
"70",100858,2004,1,0,"AUBURN UNIVERSITY MAIN CAMPUS",2000,1,3579,1849,1730,1279,445,834,0.451,0.357,0.257,4610,3032
"71",100858,2005,1,0,"Auburn University Main Campus",2000,1,4179,2180,1999,1491,511,980,0.45,0.357,0.256,4800,3543
"72",100858,2006,1,0,"Auburn University Main Campus",2000,1,4072,2168,1904,1556,549,1007,0.464,0.382,0.288,5000,3328
"73",100858,2007,1,0,"Auburn University Main Campus",2000,1,4165,2207,1958,1565,548,1017,0.461,0.376,0.28,5250,3414
"74",100858,2008,1,0,"Auburn University Main Campus",2000,1,3967,2049,1918,1676,627,1049,0.512,0.422,0.327,5880,3493
"75",100858,2009,1,0,"Auburn University Main Campus",2000,1,3911,2007,1904,1733,617,1116,0.556,0.443,0.324,6240,3363
"76",100858,2010,1,0,"Auburn University",2000,1,4193,2204,1989,1963,730,1233,0.559,0.468,0.367,7008,3523
"77",101435,1991,1,0,"HUNTINGDON COLLEGE",NA,NA,189,101,88,60,25,35,0.346,0.317,0.284,6400,158
"78",101435,1992,1,0,"HUNTINGDON COLLEGE",NA,NA,166,91,75,53,14,39,0.429,0.319,0.187,7140,135
"79",101435,1993,1,0,"HUNTINGDON COLLEGE",NA,NA,125,80,45,40,7,33,0.413,0.32,0.156,7540,107
"80",101435,1995,1,0,"HUNTINGDON COLLEGE",NA,NA,160,106,54,56,17,39,0.368,0.35,0.315,8645,146
"81",101435,1996,1,0,"HUNTINGDON COLLEGE",NA,NA,165,95,70,62,16,46,0.484,0.376,0.229,10140,140
"82",101435,1997,1,0,"HUNTINGDON COLLEGE",NA,NA,191,114,77,89,28,61,0.535,0.466,0.364,10600,177
"83",101435,1998,1,0,"HUNTINGDON COLLEGE",NA,NA,175,96,79,88,31,57,0.594,0.503,0.392,11010,158
"84",101435,1999,1,0,"HUNTINGDON COLLEGE",NA,NA,163,103,60,58,14,44,0.427,0.356,0.233,10500,144
"85",101435,2000,1,0,"HUNTINGDON COLLEGE",NA,NA,151,95,56,67,21,46,0.484,0.444,0.375,11000,134
"86",101435,2001,1,0,"HUNTINGDON COLLEGE",NA,NA,146,96,50,58,13,45,0.469,0.397,0.26,11500,128
"87",101435,2002,1,0,"HUNTINGDON COLLEGE",NA,NA,165,108,57,76,21,55,0.509,0.461,0.368,13800,146
"88",101435,2003,1,0,"HUNTINGDON COLLEGE",NA,NA,203,76,127,72,30,42,0.553,0.355,0.236,14560,171
"89",101435,2004,1,0,"HUNTINGDON COLLEGE",NA,NA,192,72,120,71,38,33,0.458,0.37,0.317,15250,160
"90",101435,2005,1,0,"Huntingdon College",NA,NA,185,90,95,78,34,44,0.489,0.422,0.358,15250,159
"91",101435,2006,1,0,"Huntingdon College",NA,NA,214,85,129,72,36,36,0.424,0.336,0.279,15990,172
"92",101435,2007,1,0,"Huntingdon College",NA,NA,257,117,140,78,23,55,0.47,0.304,0.164,17570,201
"93",101435,2008,1,0,"Huntingdon College",NA,NA,253,106,147,76,28,48,0.453,0.3,0.19,19320,196
"94",101435,2009,1,0,"Huntingdon College",NA,NA,237,99,138,58,30,28,0.283,0.245,0.217,19990,169
"95",101435,2010,1,0,"Huntingdon College",NA,NA,271,113,158,71,30,41,0.363,0.262,0.19,18512,184
"96",101480,1991,1,0,"JACKSONVILLE STATE UNIVERSITY",NA,NA,1100,567,533,109,42,67,0.118,0.099,0.079,1420,829
"97",101480,1992,1,0,"JACKSONVILLE STATE UNIVERSITY",NA,NA,1106,615,491,116,34,82,0.133,0.105,0.069,1550,847
"98",101480,1993,1,0,"JACKSONVILLE STATE UNIVERSITY",NA,NA,845,436,409,89,24,65,0.149,0.105,0.059,1680,648
"99",101480,1995,1,0,"JACKSONVILLE STATE UNIVERSITY",NA,NA,798,435,363,136,36,100,0.23,0.17,0.099,1840,618
"100",101480,1996,1,0,"JACKSONVILLE STATE UNIVERSITY",NA,NA,817,446,371,122,23,99,0.222,0.149,0.062,1940,613
"101",101480,1997,1,0,"JACKSONVILLE STATE UNIVERSITY",NA,NA,764,401,363,123,43,80,0.2,0.161,0.118,2040,582
"102",101480,1998,1,0,"JACKSONVILLE STATE UNIVERSITY",NA,NA,752,392,360,112,34,78,0.199,0.149,0.094,2140,573
"103",101480,1999,1,0,"JACKSONVILLE STATE UNIVERSITY",NA,NA,805,455,350,142,44,98,0.215,0.176,0.126,2440,592
"104",101480,2000,1,0,"JACKSONVILLE STATE UNIVERSITY",NA,NA,850,443,407,127,39,88,0.199,0.149,0.096,2640,587
"105",101480,2001,1,0,"JACKSONVILLE STATE UNIVERSITY",NA,NA,877,480,397,146,40,106,0.221,0.166,0.101,2940,569
"106",101480,2002,1,0,"JACKSONVILLE STATE UNIVERSITY",NA,NA,1059,567,492,146,41,105,0.185,0.138,0.083,3240,748
"107",101480,2003,1,0,"JACKSONVILLE STATE UNIVERSITY",NA,NA,1044,561,483,139,45,94,0.168,0.133,0.093,3540,686
"108",101480,2004,1,0,"JACKSONVILLE STATE UNIVERSITY",NA,NA,1017,555,462,91,20,71,0.128,0.089,0.043,4040,657
"109",101480,2005,1,0,"Jacksonville State University",NA,NA,1120,595,525,120,37,83,0.139,0.107,0.07,4040,673
"110",101480,2006,1,0,"Jacksonville State University",NA,NA,1106,626,480,106,23,83,0.133,0.096,0.048,4056,631
"111",101480,2007,1,0,"Jacksonville State University",NA,NA,1252,696,556,127,44,83,0.119,0.101,0.079,4056,633
"112",101480,2008,1,0,"Jacksonville State University",NA,NA,1243,663,580,108,31,77,0.116,0.087,0.053,4560,693
"113",101480,2009,1,0,"Jacksonville State University",NA,NA,1220,695,525,137,30,107,0.154,0.112,0.057,5970,649
"114",101480,2010,1,0,"Jacksonville State University",NA,NA,1246,685,561,180,55,125,0.182,0.144,0.098,6780,755
"115",101675,1991,1,0,"MILES COLLEGE",NA,NA,365,144,221,73,41,32,0.222,0.2,0.186,3760,0
"116",101675,1992,1,0,"MILES COLLEGE",NA,NA,226,108,118,107,52,55,0.509,0.473,0.441,3800,2
"117",101675,1993,1,0,"MILES COLLEGE",NA,NA,331,164,167,162,67,95,0.579,0.489,0.401,3800,2
"118",101675,1995,1,0,"MILES COLLEGE",NA,NA,229,114,115,120,50,70,0.614,0.524,0.435,4350,0
"119",101675,1996,1,0,"MILES COLLEGE",NA,NA,327,146,181,125,58,67,0.459,0.382,0.32,4500,0
"120",101675,1997,1,0,"MILES COLLEGE",NA,NA,374,169,205,3,2,1,0.006,0.008,0.01,4500,0
"121",101675,1998,1,0,"MILES COLLEGE",NA,NA,340,177,163,133,51,82,0.463,0.391,0.313,4500,2
"122",101675,1999,1,0,"MILES COLLEGE",NA,NA,319,170,149,113,21,92,0.541,0.354,0.141,4280,1
"123",101675,2000,1,0,"MILES COLLEGE",NA,NA,425,220,205,85,19,66,0.3,0.2,0.093,4408,0
"124",101675,2001,1,0,"MILES COLLEGE",NA,NA,423,213,210,29,9,20,0.094,0.069,0.043,4408,4
"125",101675,2002,1,0,"MILES COLLEGE",NA,NA,391,195,196,24,7,17,0.087,0.061,0.036,4628,1
"126",101675,2003,1,0,"MILES COLLEGE",NA,NA,347,179,168,24,6,18,0.101,0.069,0.036,5090,0
"127",101675,2004,1,0,"MILES COLLEGE",NA,NA,427,203,224,49,9,40,0.197,0.115,0.04,5250,2
"128",101675,2005,1,0,"Miles College",NA,NA,389,177,212,25,4,21,0.119,0.064,0.019,5408,1
"129",101675,2006,1,0,"Miles College",NA,NA,352,159,193,15,3,12,0.076,0.043,0.016,5950,3
"130",101675,2007,1,0,"Miles College",NA,NA,486,246,240,29,7,22,0.089,0.06,0.029,6545,10
"131",101675,2008,1,0,"Miles College",NA,NA,461,213,248,38,5,33,0.155,0.082,0.02,7396,7
"132",101675,2009,1,0,"Miles College",NA,NA,392,179,213,21,4,17,0.095,0.054,0.019,8506,3
"133",101675,2010,1,0,"Miles College",NA,NA,343,141,202,44,18,26,0.184,0.128,0.089,9186,2
"134",101879,1991,1,0,"UNIVERSITY OF NORTH ALABAMA",NA,NA,755,387,368,66,23,43,0.111,0.087,0.062,1296,664
"135",101879,1992,1,0,"UNIVERSITY OF NORTH ALABAMA",NA,NA,554,321,233,74,24,50,0.156,0.134,0.103,1460,490
"136",101879,1993,1,0,"UNIVERSITY OF NORTH ALABAMA",NA,NA,651,371,280,83,16,67,0.181,0.127,0.057,1586,567
"137",101879,1995,1,0,"UNIVERSITY OF NORTH ALABAMA",NA,NA,762,444,318,167,44,123,0.277,0.219,0.138,1910,638
"138",101879,1996,1,0,"UNIVERSITY OF NORTH ALABAMA",NA,NA,790,459,331,99,28,71,0.155,0.125,0.085,1998,650
"139",101879,1997,1,0,"UNIVERSITY OF NORTH ALABAMA",NA,NA,751,448,303,111,20,91,0.203,0.148,0.066,2166,648
"140",101879,1998,1,0,"UNIVERSITY OF NORTH ALABAMA",NA,NA,828,490,338,118,28,90,0.184,0.143,0.083,2256,648
"141",101879,1999,1,0,"UNIVERSITY OF NORTH ALABAMA",NA,NA,809,473,336,127,28,99,0.209,0.157,0.083,2232,650
"142",101879,2000,1,0,"UNIVERSITY OF NORTH ALABAMA",NA,NA,824,481,343,143,35,108,0.224,0.174,0.102,2328,677
"143",101879,2001,1,0,"UNIVERSITY OF NORTH ALABAMA",NA,NA,816,465,351,147,36,111,0.239,0.18,0.103,2544,636
"144",101879,2002,1,0,"UNIVERSITY OF NORTH ALABAMA",NA,NA,786,457,329,104,27,77,0.168,0.132,0.082,2784,586
"145",101879,2003,1,0,"UNIVERSITY OF NORTH ALABAMA",NA,NA,789,479,310,142,37,105,0.219,0.18,0.119,3048,597
"146",101879,2004,1,0,"UNIVERSITY OF NORTH ALABAMA",NA,NA,856,469,387,107,27,80,0.171,0.125,0.07,3336,668
"147",101879,2005,1,0,"University of North Alabama",NA,NA,982,526,456,2,1,1,0.002,0.002,0.002,3432,678
"148",101879,2006,1,0,"University of North Alabama",NA,NA,1019,575,444,112,26,86,0.15,0.11,0.059,3528,622
"149",101879,2007,1,0,"University of North Alabama",NA,NA,1023,558,465,126,31,95,0.17,0.123,0.067,3288,654
"150",101879,2008,1,0,"University of North Alabama",NA,NA,988,533,455,119,34,85,0.16,0.12,0.075,4590,639
"151",101879,2009,1,0,"University of North Alabama",NA,NA,1064,597,467,122,33,89,0.149,0.115,0.071,4008,775
"152",101879,2010,1,0,"University of North Alabama",NA,NA,961,562,399,152,43,109,0.194,0.158,0.108,4440,744
"153",102049,1991,1,0,"SAMFORD UNIVERSITY",NA,NA,569,337,232,217,89,128,0.38,0.381,0.384,6540,536
"154",102049,1992,1,0,"SAMFORD UNIVERSITY",NA,NA,662,405,257,295,108,187,0.462,0.446,0.42,7064,621
"155",102049,1993,1,0,"SAMFORD UNIVERSITY",NA,NA,680,438,242,318,117,201,0.459,0.468,0.483,7770,648
"156",102049,1995,1,0,"SAMFORD UNIVERSITY",NA,NA,647,399,248,331,118,213,0.534,0.512,0.476,8648,617
"157",102049,1996,1,0,"SAMFORD UNIVERSITY",NA,NA,646,388,258,329,117,212,0.546,0.509,0.453,9070,606
"158",102049,1997,1,0,"SAMFORD UNIVERSITY",NA,NA,745,470,275,405,139,266,0.566,0.544,0.505,9432,708
"159",102049,1998,1,0,"SAMFORD UNIVERSITY",NA,NA,625,390,235,316,110,206,0.528,0.506,0.468,9904,594
"160",102049,1999,1,0,"SAMFORD UNIVERSITY",NA,NA,674,420,254,353,120,233,0.555,0.524,0.472,10300,627
"161",102049,2000,1,0,"SAMFORD UNIVERSITY",NA,NA,657,427,230,359,122,237,0.555,0.546,0.53,10738,607
"162",102049,2001,1,0,"SAMFORD UNIVERSITY",NA,NA,658,434,224,354,109,245,0.565,0.538,0.487,11490,597
"163",102049,2002,1,0,"SAMFORD UNIVERSITY",NA,NA,652,428,224,5,0,5,0.012,0.008,0,12294,618
"164",102049,2003,1,0,"SAMFORD UNIVERSITY",NA,NA,682,426,256,362,123,239,0.561,0.531,0.48,13154,615
"165",102049,2004,1,0,"SAMFORD UNIVERSITY",NA,NA,665,423,242,359,111,248,0.586,0.54,0.459,13944,621
"166",102049,2005,1,0,"Samford University",NA,NA,699,457,242,358,93,265,0.58,0.512,0.384,14642,634
"167",102049,2006,1,0,"Samford University",NA,NA,644,392,252,326,99,227,0.579,0.506,0.393,16000,591
"168",102049,2007,1,0,"Samford University",NA,NA,711,459,252,348,112,236,0.514,0.489,0.444,17920,651
"169",102049,2008,1,0,"Samford University",NA,NA,705,442,263,336,104,232,0.525,0.477,0.395,19300,616
"170",102049,2009,1,0,"Samford University",NA,NA,730,486,244,430,132,298,0.613,0.589,0.541,20200,670
"171",102049,2010,1,0,"Samford University",NA,NA,711,455,256,417,132,285,0.626,0.586,0.516,21722,616
"172",102094,1991,0,1,"UNIVERSITY OF SOUTH ALABAMA",1998,0,1245,653,592,117,32,85,0.13,0.094,0.054,2103,1030
"173",102094,1992,0,1,"UNIVERSITY OF SOUTH ALABAMA",1998,0,1170,668,502,123,38,85,0.127,0.105,0.076,2295,978
"174",102094,1993,0,1,"UNIVERSITY OF SOUTH ALABAMA",1998,0,1086,621,465,125,38,87,0.14,0.115,0.082,2295,898
"175",102094,1995,0,1,"UNIVERSITY OF SOUTH ALABAMA",1998,0,1192,674,518,167,54,113,0.168,0.14,0.104,2541,985
"176",102094,1996,0,1,"UNIVERSITY OF SOUTH ALABAMA",1998,0,1066,590,476,147,37,110,0.186,0.138,0.078,2538,883
"177",102094,1997,0,1,"UNIVERSITY OF SOUTH ALABAMA",1998,0,1132,663,469,138,38,100,0.151,0.122,0.081,2673,903
"178",102094,1998,1,0,"UNIVERSITY OF SOUTH ALABAMA",1998,1,1044,618,426,143,36,107,0.173,0.137,0.085,2673,799
"179",102094,1999,1,0,"UNIVERSITY OF SOUTH ALABAMA",1998,1,882,521,361,122,22,100,0.192,0.138,0.061,2670,668
"180",102094,2000,1,0,"UNIVERSITY OF SOUTH ALABAMA",1998,1,1064,679,385,167,46,121,0.178,0.157,0.119,2670,810
"181",102094,2001,1,0,"UNIVERSITY OF SOUTH ALABAMA",1998,1,1116,634,482,160,40,120,0.189,0.143,0.083,2910,850
"182",102094,2002,1,0,"UNIVERSITY OF SOUTH ALABAMA",1998,1,1004,597,407,135,42,93,0.156,0.134,0.103,3090,777
"183",102094,2003,1,0,"UNIVERSITY OF SOUTH ALABAMA",1998,1,1218,704,514,155,42,113,0.16,0.127,0.082,3390,851
"184",102094,2004,1,0,"UNIVERSITY OF SOUTH ALABAMA",1998,1,1278,725,553,180,60,120,0.166,0.141,0.108,3810,882
"185",102094,2005,1,0,"University of South Alabama",1998,1,1198,689,509,199,62,137,0.199,0.166,0.122,3810,836
"186",102094,2006,1,0,"University of South Alabama",1998,1,1355,777,578,190,55,135,0.174,0.14,0.095,3810,941
"187",102094,2007,1,0,"University of South Alabama",1998,1,1457,801,656,200,68,132,0.165,0.137,0.104,4020,991
"188",102094,2008,1,0,"University of South Alabama",1998,1,1543,875,668,230,68,162,0.185,0.149,0.102,4410,1055
"189",102094,2009,1,0,"University of South Alabama",1998,1,1753,927,826,244,83,161,0.174,0.139,0.1,4860,1146
"190",102094,2010,1,0,"University of South Alabama",1998,1,1707,950,757,262,83,179,0.188,0.153,0.11,5448,1074
"191",102234,1991,1,0,"SPRING HILL COLLEGE",NA,NA,279,158,121,106,42,64,0.405,0.38,0.347,10149,229
"192",102234,1992,1,0,"SPRING HILL COLLEGE",NA,NA,295,167,128,144,58,86,0.515,0.488,0.453,10763,255
"193",102234,1993,1,0,"SPRING HILL COLLEGE",NA,NA,229,129,100,106,43,63,0.488,0.463,0.43,11425,205
"194",102234,1995,1,0,"SPRING HILL COLLEGE",NA,NA,232,141,91,113,34,79,0.56,0.487,0.374,12489,198
"195",102234,1996,1,0,"SPRING HILL COLLEGE",NA,NA,201,121,80,96,32,64,0.529,0.478,0.4,13140,176
"196",102234,1997,1,0,"SPRING HILL COLLEGE",NA,NA,254,144,110,118,55,63,0.438,0.465,0.5,13890,221
"197",102234,1998,1,0,"SPRING HILL COLLEGE",NA,NA,242,119,123,120,61,59,0.496,0.496,0.496,14620,210
"198",102234,1999,1,0,"SPRING HILL COLLEGE",NA,NA,299,182,117,147,43,104,0.571,0.492,0.368,14390,241
"199",102234,2000,1,0,"SPRING HILL COLLEGE",NA,NA,284,186,98,158,47,111,0.597,0.556,0.48,15254,244
"200",102234,2001,1,0,"SPRING HILL COLLEGE",NA,NA,251,137,114,112,39,73,0.533,0.446,0.342,16170,190
"201",102234,2002,1,0,"SPRING HILL COLLEGE",NA,NA,289,168,121,151,60,91,0.542,0.522,0.496,16980,241
"202",102234,2003,1,0,"SPRING HILL COLLEGE",NA,NA,308,193,115,157,61,96,0.497,0.51,0.53,17830,225
"203",102234,2004,1,0,"SPRING HILL COLLEGE",NA,NA,309,203,106,156,44,112,0.552,0.505,0.415,18722,222
"204",102234,2005,1,0,"Spring Hill College",NA,NA,274,173,101,139,49,90,0.52,0.507,0.485,19658,200
"205",102234,2006,1,0,"Spring Hill College",NA,NA,345,226,119,189,62,127,0.562,0.548,0.521,20650,238
"206",102234,2007,1,0,"Spring Hill College",NA,NA,380,243,137,179,65,114,0.469,0.471,0.474,21686,289
"207",102234,2008,1,0,"Spring Hill College",NA,NA,344,213,131,175,62,113,0.53,0.509,0.473,22770,234
"208",102234,2009,1,0,"Spring Hill College",NA,NA,355,203,152,152,55,97,0.478,0.428,0.362,23910,248
"209",102234,2010,1,0,"Spring Hill College",NA,NA,392,252,140,180,56,124,0.492,0.459,0.4,25110,268
"210",102368,1991,0,1,"TROY STATE UNIVERSITY-MAIN CAMPUS",1999,0,793,437,356,205,70,135,0.309,0.259,0.197,1470,641
"211",102368,1992,0,1,"TROY STATE UNIVERSITY-MAIN CAMPUS",1999,0,935,460,475,217,73,144,0.313,0.232,0.154,1617,742
"212",102368,1993,0,1,"TROY STATE UNIVERSITY-MAIN CAMPUS",1999,0,926,526,400,303,108,195,0.371,0.327,0.27,1771,731
"213",102368,1995,0,1,"TROY STATE UNIVERSITY-MAIN CAMPUS",1999,0,877,477,400,354,120,234,0.491,0.404,0.3,2007,711
"214",102368,1996,0,1,"TROY STATE UNIVERSITY-MAIN CAMPUS",1999,0,877,483,394,340,133,207,0.429,0.388,0.338,2175,658
"215",102368,1997,0,1,"TROY STATE UNIVERSITY-MAIN CAMPUS",1999,0,803,474,329,307,109,198,0.418,0.382,0.331,2250,612
"216",102368,1998,0,1,"TROY STATE UNIVERSITY-MAIN CAMPUS",1999,0,768,437,331,251,75,176,0.403,0.327,0.227,2490,501
"217",102368,1999,1,0,"TROY STATE UNIVERSITY-MAIN CAMPUS",1999,1,845,510,335,271,85,186,0.365,0.321,0.254,2660,571
"218",102368,2000,1,0,"TROY STATE UNIVERSITY-MAIN CAMPUS",1999,1,941,513,428,271,105,166,0.324,0.288,0.245,2850,568
"219",102368,2001,1,0,"TROY STATE UNIVERSITY-MAIN CAMPUS",1999,1,1054,572,482,211,71,140,0.245,0.2,0.147,3020,666
"220",102368,2002,1,0,"TROY STATE UNIVERSITY-MAIN CAMPUS",1999,1,1353,730,623,288,101,187,0.256,0.213,0.162,3220,810
"221",102368,2003,1,0,"TROY STATE UNIVERSITY-MAIN CAMPUS",1999,1,1229,672,557,215,66,149,0.222,0.175,0.118,3530,757
"222",102368,2004,1,0,"TROY STATE UNIVERSITY-MAIN CAMPUS",1999,1,1450,788,662,230,67,163,0.207,0.159,0.101,3850,866
"223",102368,2005,1,0,"Troy University",1999,1,1434,789,645,201,64,137,0.174,0.14,0.099,4004,834
"224",102368,2006,1,0,"Troy University",1999,1,1666,964,702,238,77,161,0.167,0.143,0.11,4004,930
"225",102368,2007,1,0,"Troy University",1999,1,1763,1011,752,222,75,147,0.145,0.126,0.1,4164,958
"226",102368,2008,1,0,"Troy University",1999,1,1827,1081,746,246,76,170,0.157,0.135,0.102,4248,988
"227",102368,2009,1,0,"Troy University",1999,1,1997,1192,805,265,78,187,0.157,0.133,0.097,4632,988
"228",102368,2010,1,0,"Troy University",1999,1,1810,1083,727,295,97,198,0.183,0.163,0.133,5184,949
"229",102377,1991,1,0,"TUSKEGEE UNIVERSITY",NA,NA,837,469,368,167,70,97,0.207,0.2,0.19,6250,2
"230",102377,1992,1,0,"TUSKEGEE UNIVERSITY",NA,NA,612,311,301,123,36,87,0.28,0.201,0.12,6535,0
"231",102377,1993,1,0,"TUSKEGEE UNIVERSITY",NA,NA,595,302,293,104,39,65,0.215,0.175,0.133,6734,0
"232",102377,1995,1,0,"TUSKEGEE UNIVERSITY",NA,NA,645,383,262,139,35,104,0.272,0.216,0.134,7424,0
"233",102377,1996,1,0,"TUSKEGEE UNIVERSITY",NA,NA,810,497,313,180,34,146,0.294,0.222,0.109,8020,1
"234",102377,1997,1,0,"TUSKEGEE UNIVERSITY",NA,NA,713,466,247,179,29,150,0.322,0.251,0.117,8662,0
"235",102377,1998,1,0,"TUSKEGEE UNIVERSITY",NA,NA,683,412,271,154,37,117,0.284,0.225,0.137,9060,0
"236",102377,1999,1,0,"TUSKEGEE UNIVERSITY",NA,NA,679,400,279,119,27,92,0.23,0.175,0.097,9500,0
"237",102377,2000,1,0,"TUSKEGEE UNIVERSITY",NA,NA,591,354,237,149,37,112,0.316,0.252,0.156,9928,0
"238",102377,2001,1,0,"TUSKEGEE UNIVERSITY",NA,NA,645,375,270,108,41,67,0.179,0.167,0.152,10326,0
"239",102377,2002,1,0,"TUSKEGEE UNIVERSITY",NA,NA,738,426,312,168,36,132,0.31,0.228,0.115,10584,0
"240",102377,2003,1,0,"TUSKEGEE UNIVERSITY",NA,NA,528,272,256,82,32,50,0.184,0.155,0.125,11060,0
"241",102377,2004,1,0,"TUSKEGEE UNIVERSITY",NA,NA,701,389,312,123,35,88,0.226,0.175,0.112,11290,3
"242",102377,2005,1,0,"Tuskegee University",NA,NA,730,385,345,112,30,82,0.213,0.153,0.087,11690,2
"243",102377,2006,1,0,"Tuskegee University",NA,NA,688,395,293,151,33,118,0.299,0.219,0.113,12400,2
"244",102377,2007,1,0,"Tuskegee University",NA,NA,796,444,352,133,31,102,0.23,0.167,0.088,13520,2
"245",102377,2008,1,0,"Tuskegee University",NA,NA,722,414,308,154,44,110,0.266,0.213,0.143,14740,1
"246",102377,2009,1,0,"Tuskegee University",NA,NA,688,410,278,123,25,98,0.239,0.179,0.09,15630,2
"247",102377,2010,1,0,"Tuskegee University",NA,NA,701,393,308,228,99,129,0.328,0.325,0.321,16100,0
"248",104151,1991,1,0,"ARIZONA STATE UNIVERSITY",NA,NA,2447,1214,1233,442,174,268,0.221,0.181,0.141,1528,1864
"249",104151,1992,1,0,"ARIZONA STATE UNIVERSITY",NA,NA,2901,1503,1398,452,162,290,0.193,0.156,0.116,1590,2149
"250",104151,1993,1,0,"ARIZONA STATE UNIVERSITY-MAIN CAMPUS",NA,NA,3298,1637,1661,561,203,358,0.219,0.17,0.122,1844,2489
"251",104151,1995,1,0,"ARIZONA STATE UNIVERSITY-MAIN CAMPUS",NA,NA,3945,2096,1849,854,299,555,0.265,0.216,0.162,1950,2893
"252",104151,1996,1,0,"ARIZONA STATE UNIVERSITY-MAIN CAMPUS",NA,NA,4001,2117,1884,1028,398,630,0.298,0.257,0.211,2009,2963
"253",104151,1997,1,0,"ARIZONA STATE UNIVERSITY-MAIN CAMPUS",NA,NA,4938,2646,2292,1284,448,836,0.316,0.26,0.195,2058,3683
"254",104151,1998,1,0,"ARIZONA STATE UNIVERSITY-MAIN CAMPUS",NA,NA,4753,2561,2192,1270,480,790,0.308,0.267,0.219,2158,3471
"255",104151,1999,1,0,"ARIZONA STATE UNIVERSITY-MAIN CAMPUS",NA,NA,5625,3096,2529,1505,522,983,0.318,0.268,0.206,2188,3845
"256",104151,2000,1,0,"ARIZONA STATE UNIVERSITY-MAIN CAMPUS",NA,NA,5763,3058,2705,1615,596,1019,0.333,0.28,0.22,2272,4179
"257",104151,2001,1,0,"ARIZONA STATE UNIVERSITY-MAIN CAMPUS",NA,NA,5950,3157,2793,1649,599,1050,0.333,0.277,0.214,2412,4379
"258",104151,2002,1,0,"ARIZONA STATE UNIVERSITY-MAIN CAMPUS",NA,NA,6094,3323,2771,1813,661,1152,0.347,0.298,0.239,2508,4323
"259",104151,2003,1,0,"ARIZONA STATE UNIVERSITY-MAIN CAMPUS",NA,NA,6815,3652,3163,1997,730,1267,0.347,0.293,0.231,3508,4801
"260",104151,2004,1,0,"ARIZONA STATE UNIVERSITY AT THE TEMPE CAMPUS",NA,NA,7293,3998,3295,2324,816,1508,0.377,0.319,0.248,3973,5111
"261",104151,2005,1,0,"Arizona State University at the Tempe Campus",NA,NA,7927,4267,3660,2561,996,1565,0.367,0.323,0.272,4311,5361
"262",104151,2006,1,0,"Arizona State University at the Tempe Campus",NA,NA,8533,4556,3977,2837,1145,1692,0.371,0.332,0.288,4591,5722
"263",104151,2007,1,0,"Arizona State University at the Tempe Campus",NA,NA,7308,3775,3533,2753,1126,1627,0.431,0.377,0.319,4821,4900
"264",104151,2008,1,0,"Arizona State University",NA,NA,6743,3320,3423,2886,1224,1662,0.501,0.428,0.358,5409,4273
"265",104151,2009,1,0,"Arizona State University",NA,NA,6747,3279,3468,3054,1335,1719,0.524,0.453,0.385,5997,4270
"266",104151,2010,1,0,"Arizona State University",NA,NA,6210,2997,3213,3071,1409,1662,0.555,0.495,0.439,7793,3773
"267",104179,1991,1,0,"UNIVERSITY OF ARIZONA",NA,NA,3970,2063,1907,786,297,489,0.237,0.198,0.156,1528,2959
"268",104179,1992,1,0,"UNIVERSITY OF ARIZONA",NA,NA,3803,1926,1877,814,302,512,0.266,0.214,0.161,1528,2847
"269",104179,1993,1,0,"UNIVERSITY OF ARIZONA",NA,NA,4287,2254,2033,968,317,651,0.289,0.226,0.156,1778,3124
"270",104179,1995,1,0,"UNIVERSITY OF ARIZONA",NA,NA,4370,2382,1988,1160,405,755,0.317,0.265,0.204,1884,3116
"271",104179,1996,1,0,"UNIVERSITY OF ARIZONA",NA,NA,4006,2102,1904,1145,441,704,0.335,0.286,0.232,2009,2899
"272",104179,1997,1,0,"UNIVERSITY OF ARIZONA",NA,NA,4431,2409,2022,1294,463,831,0.345,0.292,0.229,2058,3213
"273",104179,1998,1,0,"UNIVERSITY OF ARIZONA",NA,NA,5088,2773,2315,1595,590,1005,0.362,0.313,0.255,2158,3725
"274",104179,1999,1,0,"UNIVERSITY OF ARIZONA",NA,NA,5126,2745,2381,1626,623,1003,0.365,0.317,0.262,0,3721
"275",104179,2000,1,0,"UNIVERSITY OF ARIZONA",NA,NA,5443,2924,2519,1613,618,995,0.34,0.296,0.245,0,3984
"276",104179,2001,1,0,"UNIVERSITY OF ARIZONA",NA,NA,5727,3005,2722,1871,717,1154,0.384,0.327,0.263,0,4087
"277",104179,2002,1,0,"UNIVERSITY OF ARIZONA",NA,NA,5613,3008,2605,1805,703,1102,0.366,0.322,0.27,0,3946
"278",104179,2003,1,0,"UNIVERSITY OF ARIZONA",NA,NA,5780,3154,2626,1870,708,1162,0.368,0.324,0.27,3508,3980
"279",104179,2004,1,0,"UNIVERSITY OF ARIZONA",NA,NA,5566,3008,2558,1880,723,1157,0.385,0.338,0.283,3998,3704
"280",104179,2005,1,0,"University of Arizona",NA,NA,5785,3115,2670,2104,820,1284,0.412,0.364,0.307,4394,3970
"281",104179,2006,1,0,"University of Arizona",NA,NA,5788,3092,2696,2085,813,1272,0.411,0.36,0.302,4594,3794
"282",104179,2007,1,0,"University of Arizona",NA,NA,6231,3395,2836,2485,976,1509,0.445,0.399,0.344,4824,4152
"283",104179,2008,1,0,"University of Arizona",NA,NA,6331,3377,2954,2536,1017,1519,0.45,0.401,0.344,5274,4133
"284",104179,2009,1,0,"University of Arizona",NA,NA,6782,3697,3085,2922,1146,1776,0.48,0.431,0.371,6540,4241
"285",104179,2010,1,0,"University of Arizona",NA,NA,6797,3629,3168,2847,1137,1710,0.471,0.419,0.359,7614,3962
"286",105330,1991,1,0,"NORTHERN ARIZONA UNIVERSITY",NA,NA,1881,1064,817,294,97,197,0.185,0.156,0.119,1528,1470
"287",105330,1992,1,0,"NORTHERN ARIZONA UNIVERSITY",NA,NA,2095,1203,892,315,104,211,0.175,0.15,0.117,1528,1645
"288",105330,1993,1,0,"NORTHERN ARIZONA UNIVERSITY",NA,NA,1930,1090,840,306,103,203,0.186,0.159,0.123,1844,1537
"289",105330,1995,1,0,"NORTHERN ARIZONA UNIVERSITY",NA,NA,2015,1120,895,436,133,303,0.27,0.216,0.149,1950,1612
"290",105330,1996,1,0,"NORTHERN ARIZONA UNIVERSITY",NA,NA,2267,1288,979,538,170,368,0.286,0.237,0.174,2009,1867
"291",105330,1997,1,0,"NORTHERN ARIZONA UNIVERSITY",NA,NA,1983,1169,814,530,154,376,0.322,0.267,0.189,2058,1676
"292",105330,1998,1,0,"NORTHERN ARIZONA UNIVERSITY",NA,NA,2073,1188,885,554,176,378,0.318,0.267,0.199,2160,1695
"293",105330,1999,1,0,"NORTHERN ARIZONA UNIVERSITY",NA,NA,2162,1278,884,562,166,396,0.31,0.26,0.188,2188,1772
"294",105330,2000,1,0,"NORTHERN ARIZONA UNIVERSITY",NA,NA,2273,1384,889,613,174,439,0.317,0.27,0.196,2272,1870
"295",105330,2001,1,0,"NORTHERN ARIZONA UNIVERSITY",NA,NA,2146,1299,847,609,169,440,0.339,0.284,0.2,2412,1769
"296",105330,2002,1,0,"NORTHERN ARIZONA UNIVERSITY",NA,NA,2153,1327,826,681,173,508,0.383,0.316,0.209,2507,1718
"297",105330,2003,1,0,"NORTHERN ARIZONA UNIVERSITY",NA,NA,2114,1249,865,644,196,448,0.359,0.305,0.227,3508,1670
"298",105330,2004,1,0,"NORTHERN ARIZONA UNIVERSITY",NA,NA,2274,1309,965,652,190,462,0.353,0.287,0.197,3983,1769
"299",105330,2005,1,0,"Northern Arizona University",NA,NA,2101,1268,833,645,174,471,0.372,0.307,0.209,4223,1622
"300",105330,2006,1,0,"Northern Arizona University",NA,NA,2527,1488,1039,756,224,532,0.358,0.299,0.216,4376,1931
"301",105330,2007,1,0,"Northern Arizona University",NA,NA,2880,1676,1204,868,261,607,0.362,0.301,0.217,4594,2166
"302",105330,2008,1,0,"Northern Arizona University",NA,NA,3248,1899,1349,1078,316,762,0.401,0.332,0.234,5144,2437
"303",105330,2009,1,0,"Northern Arizona University",NA,NA,3377,1951,1426,1122,354,768,0.394,0.332,0.248,6092,2390
"304",105330,2010,1,0,"Northern Arizona University",NA,NA,3739,2209,1530,1354,442,912,0.413,0.362,0.289,5431,2486
"305",106245,1991,1,0,"UNIVERSITY OF ARKANSAS AT LITTLE ROCK",NA,NA,941,536,405,45,14,31,0.058,0.048,0.035,1806,729
"306",106245,1992,1,0,"UNIVERSITY OF ARKANSAS AT LITTLE ROCK",NA,NA,1092,600,492,61,23,38,0.063,0.056,0.047,1902,781
"307",106245,1993,1,0,"UNIVERSITY OF ARKANSAS AT LITTLE ROCK",NA,NA,966,565,401,59,12,47,0.083,0.061,0.03,2098,613
"308",106245,1995,1,0,"UNIVERSITY OF ARKANSAS AT LITTLE ROCK",NA,NA,675,390,285,103,37,66,0.169,0.153,0.13,2368,456
"309",106245,1996,1,0,"UNIVERSITY OF ARKANSAS AT LITTLE ROCK",NA,NA,691,429,262,65,18,47,0.11,0.094,0.069,2538,437
"310",106245,1997,1,0,"UNIVERSITY OF ARKANSAS AT LITTLE ROCK",NA,NA,841,503,338,46,13,33,0.066,0.055,0.038,2538,503
"311",106245,1998,1,0,"UNIVERSITY OF ARKANSAS AT LITTLE ROCK",NA,NA,865,539,326,93,22,71,0.132,0.108,0.067,2616,506
"312",106245,1999,1,0,"UNIVERSITY OF ARKANSAS AT LITTLE ROCK",NA,NA,826,518,308,51,12,39,0.075,0.062,0.039,2424,466
"313",106245,2000,1,0,"UNIVERSITY OF ARKANSAS AT LITTLE ROCK",NA,NA,836,484,352,73,28,45,0.093,0.087,0.08,2544,424
"314",106245,2001,1,0,"UNIVERSITY OF ARKANSAS AT LITTLE ROCK",NA,NA,703,410,293,57,19,38,0.093,0.081,0.065,2664,392
"315",106245,2002,1,0,"UNIVERSITY OF ARKANSAS AT LITTLE ROCK",NA,NA,739,456,283,72,19,53,0.116,0.097,0.067,2850,419
"316",106245,2003,1,0,"UNIVERSITY OF ARKANSAS AT LITTLE ROCK",NA,NA,691,405,286,29,9,20,0.049,0.042,0.031,3024,373
"317",106245,2004,1,0,"UNIVERSITY OF ARKANSAS AT LITTLE ROCK",NA,NA,759,452,307,54,18,36,0.08,0.071,0.059,3216,410
"318",106245,2005,1,0,"University of Arkansas at Little Rock",NA,NA,762,445,317,64,24,40,0.09,0.084,0.076,3384,403
"319",106245,2006,1,0,"University of Arkansas at Little Rock",NA,NA,603,317,286,40,19,21,0.066,0.066,0.066,3552,334
"320",106245,2007,1,0,"University of Arkansas at Little Rock",NA,NA,812,471,341,57,28,29,0.062,0.07,0.082,4612,449
"321",106245,2008,1,0,"University of Arkansas at Little Rock",NA,NA,618,375,243,50,23,27,0.072,0.081,0.095,4890,345
"322",106245,2009,1,0,"University of Arkansas at Little Rock",NA,NA,674,387,287,74,27,47,0.121,0.11,0.094,5040,367
"323",106245,2010,1,0,"University of Arkansas at Little Rock",NA,NA,683,376,307,80,40,40,0.106,0.117,0.13,5228,370
"324",106342,1991,1,0,"ARKANSAS COLLEGE",NA,NA,121,79,42,48,17,31,0.392,0.397,0.405,7040,109
"325",106342,1992,1,0,"ARKANSAS COLLEGE",NA,NA,138,80,58,51,21,30,0.375,0.37,0.362,7603,118
"326",106342,1993,1,0,"ARKANSAS COLLEGE",NA,NA,166,84,82,65,29,36,0.429,0.392,0.354,8060,159
"327",106342,1995,1,0,"LYON COLLEGE",NA,NA,168,90,78,82,32,50,0.556,0.488,0.41,8990,152
"328",106342,1996,1,0,"LYON COLLEGE",NA,NA,129,69,60,60,22,38,0.551,0.465,0.367,9490,113
"329",106342,1997,1,0,"LYON COLLEGE",NA,NA,125,63,62,54,19,35,0.556,0.432,0.306,10100,110
"330",106342,1998,1,0,"LYON COLLEGE",NA,NA,107,65,42,56,21,35,0.538,0.523,0.5,10526,96
"331",106342,1999,1,0,"LYON COLLEGE",NA,NA,141,79,62,82,33,49,0.62,0.582,0.532,10272,119
"332",106342,2000,1,0,"LYON COLLEGE",NA,NA,127,71,56,74,30,44,0.62,0.583,0.536,10580,113
"333",106342,2001,1,0,"LYON COLLEGE",NA,NA,129,80,49,68,20,48,0.6,0.527,0.408,11000,116
"334",106342,2002,1,0,"LYON COLLEGE",NA,NA,113,47,66,62,33,29,0.617,0.549,0.5,11540,100
"335",106342,2003,1,0,"LYON COLLEGE",NA,NA,120,67,53,53,23,30,0.448,0.442,0.434,11990,102
"336",106342,2004,1,0,"LYON COLLEGE",NA,NA,141,66,75,62,37,25,0.379,0.44,0.493,12710,114
"337",106342,2005,1,0,"Lyon College",NA,NA,111,61,50,45,20,25,0.41,0.405,0.4,13475,100
"338",106342,2006,1,0,"Lyon College",NA,NA,128,61,67,56,27,29,0.475,0.438,0.403,14420,106
"339",106342,2007,1,0,"Lyon College",NA,NA,143,84,59,62,19,43,0.512,0.434,0.322,15466,117
"340",106342,2008,1,0,"Lyon College",NA,NA,102,52,50,50,25,25,0.481,0.49,0.5,18500,83
"341",106342,2009,1,0,"Lyon College",NA,NA,216,114,102,75,39,36,0.316,0.347,0.382,19424,181
"342",106342,2010,1,0,"Lyon College",NA,NA,198,107,91,70,29,41,0.383,0.354,0.319,21100,154
"343",106397,1991,1,0,"UNIVERSITY OF ARKANSAS-FAYETTEVILLE",NA,NA,2327,1080,1247,381,170,211,0.195,0.164,0.136,1732,1989
"344",106397,1992,1,0,"UNIVERSITY OF ARKANSAS-FAYETTEVILLE",NA,NA,2327,1066,1261,394,165,229,0.215,0.169,0.131,1838,2047
"345",106397,1993,1,0,"UNIVERSITY OF ARKANSAS AT FAYETTEVILLE",NA,NA,2015,964,1051,401,158,243,0.252,0.199,0.15,1946,1753
"346",106397,1995,1,0,"UNIVERSITY OF ARKANSAS AT FAYETTEVILLE",NA,NA,2249,1148,1101,425,155,270,0.235,0.189,0.141,2130,1863
"347",106397,1996,1,0,"UNIVERSITY OF ARKANSAS AT FAYETTEVILLE",NA,NA,2174,1105,1069,490,184,306,0.277,0.225,0.172,2639,1784
"348",106397,1997,1,0,"UNIVERSITY OF ARKANSAS AT FAYETTEVILLE",NA,NA,2125,1077,1048,515,191,324,0.301,0.242,0.182,2896,1770
"349",106397,1998,1,0,"UNIVERSITY OF ARKANSAS AT FAYETTEVILLE",NA,NA,2456,1245,1211,665,246,419,0.336,0.271,0.203,3119,2085
"350",106397,1999,1,0,"UNIVERSITY OF ARKANSAS AT FAYETTEVILLE",NA,NA,2189,1123,1066,666,235,431,0.384,0.304,0.22,2800,1791
"351",106397,2000,1,0,"UNIVERSITY OF ARKANSAS MAIN CAMPUS",NA,NA,2179,1092,1087,645,246,399,0.365,0.296,0.226,2968,1848
"352",106397,2001,1,0,"UNIVERSITY OF ARKANSAS MAIN CAMPUS",NA,NA,2190,1126,1064,718,290,428,0.38,0.328,0.273,3116,1877
"353",106397,2002,1,0,"UNIVERSITY OF ARKANSAS MAIN CAMPUS",NA,NA,2137,1106,1031,707,284,423,0.382,0.331,0.275,3573,1792
"354",106397,2003,1,0,"UNIVERSITY OF ARKANSAS MAIN CAMPUS",NA,NA,2260,1175,1085,775,318,457,0.389,0.343,0.293,3810,1942
"355",106397,2004,1,0,"UNIVERSITY OF ARKANSAS MAIN CAMPUS",NA,NA,2420,1222,1198,835,329,506,0.414,0.345,0.275,4115,2053
"356",106397,2005,1,0,"University of Arkansas Main Campus",NA,NA,2662,1324,1338,913,375,538,0.406,0.343,0.28,4361,2224
"357",106397,2006,1,0,"University of Arkansas Main Campus",NA,NA,2719,1346,1373,945,398,547,0.406,0.348,0.29,4590,2318
"358",106397,2007,1,0,"University of Arkansas Main Campus",NA,NA,2877,1425,1452,1055,456,599,0.42,0.367,0.314,4772,2421
"359",106397,2008,1,0,"University of Arkansas Main Campus",NA,NA,2977,1488,1489,1108,475,633,0.425,0.372,0.319,5010,2487
"360",106397,2009,1,0,"University of Arkansas",NA,NA,2890,1448,1442,1129,466,663,0.458,0.391,0.323,5010,2409
"361",106397,2010,1,0,"University of Arkansas",NA,NA,3774,1929,1845,1596,634,962,0.499,0.423,0.344,5211,3079
"362",106412,1991,1,0,"UNIVERSITY OF ARKANSAS-PINE BLUFF",NA,NA,650,393,257,55,15,40,0.102,0.085,0.058,1451,67
"363",106412,1992,1,0,"UNIVERSITY OF ARKANSAS-PINE BLUFF",NA,NA,592,341,251,27,9,18,0.053,0.046,0.036,1451,57
"364",106412,1993,1,0,"UNIVERSITY OF ARKANSAS AT PINE BLUFF",NA,NA,735,379,356,52,15,37,0.098,0.071,0.042,1584,40
"365",106412,1995,1,0,"UNIVERSITY OF ARKANSAS AT PINE BLUFF",NA,NA,565,302,263,39,11,28,0.093,0.069,0.042,1788,15
"366",106412,1996,1,0,"UNIVERSITY OF ARKANSAS AT PINE BLUFF",NA,NA,575,302,273,47,12,35,0.116,0.082,0.044,1860,7
"367",106412,1997,1,0,"UNIVERSITY OF ARKANSAS AT PINE BLUFF",NA,NA,608,297,311,51,12,39,0.131,0.084,0.039,2046,12
"368",106412,1998,1,0,"UNIVERSITY OF ARKANSAS AT PINE BLUFF",NA,NA,721,372,349,70,22,48,0.129,0.097,0.063,2082,13
"369",106412,1999,1,0,"UNIVERSITY OF ARKANSAS AT PINE BLUFF",NA,NA,656,341,315,76,20,56,0.164,0.116,0.063,2058,8
"370",106412,2000,1,0,"UNIVERSITY OF ARKANSAS AT PINE BLUFF",NA,NA,629,330,299,43,13,30,0.091,0.068,0.043,2400,11
"371",106412,2001,1,0,"UNIVERSITY OF ARKANSAS AT PINE BLUFF",NA,NA,700,371,329,97,21,76,0.205,0.139,0.064,2490,7
"372",106412,2002,1,0,"UNIVERSITY OF ARKANSAS AT PINE BLUFF",NA,NA,712,358,354,63,16,47,0.131,0.088,0.045,2664,10
"373",106412,2003,1,0,"UNIVERSITY OF ARKANSAS AT PINE BLUFF",NA,NA,731,333,398,47,12,35,0.105,0.064,0.03,2820,11
"374",106412,2004,1,0,"UNIVERSITY OF ARKANSAS AT PINE BLUFF",NA,NA,690,365,325,47,14,33,0.09,0.068,0.043,3000,10
"375",106412,2005,1,0,"University of Arkansas at Pine Bluff",NA,NA,714,349,365,74,24,50,0.143,0.104,0.066,3150,13
"376",106412,2006,1,0,"University of Arkansas at Pine Bluff",NA,NA,688,340,348,55,18,37,0.109,0.08,0.052,3300,7
"377",106412,2007,1,0,"University of Arkansas at Pine Bluff",NA,NA,786,411,375,44,10,34,0.083,0.056,0.027,3300,8
"378",106412,2008,1,0,"University of Arkansas at Pine Bluff",NA,NA,952,504,448,93,21,72,0.143,0.098,0.047,3450,11
"379",106412,2009,1,0,"University of Arkansas at Pine Bluff",NA,NA,959,523,436,67,16,51,0.098,0.07,0.037,3540,14
"380",106412,2010,1,0,"University of Arkansas at Pine Bluff",NA,NA,780,393,387,51,13,38,0.097,0.065,0.034,3750,9
"381",106458,1991,1,0,"ARKANSAS STATE UNIVERSITY MAIN CAMPUS",NA,NA,1521,833,688,147,44,103,0.124,0.097,0.064,1420,1225
"382",106458,1992,1,0,"ARKANSAS STATE UNIVERSITY MAIN CAMPUS",NA,NA,1607,855,752,164,48,116,0.136,0.102,0.064,1610,1259
"383",106458,1993,1,0,"ARKANSAS STATE UNIVERSITY-MAIN CAMPUS",NA,NA,1487,812,675,190,66,124,0.153,0.128,0.098,1810,1272
"384",106458,1995,1,0,"ARKANSAS STATE UNIVERSITY-MAIN CAMPUS",NA,NA,1448,803,645,218,65,153,0.19,0.151,0.101,1950,1213
"385",106458,1996,1,0,"ARKANSAS STATE UNIVERSITY-MAIN CAMPUS",NA,NA,1592,893,699,216,64,152,0.17,0.136,0.092,1970,1320
"386",106458,1997,1,0,"ARKANSAS STATE UNIVERSITY-MAIN CAMPUS",NA,NA,1687,922,765,249,89,160,0.174,0.148,0.116,2280,1399
"387",106458,1998,1,0,"ARKANSAS STATE UNIVERSITY-MAIN CAMPUS",NA,NA,1705,928,777,270,68,202,0.218,0.158,0.088,2804,1393
"388",106458,1999,1,0,"ARKANSAS STATE UNIVERSITY-MAIN CAMPUS",NA,NA,1654,937,717,303,92,211,0.225,0.183,0.128,2352,1347
"389",106458,2000,1,0,"ARKANSAS STATE UNIVERSITY-MAIN CAMPUS",NA,NA,1591,893,698,307,97,210,0.235,0.193,0.139,2520,1301
"390",106458,2001,1,0,"ARKANSAS STATE UNIVERSITY-MAIN CAMPUS",NA,NA,1594,921,673,309,86,223,0.242,0.194,0.128,3360,1325
"391",106458,2002,1,0,"ARKANSAS STATE UNIVERSITY-MAIN CAMPUS",NA,NA,1539,813,726,291,109,182,0.224,0.189,0.15,3570,1254
"392",106458,2003,1,0,"ARKANSAS STATE UNIVERSITY-MAIN CAMPUS",NA,NA,1426,798,628,233,70,163,0.204,0.163,0.111,3750,1111
"393",106458,2004,1,0,"ARKANSAS STATE UNIVERSITY-MAIN CAMPUS",NA,NA,1296,749,547,212,71,141,0.188,0.164,0.13,4035,907
"394",106458,2005,1,0,"Arkansas State University-Main Campus",NA,NA,1483,826,657,288,108,180,0.218,0.194,0.164,4260,1068
"395",106458,2006,1,0,"Arkansas State University-Main Campus",NA,NA,1659,946,713,345,124,221,0.234,0.208,0.174,4470,1232
"396",106458,2007,1,0,"Arkansas State University-Main Campus",NA,NA,1655,962,693,309,102,207,0.215,0.187,0.147,4620,1203
"397",106458,2008,1,0,"Arkansas State University-Main Campus",NA,NA,1743,981,762,352,129,223,0.227,0.202,0.169,4890,1037
"398",106458,2009,1,0,"Arkansas State University-Main Campus",NA,NA,1645,874,771,349,154,195,0.223,0.212,0.2,4890,987
"399",106458,2010,1,0,"Arkansas State University-Main Campus",NA,NA,1659,897,762,438,167,271,0.302,0.264,0.219,5100,1152
"400",106467,1991,1,0,"ARKANSAS TECH UNIVERSITY",NA,NA,761,403,358,103,32,71,0.176,0.135,0.089,1460,728
"401",106467,1992,1,0,"ARKANSAS TECH UNIVERSITY",NA,NA,812,438,374,112,33,79,0.18,0.138,0.088,1560,773
"402",106467,1993,1,0,"ARKANSAS TECH UNIVERSITY",NA,NA,847,404,443,117,43,74,0.183,0.138,0.097,1710,800
"403",106467,1995,1,0,"ARKANSAS TECH UNIVERSITY",NA,NA,756,386,370,133,46,87,0.225,0.176,0.124,1910,705
"404",106467,1996,1,0,"ARKANSAS TECH UNIVERSITY",NA,NA,668,339,329,94,40,54,0.159,0.141,0.122,1992,619
"405",106467,1997,1,0,"ARKANSAS TECH UNIVERSITY",NA,NA,725,376,349,83,32,51,0.136,0.114,0.092,2126,664
"406",106467,1998,1,0,"ARKANSAS TECH UNIVERSITY",NA,NA,821,401,420,105,41,64,0.16,0.128,0.098,2288,754
"407",106467,1999,1,0,"ARKANSAS TECH UNIVERSITY",NA,NA,1055,508,547,146,55,91,0.179,0.138,0.101,2352,966
"408",106467,2000,1,0,"ARKANSAS TECH UNIVERSITY",NA,NA,1124,593,531,205,70,135,0.228,0.182,0.132,2588,1030
"409",106467,2001,1,0,"ARKANSAS TECH UNIVERSITY",NA,NA,1202,564,638,235,108,127,0.225,0.196,0.169,2796,1086
"410",106467,2002,1,0,"ARKANSAS TECH UNIVERSITY",NA,NA,1169,624,545,207,80,127,0.204,0.177,0.147,3076,1058
"411",106467,2003,1,0,"ARKANSAS TECH UNIVERSITY",NA,NA,1445,723,722,248,96,152,0.21,0.172,0.133,3312,1312
"412",106467,2004,1,0,"ARKANSAS TECH UNIVERSITY",NA,NA,1398,728,670,199,72,127,0.174,0.142,0.107,3696,1226
"413",106467,2005,1,0,"Arkansas Tech University",NA,NA,1457,714,743,253,104,149,0.209,0.174,0.14,3432,1265
"414",106467,2006,1,0,"Arkansas Tech University",NA,NA,1426,711,715,234,83,151,0.212,0.164,0.116,3576,1209
"415",106467,2007,1,0,"Arkansas Tech University",NA,NA,1548,762,786,278,131,147,0.193,0.18,0.167,3672,1300
"416",106467,2008,1,0,"Arkansas Tech University",NA,NA,1450,763,687,305,115,190,0.249,0.21,0.167,3864,1272
"417",106467,2009,1,0,"Arkansas Tech University",NA,NA,1744,882,862,375,139,236,0.268,0.215,0.161,4008,1517
"418",106467,2010,1,0,"Arkansas Tech University",NA,NA,1681,823,858,259,105,154,0.187,0.154,0.122,4080,1383
"419",106485,1991,1,0,"UNIVERSITY OF ARKANSAS-MONTICELLO",NA,NA,478,256,222,33,13,20,0.078,0.069,0.059,1500,387
"420",106485,1992,1,0,"UNIVERSITY OF ARKANSAS-MONTICELLO",NA,NA,581,302,279,53,15,38,0.126,0.091,0.054,1500,459
"421",106485,1993,1,0,"UNIVERSITY OF ARKANSAS AT MONTICELLO",NA,NA,508,249,259,31,12,19,0.076,0.061,0.046,1500,399
"422",106485,1995,1,0,"UNIVERSITY OF ARKANSAS AT MONTICELLO",NA,NA,489,254,235,46,14,32,0.126,0.094,0.06,1786,387
"423",106485,1996,1,0,"UNIVERSITY OF ARKANSAS AT MONTICELLO",NA,NA,453,240,213,44,19,25,0.104,0.097,0.089,1906,373
"424",106485,1997,1,0,"UNIVERSITY OF ARKANSAS AT MONTICELLO",NA,NA,620,342,278,47,8,39,0.114,0.076,0.029,2145,486
"425",106485,1998,1,0,"UNIVERSITY OF ARKANSAS AT MONTICELLO",NA,NA,558,292,266,52,18,34,0.116,0.093,0.068,2330,423
"426",106485,1999,1,0,"UNIVERSITY OF ARKANSAS AT MONTICELLO",NA,NA,685,370,315,53,15,38,0.103,0.077,0.048,2100,465
"427",106485,2000,1,0,"UNIVERSITY OF ARKANSAS AT MONTICELLO",NA,NA,628,346,282,51,17,34,0.098,0.081,0.06,2250,447
"428",106485,2001,1,0,"UNIVERSITY OF ARKANSAS AT MONTICELLO",NA,NA,654,382,272,51,15,36,0.094,0.078,0.055,2370,465
"429",106485,2002,1,0,"UNIVERSITY OF ARKANSAS AT MONTICELLO",NA,NA,645,368,277,46,14,32,0.087,0.071,0.051,2490,440
"430",106485,2003,1,0,"UNIVERSITY OF ARKANSAS AT MONTICELLO",NA,NA,674,371,303,57,25,32,0.086,0.085,0.083,2700,432
"431",106485,2004,1,0,"UNIVERSITY OF ARKANSAS AT MONTICELLO",NA,NA,629,327,302,60,25,35,0.107,0.095,0.083,2850,394
"432",106485,2005,1,0,"University of Arkansas at Monticello",NA,NA,625,337,288,55,20,35,0.104,0.088,0.069,3000,373
"433",106485,2006,1,0,"University of Arkansas at Monticello",NA,NA,630,335,295,71,28,43,0.128,0.113,0.095,3150,407
"434",106485,2007,1,0,"University of Arkansas at Monticello",NA,NA,617,303,314,52,19,33,0.109,0.084,0.061,3240,413
"435",106485,2008,1,0,"University of Arkansas at Monticello",NA,NA,661,361,300,89,33,56,0.155,0.135,0.11,3420,457
"436",106485,2009,1,0,"University of Arkansas at Monticello",NA,NA,740,373,367,63,16,47,0.126,0.085,0.044,3510,440
"437",106485,2010,1,0,"University of Arkansas at Monticello",NA,NA,689,338,351,69,30,39,0.115,0.1,0.085,3600,374
"438",106704,1991,1,0,"UNIVERSITY OF CENTRAL ARKANSAS",NA,NA,1961,1129,832,171,46,125,0.111,0.087,0.055,1370,1538
"439",106704,1992,1,0,"UNIVERSITY OF CENTRAL ARKANSAS",NA,NA,1948,1150,798,352,116,236,0.205,0.181,0.145,1546,1535
"440",106704,1993,1,0,"UNIVERSITY OF CENTRAL ARKANSAS",NA,NA,1792,1098,694,283,94,189,0.172,0.158,0.135,1730,1388
"441",106704,1995,1,0,"UNIVERSITY OF CENTRAL ARKANSAS",NA,NA,1469,920,549,207,46,161,0.175,0.141,0.084,2010,1218
"442",106704,1996,1,0,"UNIVERSITY OF CENTRAL ARKANSAS",NA,NA,1478,928,550,239,69,170,0.183,0.162,0.125,2392,1211
"443",106704,1997,1,0,"UNIVERSITY OF CENTRAL ARKANSAS",NA,NA,1598,1031,567,284,55,229,0.222,0.178,0.097,2692,1335
"444",106704,1998,1,0,"UNIVERSITY OF CENTRAL ARKANSAS",NA,NA,1575,944,631,249,58,191,0.202,0.158,0.092,3038,1302
"445",106704,1999,1,0,"UNIVERSITY OF CENTRAL ARKANSAS",NA,NA,1729,1030,699,272,86,186,0.181,0.157,0.123,2758,1413
"446",106704,2000,1,0,"UNIVERSITY OF CENTRAL ARKANSAS",NA,NA,1627,982,645,325,80,245,0.25,0.2,0.124,2856,1286
"447",106704,2001,1,0,"UNIVERSITY OF CENTRAL ARKANSAS",NA,NA,1668,1028,640,367,102,265,0.258,0.22,0.159,3060,1229
"448",106704,2002,1,0,"UNIVERSITY OF CENTRAL ARKANSAS",NA,NA,1766,1062,704,389,108,281,0.265,0.22,0.153,3312,1331
"449",106704,2003,1,0,"UNIVERSITY OF CENTRAL ARKANSAS",NA,NA,2414,1450,964,527,165,362,0.25,0.218,0.171,3770,1741
"450",106704,2004,1,0,"UNIVERSITY OF CENTRAL ARKANSAS",NA,NA,2216,1313,903,468,131,337,0.257,0.211,0.145,4060,1656
"451",106704,2005,1,0,"University of Central Arkansas",NA,NA,2429,1376,1053,467,136,331,0.241,0.192,0.129,4500,1641
"452",106704,2006,1,0,"University of Central Arkansas",NA,NA,2352,1340,1012,538,187,351,0.262,0.229,0.185,4695,1532
"453",106704,2007,1,0,"University of Central Arkansas",NA,NA,1763,1054,709,362,118,244,0.231,0.205,0.166,4830,1247
"454",106704,2008,1,0,"University of Central Arkansas",NA,NA,2075,1165,910,444,157,287,0.246,0.214,0.173,5100,1435
"455",106704,2009,1,0,"University of Central Arkansas",NA,NA,1753,1023,730,403,136,267,0.261,0.23,0.186,5205,1221
"456",106704,2010,1,0,"University of Central Arkansas",NA,NA,1828,1070,758,445,155,290,0.271,0.243,0.204,5235,1194
"457",107044,1991,1,0,"HARDING UNIVERSITY",NA,NA,673,383,290,192,65,127,0.332,0.285,0.224,5205,600
"458",107044,1992,1,0,"HARDING UNIVERSITY",NA,NA,818,434,384,238,91,147,0.339,0.291,0.237,5460,688
"459",107044,1993,1,0,"HARDING UNIVERSITY",NA,NA,793,437,356,244,101,143,0.327,0.308,0.284,5790,696
"460",107044,1995,1,0,"HARDING UNIVERSITY",NA,NA,779,437,342,250,92,158,0.362,0.321,0.269,6420,696
"461",107044,1996,1,0,"HARDING UNIVERSITY",NA,NA,846,497,349,266,85,181,0.364,0.314,0.244,6825,753
"462",107044,1997,1,0,"HARDING UNIVERSITY",NA,NA,863,495,368,271,85,186,0.376,0.314,0.231,7230,707
"463",107044,1998,1,0,"HARDING UNIVERSITY",NA,NA,908,535,373,285,101,184,0.344,0.314,0.271,7530,793
"464",107044,1999,1,0,"HARDING UNIVERSITY",NA,NA,941,488,453,313,130,183,0.375,0.333,0.287,7755,814
"465",107044,2000,1,0,"HARDING UNIVERSITY",NA,NA,975,557,418,365,137,228,0.409,0.374,0.328,8175,849
"466",107044,2001,1,0,"HARDING UNIVERSITY",NA,NA,979,547,432,365,145,220,0.402,0.373,0.336,8730,851
"467",107044,2002,1,0,"HARDING UNIVERSITY",NA,NA,1011,580,431,383,138,245,0.422,0.379,0.32,9180,879
"468",107044,2003,1,0,"HARDING UNIVERSITY",NA,NA,966,543,423,369,132,237,0.436,0.382,0.312,9720,859
"469",107044,2004,1,0,"HARDING UNIVERSITY",NA,NA,961,516,445,387,161,226,0.438,0.403,0.362,10380,855
"470",107044,2005,1,0,"Harding University",NA,NA,955,527,428,396,132,264,0.501,0.415,0.308,10800,837
"471",107044,2006,1,0,"Harding University",NA,NA,901,477,424,365,134,231,0.484,0.405,0.316,11250,783
"472",107044,2007,1,0,"Harding University",NA,NA,960,549,411,388,124,264,0.481,0.404,0.302,11940,833
"473",107044,2008,1,0,"Harding University",NA,NA,980,537,443,425,158,267,0.497,0.434,0.357,12690,870
"474",107044,2009,1,0,"Harding University",NA,NA,950,530,420,430,143,287,0.541,0.453,0.34,13140,788
"475",107044,2010,1,0,"Harding University",NA,NA,988,506,482,426,177,249,0.492,0.431,0.367,13590,848
"476",107080,1991,0,1,"HENDRIX COLLEGE",2002,0,281,146,135,141,67,74,0.507,0.502,0.496,7150,257
"477",107080,1992,0,1,"HENDRIX COLLEGE",2002,0,335,183,152,174,76,98,0.535,0.519,0.5,7710,299
"478",107080,1993,0,1,"HENDRIX COLLEGE",2002,0,273,165,108,152,58,94,0.57,0.557,0.537,8410,242
"479",107080,1995,0,1,"HENDRIX COLLEGE",2002,0,273,166,107,148,58,90,0.542,0.542,0.542,9325,248
"480",107080,1996,0,1,"HENDRIX COLLEGE",2002,0,306,185,121,188,78,110,0.595,0.614,0.645,9750,264
"481",107080,1997,0,1,"HENDRIX COLLEGE",2002,0,329,193,136,184,76,108,0.56,0.559,0.559,10280,275
"482",107080,1998,0,1,"HENDRIX COLLEGE",2002,0,320,166,154,196,89,107,0.645,0.613,0.578,10835,239
"483",107080,1999,0,1,"HENDRIX COLLEGE",2002,0,330,181,149,183,74,109,0.602,0.555,0.497,11440,271
"484",107080,2000,0,1,"HENDRIX COLLEGE",2002,0,326,173,153,194,85,109,0.63,0.595,0.556,12340,254
"485",107080,2001,0,1,"HENDRIX COLLEGE",2002,0,279,164,115,157,49,108,0.658,0.563,0.426,13071,191
"486",107080,2002,1,0,"HENDRIX COLLEGE",2002,1,317,184,133,199,73,126,0.685,0.628,0.549,14900,216
"487",107080,2003,1,0,"HENDRIX COLLEGE",2002,1,267,155,112,157,63,94,0.607,0.588,0.562,15630,183
"488",107080,2004,1,0,"HENDRIX COLLEGE",2002,1,295,165,130,159,69,90,0.545,0.539,0.531,16510,223
"489",107080,2005,1,0,"Hendrix College",2002,1,280,156,124,179,73,106,0.679,0.639,0.589,19508,236
"490",107080,2006,1,0,"Hendrix College",2002,1,396,222,174,251,99,152,0.685,0.634,0.569,20679,324
"491",107080,2007,1,0,"Hendrix College",2002,1,365,194,171,231,99,132,0.68,0.633,0.579,22125,305
"492",107080,2008,1,0,"Hendrix College",2002,1,430,238,192,284,122,162,0.681,0.66,0.635,23570,351
"493",107080,2009,1,0,"Hendrix College",2002,1,412,245,167,265,107,158,0.645,0.643,0.641,28713,315
"494",107080,2010,1,0,"Hendrix College",2002,1,403,237,166,259,96,163,0.688,0.643,0.578,30410,283
"495",107141,1991,1,0,"JOHN BROWN UNIVERSITY",NA,NA,219,123,96,65,29,36,0.293,0.297,0.302,5390,180
"496",107141,1992,1,0,"JOHN BROWN UNIVERSITY",NA,NA,196,109,87,70,31,39,0.358,0.357,0.356,5930,154
"497",107141,1993,1,0,"JOHN BROWN UNIVERSITY",NA,NA,245,139,106,76,29,47,0.338,0.31,0.274,6390,213
"498",107141,1995,1,0,"JOHN BROWN UNIVERSITY",NA,NA,224,115,109,71,28,43,0.374,0.317,0.257,7650,210
"499",107141,1996,1,0,"JOHN BROWN UNIVERSITY",NA,NA,266,148,118,101,37,64,0.432,0.38,0.314,8308,240
"500",107141,1997,1,0,"JOHN BROWN UNIVERSITY",NA,NA,225,121,104,83,37,46,0.38,0.369,0.356,9120,199
"501",107141,1998,1,0,"JOHN BROWN UNIVERSITY",NA,NA,250,138,112,112,44,68,0.493,0.448,0.393,9802,209
"502",107141,1999,1,0,"JOHN BROWN UNIVERSITY",NA,NA,267,149,118,113,39,74,0.497,0.423,0.331,10232,225
"503",107141,2000,1,0,"JOHN BROWN UNIVERSITY",NA,NA,276,164,112,140,51,89,0.543,0.507,0.455,11022,229
"504",107141,2001,1,0,"JOHN BROWN UNIVERSITY",NA,NA,241,149,92,132,50,82,0.55,0.548,0.543,11892,202
"505",107141,2002,1,0,"JOHN BROWN UNIVERSITY",NA,NA,303,186,117,176,64,112,0.602,0.581,0.547,12464,251
"506",107141,2003,1,0,"JOHN BROWN UNIVERSITY",NA,NA,274,140,134,145,68,77,0.55,0.529,0.507,13076,227
"507",107141,2004,1,0,"JOHN BROWN UNIVERSITY",NA,NA,296,156,140,155,67,88,0.564,0.524,0.479,13724,240
"508",107141,2005,1,0,"John Brown University",NA,NA,262,132,130,143,71,72,0.545,0.546,0.546,14544,227
"509",107141,2006,1,0,"John Brown University",NA,NA,326,168,158,190,78,112,0.667,0.583,0.494,15412,279
"510",107141,2007,1,0,"John Brown University",NA,NA,361,206,155,200,81,119,0.578,0.554,0.523,16396,303
"511",107141,2008,1,0,"John Brown University",NA,NA,307,165,142,160,72,88,0.533,0.521,0.507,17256,250
"512",107141,2009,1,0,"John Brown University",NA,NA,305,170,135,167,62,105,0.618,0.548,0.459,18032,250
"513",107141,2010,1,0,"John Brown University",NA,NA,322,175,147,180,82,98,0.56,0.559,0.558,18844,265
"514",107512,1991,1,0,"OUACHITA BAPTIST UNIVERSITY",NA,NA,338,182,156,115,44,71,0.39,0.34,0.282,5370,312
"515",107512,1992,1,0,"OUACHITA BAPTIST UNIVERSITY",NA,NA,296,148,148,121,36,85,0.574,0.409,0.243,5800,264
"516",107512,1993,1,0,"OUACHITA BAPTIST UNIVERSITY",NA,NA,443,217,226,174,86,88,0.405,0.393,0.381,6230,404
"517",107512,1995,1,0,"OUACHITA BAPTIST UNIVERSITY",NA,NA,380,206,174,173,75,98,0.476,0.455,0.431,7070,351
"518",107512,1996,1,0,"OUACHITA BAPTIST UNIVERSITY",NA,NA,451,237,214,184,69,115,0.485,0.408,0.322,7650,433
"519",107512,1997,1,0,"OUACHITA BAPTIST UNIVERSITY",NA,NA,404,230,174,164,59,105,0.456,0.406,0.339,8090,359
"520",107512,1998,1,0,"OUACHITA BAPTIST UNIVERSITY",NA,NA,362,220,142,120,36,84,0.382,0.331,0.254,8550,336
"521",107512,1999,1,0,"OUACHITA BAPTIST UNIVERSITY",NA,NA,443,256,187,197,72,125,0.488,0.445,0.385,8850,405
"522",107512,2000,1,0,"OUACHITA BAPTIST UNIVERSITY",NA,NA,440,247,193,187,69,118,0.478,0.425,0.358,9800,404
"523",107512,2001,1,0,"OUACHITA BAPTIST UNIVERSITY",NA,NA,400,214,186,183,73,110,0.514,0.458,0.392,11800,371
"524",107512,2002,1,0,"OUACHITA BAPTIST UNIVERSITY",NA,NA,396,229,167,166,64,102,0.445,0.419,0.383,11800,360
"525",107512,2003,1,0,"OUACHITA BAPTIST UNIVERSITY",NA,NA,343,195,148,140,52,88,0.451,0.408,0.351,12013,308
"526",107512,2004,1,0,"OUACHITA BAPTIST UNIVERSITY",NA,NA,380,223,157,170,49,121,0.543,0.447,0.312,13023,338
"527",107512,2005,1,0,"Ouachita Baptist University",NA,NA,365,213,152,181,66,115,0.54,0.496,0.434,14218,327
"528",107512,2006,1,0,"Ouachita Baptist University",NA,NA,367,190,177,185,73,112,0.59,0.504,0.412,15235,322
"529",107512,2007,1,0,"Ouachita Baptist University",NA,NA,372,202,170,179,60,119,0.589,0.481,0.353,16158,334
"530",107512,2008,1,0,"Ouachita Baptist University",NA,NA,404,220,184,205,80,125,0.568,0.507,0.435,17058,347
"531",107512,2009,1,0,"Ouachita Baptist University",NA,NA,389,198,191,208,84,124,0.626,0.535,0.44,18038,326
"532",107512,2010,1,0,"Ouachita Baptist University",NA,NA,450,243,207,264,102,162,0.667,0.587,0.493,18805,401
"533",107558,1991,1,0,"UNIVERSITY OF THE OZARKS",NA,NA,90,52,38,9,4,5,0.096,0.1,0.105,3520,83
"534",107558,1992,1,0,"UNIVERSITY OF THE OZARKS",NA,NA,120,53,67,11,7,4,0.076,0.092,0.104,4220,109
"535",107558,1993,1,0,"UNIVERSITY OF THE OZARKS",NA,NA,162,96,66,37,15,22,0.229,0.228,0.227,4920,144
"536",107558,1995,1,0,"UNIVERSITY OF THE OZARKS",NA,NA,133,66,67,29,14,15,0.227,0.218,0.209,6540,110
"537",107558,1996,1,0,"UNIVERSITY OF THE OZARKS",NA,NA,110,52,58,37,14,23,0.442,0.336,0.241,7140,93
"538",107558,1997,1,0,"UNIVERSITY OF THE OZARKS",NA,NA,155,66,89,44,21,23,0.349,0.284,0.236,7390,136
"539",107558,1998,1,0,"UNIVERSITY OF THE OZARKS",NA,NA,137,69,68,43,18,25,0.362,0.314,0.265,7990,102
"540",107558,1999,1,0,"UNIVERSITY OF THE OZARKS",NA,NA,164,93,71,53,17,36,0.387,0.323,0.239,8290,119
"541",107558,2000,1,0,"UNIVERSITY OF THE OZARKS",NA,NA,166,100,66,52,17,35,0.35,0.313,0.258,8830,141
"542",107558,2001,1,0,"UNIVERSITY OF THE OZARKS",NA,NA,190,116,74,61,22,39,0.336,0.321,0.297,9348,151
"543",107558,2002,1,0,"UNIVERSITY OF THE OZARKS",NA,NA,200,97,103,60,28,32,0.33,0.3,0.272,10282,156
"544",107558,2003,1,0,"UNIVERSITY OF THE OZARKS",NA,NA,206,113,93,63,20,43,0.38,0.306,0.215,11520,145
"545",107558,2004,1,0,"UNIVERSITY OF THE OZARKS",NA,NA,134,74,60,44,18,26,0.351,0.328,0.3,12902,106
"546",107558,2005,1,0,"University of the Ozarks",NA,NA,168,89,79,48,19,29,0.326,0.286,0.241,13740,117
"547",107558,2006,1,0,"University of the Ozarks",NA,NA,164,80,84,59,29,30,0.375,0.36,0.345,14470,109
"548",107558,2007,1,0,"University of the Ozarks",NA,NA,178,102,76,61,17,44,0.431,0.343,0.224,15630,132
"549",107558,2008,1,0,"University of the Ozarks",NA,NA,195,113,82,72,27,45,0.398,0.369,0.329,16730,152
"550",107558,2009,1,0,"University of the Ozarks",NA,NA,152,72,80,39,12,27,0.375,0.257,0.15,18300,110
"551",107558,2010,1,0,"University of the Ozarks",NA,NA,204,114,90,61,28,33,0.29,0.299,0.311,19930,152
"552",110097,1991,1,0,"BIOLA UNIVERSITY",NA,NA,391,256,135,155,45,110,0.43,0.396,0.333,9902,296
"553",110097,1992,1,0,"BIOLA UNIVERSITY",NA,NA,464,290,174,176,64,112,0.386,0.379,0.368,10756,331
"554",110097,1993,1,0,"BIOLA UNIVERSITY",NA,NA,444,286,158,157,48,109,0.381,0.354,0.304,11388,301
"555",110097,1995,1,0,"BIOLA UNIVERSITY",NA,NA,407,278,129,168,45,123,0.442,0.413,0.349,12652,299
"556",110097,1996,1,0,"BIOLA UNIVERSITY",NA,NA,407,268,139,184,62,122,0.455,0.452,0.446,13408,309
"557",110097,1997,1,0,"BIOLA UNIVERSITY",NA,NA,437,296,141,204,60,144,0.486,0.467,0.426,14286,338
"558",110097,1998,1,0,"BIOLA UNIVERSITY",NA,NA,469,313,156,227,75,152,0.486,0.484,0.481,15214,368
"559",110097,1999,1,0,"BIOLA UNIVERSITY",NA,NA,563,373,190,370,123,247,0.662,0.657,0.647,15914,426
"560",110097,2000,1,0,"BIOLA UNIVERSITY",NA,NA,608,409,199,326,88,238,0.582,0.536,0.442,16630,498
"561",110097,2001,1,0,"BIOLA UNIVERSITY",NA,NA,649,426,223,360,113,247,0.58,0.555,0.507,17410,514
"562",110097,2002,1,0,"BIOLA UNIVERSITY",NA,NA,656,414,242,345,108,237,0.573,0.526,0.446,18456,525
"563",110097,2003,1,0,"BIOLA UNIVERSITY",NA,NA,685,459,226,348,104,244,0.532,0.508,0.46,19564,553
"564",110097,2004,1,0,"BIOLA UNIVERSITY",NA,NA,691,443,248,346,120,226,0.51,0.501,0.484,20932,494
"565",110097,2005,1,0,"Biola University",NA,NA,670,416,254,337,111,226,0.543,0.503,0.437,22602,467
"566",110097,2006,1,0,"Biola University",NA,NA,799,521,278,364,102,262,0.503,0.456,0.367,23782,553
"567",110097,2007,1,0,"Biola University",NA,NA,789,514,275,385,118,267,0.52,0.488,0.429,24998,536
"568",110097,2008,1,0,"Biola University",NA,NA,846,530,316,430,157,273,0.515,0.508,0.497,26424,563
"569",110097,2009,1,0,"Biola University",NA,NA,775,508,267,402,131,271,0.533,0.519,0.491,27744,489
"570",110097,2010,1,0,"Biola University",NA,NA,877,560,317,471,159,312,0.557,0.537,0.502,28852,498
"571",110404,1991,0,1,"CALIFORNIA INSTITUTE OF TECHNOLOGY",9999,0,225,73,152,146,99,47,0.644,0.649,0.651,14230,126
"572",110404,1992,0,1,"CALIFORNIA INSTITUTE OF TECHNOLOGY",9999,0,233,60,173,165,119,46,0.767,0.708,0.688,15080,132
"573",110404,1993,0,1,"CALIFORNIA INSTITUTE OF TECHNOLOGY",9999,0,209,63,146,151,109,42,0.667,0.722,0.747,16030,117
"574",110404,1995,0,1,"CALIFORNIA INSTITUTE OF TECHNOLOGY",9999,0,218,52,166,156,108,48,0.923,0.716,0.651,17370,145
"575",110404,1996,0,1,"CALIFORNIA INSTITUTE OF TECHNOLOGY",9999,0,216,64,152,156,112,44,0.688,0.722,0.737,18000,140
"576",110404,1997,0,1,"CALIFORNIA INSTITUTE OF TECHNOLOGY",9999,0,217,64,153,169,119,50,0.781,0.779,0.778,18736,127
"577",110404,1998,0,1,"CALIFORNIA INSTITUTE OF TECHNOLOGY",9999,0,254,79,175,195,136,59,0.747,0.768,0.777,19166,153
"578",110404,1999,0,1,"CALIFORNIA INSTITUTE OF TECHNOLOGY",9999,0,234,83,151,195,126,69,0.831,0.833,0.834,19260,150
"579",110404,2000,0,1,"CALIFORNIA INSTITUTE OF TECHNOLOGY",9999,0,205,74,131,166,107,59,0.797,0.81,0.817,19743,110
"580",110404,2001,0,1,"CALIFORNIA INSTITUTE OF TECHNOLOGY",9999,0,214,78,136,175,110,65,0.833,0.818,0.809,20904,109
"581",110404,2002,0,1,"CALIFORNIA INSTITUTE OF TECHNOLOGY",9999,0,252,73,179,203,138,65,0.89,0.806,0.771,21903,148
"582",110404,2003,0,1,"CALIFORNIA INSTITUTE OF TECHNOLOGY",9999,0,190,64,126,138,90,48,0.75,0.726,0.714,23901,89
"583",110404,2004,0,1,"CALIFORNIA INSTITUTE OF TECHNOLOGY",9999,0,207,59,148,167,117,50,0.848,0.807,0.791,25335,115
"584",110404,2005,0,1,"California Institute of Technology",9999,0,233,69,164,178,127,51,0.739,0.764,0.774,27309,105
"585",110404,2006,0,1,"California Institute of Technology",9999,0,210,60,150,166,113,53,0.883,0.79,0.753,28515,79
"586",110404,2007,0,1,"California Institute of Technology",9999,0,231,86,145,190,117,73,0.849,0.823,0.807,29940,97
"587",110404,2008,0,1,"California Institute of Technology",9999,0,236,97,139,200,112,88,0.907,0.847,0.806,31437,93
"588",110404,2009,0,1,"California Institute of Technology",9999,0,251,106,145,212,122,90,0.849,0.845,0.841,33324,92
"589",110404,2010,0,1,"California Institute of Technology",9999,0,220,87,133,179,105,74,0.851,0.814,0.789,34989,78
"590",110422,1991,0,1,"CALIFORNIA POLYTECHNIC STATE UNIV-SAN LUIS OBISPO",9999,0,1526,717,809,121,36,85,0.118,0.079,0.044,936,868
"591",110422,1992,0,1,"CALIFORNIA POLYTECHNIC STATE UNIV-SAN LUIS OBISPO",9999,0,1295,566,729,136,37,99,0.175,0.105,0.051,1616,713
"592",110422,1993,0,1,"CALIFORNIA POLYTECHNIC STATE UNIV-SAN LUIS OBISPO",9999,0,1600,722,878,155,36,119,0.165,0.097,0.041,1674,948
"593",110422,1995,0,1,"CALIFORNIA POLYTECHNIC STATE UNIV-SAN LUIS OBISPO",9999,0,2418,1092,1326,356,114,242,0.222,0.147,0.086,1891,1492
"594",110422,1996,0,1,"CALIFORNIA POLYTECHNIC STATE UNIV-SAN LUIS OBISPO",9999,0,2757,1202,1555,448,132,316,0.263,0.162,0.085,1935,1769
"595",110422,1997,0,1,"CALIFORNIA POLYTECHNIC STATE UNIV-SAN LUIS OBISPO",9999,0,2114,951,1163,318,108,210,0.221,0.15,0.093,2228,1243
"596",110422,1998,0,1,"CALIFORNIA POLYTECHNIC STATE UNIV-SAN LUIS OBISPO",9999,0,2260,945,1315,367,136,231,0.244,0.162,0.103,2204,1505
"597",110422,1999,0,1,"CALIFORNIA POLYTECHNIC STATE UNIV-SAN LUIS OBISPO",9999,0,2673,1277,1396,557,167,390,0.305,0.208,0.12,0,1169
"598",110422,2000,0,1,"CALIFORNIA POLYTECHNIC STATE UNIV-SAN LUIS OBISPO",9999,0,3053,1332,1721,607,212,395,0.296,0.199,0.123,0,1973
"599",110422,2001,0,1,"CALIFORNIA POLYTECHNIC STATE UNIV-SAN LUIS OBISPO",9999,0,2957,1374,1583,629,220,409,0.298,0.213,0.139,0,2041
"600",110422,2002,0,1,"CALIFORNIA POLYTECHNIC STATE UNIV-SAN LUIS OBISPO",9999,0,2565,1158,1407,587,209,378,0.326,0.229,0.149,0,1748
"601",110422,2003,0,1,"CALIFORNIA POLYTECHNIC STATE UNIV-SAN LUIS OBISPO",9999,0,2798,1239,1559,673,264,409,0.33,0.241,0.169,0,1920
"602",110422,2004,0,1,"CALIFORNIA POLYTECHNIC STATE UNIVERSITY-SAN LUIS OBISPO",9999,0,2900,1169,1731,767,304,463,0.396,0.264,0.176,0,1962
"603",110422,2005,0,1,"California Polytechnic State University-San Luis Obispo",9999,0,3318,1599,1719,1021,345,676,0.423,0.308,0.201,0,2270
"604",110422,2006,0,1,"California Polytechnic State University-San Luis Obispo",9999,0,3761,1648,2113,1044,362,682,0.414,0.278,0.171,0,2457
"605",110422,2007,0,1,"California Polytechnic State University-San Luis Obispo",9999,0,4419,1885,2534,1282,460,822,0.436,0.29,0.182,0,2860
"606",110422,2008,0,1,"California Polytechnic State University-San Luis Obispo",9999,0,3448,1553,1895,1246,458,788,0.507,0.361,0.242,0,2298
"607",110422,2009,0,1,"California Polytechnic State University-San Luis Obispo",9999,0,3877,1803,2074,1557,593,964,0.535,0.402,0.286,0,2461
"608",110422,2010,0,1,"California Polytechnic State University-San Luis Obispo",9999,0,3459,1642,1817,1634,636,998,0.608,0.472,0.35,0,2245
"609",110486,1991,0,1,"CALIFORNIA STATE COLLEGE-BAKERSFIELD",9999,0,363,200,163,26,16,10,0.05,0.072,0.098,936,143
"610",110486,1992,0,1,"CALIFORNIA STATE BAKERSFIELD UNIVERSITY",9999,0,323,181,142,32,11,21,0.116,0.099,0.077,1444,117
"611",110486,1993,0,1,"CALIFORNIA STATE UNIVERSITY-BAKERSFIELD",9999,0,317,200,117,38,12,26,0.13,0.12,0.103,1674,99
"612",110486,1995,0,1,"CALIFORNIA STATE UNIVERSITY-BAKERSFIELD",9999,0,397,236,161,43,11,32,0.136,0.108,0.068,1891,132
"613",110486,1996,0,1,"CALIFORNIA STATE UNIVERSITY-BAKERSFIELD",9999,0,418,253,165,56,14,42,0.166,0.134,0.085,1935,150
"614",110486,1997,0,1,"CALIFORNIA STATE UNIVERSITY-BAKERSFIELD",9999,0,467,288,179,49,15,34,0.118,0.105,0.084,1951,169
"615",110486,1998,0,1,"CALIFORNIA STATE UNIVERSITY-BAKERSFIELD",9999,0,471,298,173,54,9,45,0.151,0.115,0.052,1873,168
"616",110486,1999,0,1,"CALIFORNIA STATE UNIVERSITY-BAKERSFIELD",9999,0,517,319,198,69,14,55,0.172,0.133,0.071,0,191
"617",110486,2000,0,1,"CALIFORNIA STATE UNIVERSITY-BAKERSFIELD",9999,0,545,349,196,77,22,55,0.158,0.141,0.112,0,212
"618",110486,2001,0,1,"CALIFORNIA STATE UNIVERSITY-BAKERSFIELD",9999,0,610,393,217,86,20,66,0.168,0.141,0.092,0,210
"619",110486,2002,0,1,"CALIFORNIA STATE UNIVERSITY-BAKERSFIELD",9999,0,679,408,271,99,28,71,0.174,0.146,0.103,0,220
"620",110486,2003,0,1,"CALIFORNIA STATE UNIVERSITY-BAKERSFIELD",9999,0,714,476,238,92,23,69,0.145,0.129,0.097,0,237
"621",110486,2004,0,1,"CALIFORNIA STATE UNIVERSITY-BAKERSFIELD",9999,0,745,483,262,128,32,96,0.199,0.172,0.122,0,251
"622",110486,2005,0,1,"California State University-Bakersfield",9999,0,766,503,263,114,21,93,0.185,0.149,0.08,0,209
"623",110486,2006,0,1,"California State University-Bakersfield",9999,0,854,553,301,120,29,91,0.165,0.141,0.096,0,216
"624",110486,2007,0,1,"California State University-Bakersfield",9999,0,859,578,281,129,25,104,0.18,0.15,0.089,0,208
"625",110486,2008,0,1,"California State University-Bakersfield",9999,0,901,592,309,144,45,99,0.167,0.16,0.146,0,142
"626",110486,2009,0,1,"California State University-Bakersfield",9999,0,1061,652,409,139,39,100,0.153,0.131,0.095,0,158
"627",110486,2010,0,1,"California State University-Bakersfield",9999,0,1013,613,400,148,50,98,0.16,0.146,0.125,0,158
"628",110495,1991,1,0,"CALIFORNIA STATE UNIVERSITY-STANISLAUS",NA,NA,273,164,109,39,8,31,0.189,0.143,0.073,936,130
"629",110495,1992,1,0,"CALIFORNIA STATE UNIVERSITY-STANISLAUS",NA,NA,307,191,116,33,11,22,0.115,0.107,0.095,1434,133
"630",110495,1993,1,0,"CALIFORNIA STATE UNIVERSITY-STANISLAUS",NA,NA,387,232,155,60,22,38,0.164,0.155,0.142,1674,194
"631",110495,1995,1,0,"CALIFORNIA STATE UNIVERSITY-STANISLAUS",NA,NA,353,242,111,75,12,63,0.26,0.212,0.108,1891,167
"632",110495,1996,1,0,"CALIFORNIA STATE UNIVERSITY-STANISLAUS",NA,NA,381,244,137,85,22,63,0.258,0.223,0.161,1935,172
"633",110495,1997,1,0,"CALIFORNIA STATE UNIVERSITY-STANISLAUS",NA,NA,409,270,139,84,19,65,0.241,0.205,0.137,1915,191
"634",110495,1998,1,0,"CALIFORNIA STATE UNIVERSITY-STANISLAUS",NA,NA,444,297,147,84,16,68,0.229,0.189,0.109,1830,211
"635",110495,1999,1,0,"CALIFORNIA STATE UNIVERSITY-STANISLAUS",NA,NA,470,310,160,101,16,85,0.274,0.215,0.1,0,222
"636",110495,2000,1,0,"CALIFORNIA STATE UNIVERSITY-STANISLAUS",NA,NA,565,362,203,113,27,86,0.238,0.2,0.133,0,223
"637",110495,2001,1,0,"CALIFORNIA STATE UNIVERSITY-STANISLAUS",NA,NA,516,352,164,96,24,72,0.204,0.186,0.146,0,225
"638",110495,2002,1,0,"CALIFORNIA STATE UNIVERSITY-STANISLAUS",NA,NA,550,360,190,116,20,96,0.267,0.211,0.105,0,232
"639",110495,2003,1,0,"CALIFORNIA STATE UNIVERSITY-STANISLAUS",NA,NA,551,365,186,119,37,82,0.225,0.216,0.199,0,232
"640",110495,2004,1,0,"CALIFORNIA STATE UNIVERSITY-STANISLAUS",NA,NA,653,456,197,153,41,112,0.246,0.234,0.208,0,288
"641",110495,2005,1,0,"California State University-Stanislaus",NA,NA,741,511,230,151,31,120,0.235,0.204,0.135,0,288
"642",110495,2006,1,0,"California State University-Stanislaus",NA,NA,846,570,276,148,37,111,0.195,0.175,0.134,0,324
"643",110495,2007,1,0,"California State University-Stanislaus",NA,NA,910,592,318,166,34,132,0.223,0.182,0.107,0,347
"644",110495,2008,1,0,"California State University-Stanislaus",NA,NA,899,576,323,133,33,100,0.174,0.148,0.102,0,338
"645",110495,2009,1,0,"California State University-Stanislaus",NA,NA,798,555,243,124,37,87,0.157,0.155,0.152,0,258
"646",110495,2010,1,0,"California State University-Stanislaus",NA,NA,998,670,328,156,41,115,0.172,0.156,0.125,0,265
"647",110510,1991,0,1,"CALIFORNIA STATE UNIVERSITY-SAN BERNARDINO",9999,0,815,505,310,58,17,41,0.081,0.071,0.055,936,387
"648",110510,1992,0,1,"CALIFORNIA STATE UNIVERSITY-SAN BERNARDINO",9999,0,737,449,288,59,23,36,0.08,0.08,0.08,1443,321
"649",110510,1993,0,1,"CALIFORNIA STATE UNIVERSITY-SAN BERNARDINO",9999,0,692,433,259,37,9,28,0.065,0.053,0.035,1674,277
"650",110510,1995,0,1,"CALIFORNIA STATE UNIVERSITY-SAN BERNARDINO",9999,0,799,505,294,58,16,42,0.083,0.073,0.054,1891,280
"651",110510,1996,0,1,"CALIFORNIA STATE UNIVERSITY-SAN BERNARDINO",9999,0,882,554,328,78,18,60,0.108,0.088,0.055,1935,324
"652",110510,1997,0,1,"CALIFORNIA STATE UNIVERSITY-SAN BERNARDINO",9999,0,890,559,331,83,26,57,0.102,0.093,0.079,1889,315
"653",110510,1998,0,1,"CALIFORNIA STATE UNIVERSITY-SAN BERNARDINO",9999,0,1068,680,388,124,39,85,0.125,0.116,0.101,1779,390
"654",110510,1999,0,1,"CALIFORNIA STATE UNIVERSITY-SAN BERNARDINO",9999,0,1049,679,370,105,30,75,0.111,0.1,0.081,0,342
"655",110510,2000,0,1,"CALIFORNIA STATE UNIVERSITY-SAN BERNARDINO",9999,0,1146,750,396,142,33,109,0.145,0.124,0.083,0,373
"656",110510,2001,0,1,"CALIFORNIA STATE UNIVERSITY-SAN BERNARDINO",9999,0,1273,774,499,127,36,91,0.118,0.1,0.072,0,387
"657",110510,2002,0,1,"CALIFORNIA STATE UNIVERSITY-SAN BERNARDINO",9999,0,1161,751,410,142,32,110,0.147,0.122,0.078,0,323
"658",110510,2003,0,1,"CALIFORNIA STATE UNIVERSITY-SAN BERNARDINO",9999,0,1335,918,417,178,45,133,0.145,0.133,0.108,0,386
"659",110510,2004,0,1,"CALIFORNIA STATE UNIVERSITY-SAN BERNARDINO",9999,0,1587,1099,488,208,53,155,0.141,0.131,0.109,0,351
"660",110510,2005,0,1,"California State University-San Bernardino",9999,0,1645,1092,553,212,75,137,0.126,0.129,0.136,0,393
"661",110510,2006,0,1,"California State University-San Bernardino",9999,0,1774,1157,617,201,55,146,0.126,0.113,0.089,0,405
"662",110510,2007,0,1,"California State University-San Bernardino",9999,0,1656,1098,558,156,43,113,0.103,0.094,0.077,0,334
"663",110510,2008,0,1,"California State University-San Bernardino",9999,0,1916,1213,703,241,77,164,0.135,0.126,0.11,0,390
"664",110510,2009,0,1,"California State University-San Bernardino",9999,0,1968,1275,693,265,75,190,0.149,0.135,0.108,0,304
"665",110510,2010,0,1,"California State University-San Bernardino",9999,0,1747,1114,633,251,73,178,0.16,0.144,0.115,0,263
"666",110529,1991,0,1,"CALIFORNIA STATE POLYTECHNIC UNIVERSITY POMONA",9999,0,1583,650,933,96,28,68,0.105,0.061,0.03,936,470
"667",110529,1992,0,1,"CALIFORNIA STATE POLYTECHNIC UNIVERSITY POMONA",9999,0,1358,551,807,84,34,50,0.091,0.062,0.042,1384,373
"668",110529,1993,0,1,"CALIFORNIA STATE POLYTECHNIC UNIVERSITY-POMONA",9999,0,1309,536,773,105,42,63,0.118,0.08,0.054,1674,383
"669",110529,1995,0,1,"CALIFORNIA STATE POLYTECHNIC UNIVERSITY-POMONA",9999,0,1422,621,801,96,37,59,0.095,0.068,0.046,1891,374
"670",110529,1996,0,1,"CALIFORNIA STATE POLYTECHNIC UNIVERSITY-POMONA",9999,0,1497,647,850,128,56,72,0.111,0.086,0.066,1935,393
"671",110529,1997,0,1,"CALIFORNIA STATE POLYTECHNIC UNIVERSITY-POMONA",9999,0,1856,810,1046,157,56,101,0.125,0.085,0.054,1903,466
"672",110529,1998,0,1,"CALIFORNIA STATE POLYTECHNIC UNIVERSITY-POMONA",9999,0,2033,855,1178,191,80,111,0.13,0.094,0.068,1855,516
"673",110529,1999,0,1,"CALIFORNIA STATE POLYTECHNIC UNIVERSITY-POMONA",9999,0,2489,1008,1481,226,90,136,0.135,0.091,0.061,0,599
"674",110529,2000,0,1,"CALIFORNIA STATE POLYTECHNIC UNIVERSITY-POMONA",9999,0,2600,1121,1479,265,113,152,0.136,0.102,0.076,0,578
"675",110529,2001,0,1,"CALIFORNIA STATE POLYTECHNIC UNIVERSITY-POMONA",9999,0,2412,961,1451,229,91,138,0.144,0.095,0.063,0,535
"676",110529,2002,0,1,"CALIFORNIA STATE POLYTECHNIC UNIVERSITY-POMONA",9999,0,2674,1080,1594,345,161,184,0.17,0.129,0.101,0,651
"677",110529,2003,0,1,"CALIFORNIA STATE POLYTECHNIC UNIVERSITY-POMONA",9999,0,2558,1107,1451,384,172,212,0.192,0.15,0.119,0,693
"678",110529,2004,0,1,"CALIFORNIA STATE POLYTECHNIC UNIVERSITY-POMONA",9999,0,2115,921,1194,412,188,224,0.243,0.195,0.157,0,588
"679",110529,2005,0,1,"California State Polytechnic University-Pomona",9999,0,3089,1296,1793,380,157,223,0.172,0.123,0.088,0,773
"680",110529,2006,0,1,"California State Polytechnic University-Pomona",9999,0,3138,1357,1781,341,128,213,0.157,0.109,0.072,0,769
"681",110529,2007,0,1,"California State Polytechnic University-Pomona",9999,0,3414,1459,1955,343,118,225,0.154,0.1,0.06,0,770
"682",110529,2008,0,1,"California State Polytechnic University-Pomona",9999,0,2538,1068,1470,299,135,164,0.154,0.118,0.092,0,680
"683",110529,2009,0,1,"California State Polytechnic University-Pomona",9999,0,2728,1192,1536,401,134,267,0.224,0.147,0.087,0,714
"684",110529,2010,0,1,"California State Polytechnic University-Pomona",9999,0,1923,835,1088,352,150,202,0.242,0.183,0.138,0,458
"685",110538,1991,1,0,"CALIFORNIA STATE UNIVERSITY-CHICO",NA,NA,1284,731,553,171,35,136,0.186,0.133,0.063,936,1009
"686",110538,1992,1,0,"CALIFORNIA STATE UNIVERSITY-CHICO",NA,NA,1325,758,567,148,34,114,0.15,0.112,0.06,1452,1018
"687",110538,1993,1,0,"CALIFORNIA STATE UNIVERSITY-CHICO",NA,NA,1244,754,490,169,27,142,0.188,0.136,0.055,1674,899
"688",110538,1995,1,0,"CALIFORNIA STATE UNIVERSITY-CHICO",NA,NA,1401,832,569,161,22,139,0.167,0.115,0.039,1891,940
"689",110538,1996,1,0,"CALIFORNIA STATE UNIVERSITY-CHICO",NA,NA,1524,874,650,173,35,138,0.158,0.114,0.054,1935,1018
"690",110538,1997,1,0,"CALIFORNIA STATE UNIVERSITY-CHICO",NA,NA,1618,948,670,246,45,201,0.212,0.152,0.067,2076,1125
"691",110538,1998,1,0,"CALIFORNIA STATE UNIVERSITY-CHICO",NA,NA,1850,1069,781,299,65,234,0.219,0.162,0.083,2026,1263
"692",110538,1999,1,0,"CALIFORNIA STATE UNIVERSITY-CHICO",NA,NA,2007,1139,868,304,67,237,0.208,0.151,0.077,0,1398
"693",110538,2000,1,0,"CALIFORNIA STATE UNIVERSITY-CHICO",NA,NA,1931,1079,852,336,79,257,0.238,0.174,0.093,0,1336
"694",110538,2001,1,0,"CALIFORNIA STATE UNIVERSITY-CHICO",NA,NA,2092,1175,917,314,64,250,0.213,0.15,0.07,0,1444
"695",110538,2002,1,0,"CALIFORNIA STATE UNIVERSITY-CHICO",NA,NA,1995,1125,870,372,95,277,0.246,0.186,0.109,0,1353
"696",110538,2003,1,0,"CALIFORNIA STATE UNIVERSITY-CHICO",NA,NA,1970,1140,830,322,71,251,0.22,0.163,0.086,0,1385
"697",110538,2004,1,0,"CALIFORNIA STATE UNIVERSITY-CHICO",NA,NA,2198,1266,932,436,102,334,0.264,0.198,0.109,0,1485
"698",110538,2005,1,0,"California State University-Chico",NA,NA,2300,1237,1063,439,118,321,0.26,0.191,0.111,0,1452
"699",110538,2006,1,0,"California State University-Chico",NA,NA,2430,1326,1104,420,103,317,0.239,0.173,0.093,0,1597
"700",110538,2007,1,0,"California State University-Chico",NA,NA,2710,1418,1292,458,138,320,0.226,0.169,0.107,0,1765
"701",110538,2008,1,0,"California State University-Chico",NA,NA,2727,1420,1307,537,163,374,0.263,0.197,0.125,0,1821
"702",110538,2009,1,0,"California State University-Chico",NA,NA,2468,1338,1130,561,159,402,0.3,0.227,0.141,0,1488
"703",110538,2010,1,0,"California State University-Chico",NA,NA,1880,1048,832,484,160,324,0.309,0.257,0.192,0,1015
"704",110547,1991,1,0,"CALIFORNIA STATE UNIVERSITY-DOMINGUEZ HILLS",NA,NA,337,227,110,9,2,7,0.031,0.027,0.018,936,50
"705",110547,1992,1,0,"CALIFORNIA STATE UNIVERSITY-DOMINGUEZ HILLS",NA,NA,485,336,149,16,6,10,0.03,0.033,0.04,1399,53
"706",110547,1993,1,0,"CALIFORNIA STATE UNIVERSITY-DOMINGUEZ HILLS",NA,NA,389,252,137,15,5,10,0.04,0.039,0.036,1674,46
"707",110547,1995,1,0,"CALIFORNIA STATE UNIVERSITY-DOMINGUEZ HILLS",NA,NA,467,335,132,19,4,15,0.045,0.041,0.03,1891,23
"708",110547,1996,1,0,"CALIFORNIA STATE UNIVERSITY-DOMINGUEZ HILLS",NA,NA,475,358,117,24,3,21,0.059,0.051,0.026,1935,14
"709",110547,1997,1,0,"CALIFORNIA STATE UNIVERSITY-DOMINGUEZ HILLS",NA,NA,512,363,149,17,2,15,0.041,0.033,0.013,1791,27
"710",110547,1998,1,0,"CALIFORNIA STATE UNIVERSITY-DOMINGUEZ HILLS",NA,NA,465,330,135,21,3,18,0.054,0.045,0.022,1748,20
"711",110547,1999,1,0,"CALIFORNIA STATE UNIVERSITY-DOMINGUEZ HILLS",NA,NA,453,319,134,26,5,21,0.066,0.057,0.037,0,24
"712",110547,2000,1,0,"CALIFORNIA STATE UNIVERSITY-DOMINGUEZ HILLS",NA,NA,495,355,140,31,7,24,0.068,0.063,0.05,0,25
"713",110547,2001,1,0,"CALIFORNIA STATE UNIVERSITY-DOMINGUEZ HILLS",NA,NA,561,391,170,26,6,20,0.051,0.046,0.035,0,25
"714",110547,2002,1,0,"CALIFORNIA STATE UNIVERSITY-DOMINGUEZ HILLS",NA,NA,630,466,164,28,6,22,0.047,0.044,0.037,0,30
"715",110547,2003,1,0,"CALIFORNIA STATE UNIVERSITY-DOMINGUEZ HILLS",NA,NA,639,458,181,31,5,26,0.057,0.049,0.028,0,25
"716",110547,2004,1,0,"CALIFORNIA STATE UNIVERSITY-DOMINGUEZ HILLS",NA,NA,673,459,214,35,10,25,0.054,0.052,0.047,0,36
"717",110547,2005,1,0,"California State University-Dominguez Hills",NA,NA,705,476,229,42,9,33,0.069,0.06,0.039,0,34
"718",110547,2006,1,0,"California State University-Dominguez Hills",NA,NA,984,716,268,41,8,33,0.046,0.042,0.03,0,41
"719",110547,2007,1,0,"California State University-Dominguez Hills",NA,NA,913,602,311,35,11,24,0.04,0.038,0.035,0,38
"720",110547,2008,1,0,"California State University-Dominguez Hills",NA,NA,889,599,290,42,14,28,0.047,0.047,0.048,0,35
"721",110547,2009,1,0,"California State University-Dominguez Hills",NA,NA,1069,703,366,66,13,53,0.075,0.062,0.036,0,34
"722",110547,2010,1,0,"California State University-Dominguez Hills",NA,NA,982,633,349,50,17,33,0.052,0.051,0.049,0,41
"723",110556,1991,1,0,"CALIFORNIA STATE UNIVERSITY-FRESNO",NA,NA,1648,902,746,173,61,112,0.124,0.105,0.082,936,711
"724",110556,1992,1,0,"CALIFORNIA STATE UNIVERSITY-FRESNO",NA,NA,1559,860,699,165,52,113,0.131,0.106,0.074,1446,666
"725",110556,1993,1,0,"CALIFORNIA STATE UNIVERSITY-FRESNO",NA,NA,1436,792,644,152,32,120,0.152,0.106,0.05,1674,522
"726",110556,1995,1,0,"CALIFORNIA STATE UNIVERSITY-FRESNO",NA,NA,1571,915,656,176,44,132,0.144,0.112,0.067,1891,537
"727",110556,1996,1,0,"CALIFORNIA STATE UNIVERSITY-FRESNO",NA,NA,1503,846,657,198,54,144,0.17,0.132,0.082,1935,469
"728",110556,1997,1,0,"CALIFORNIA STATE UNIVERSITY-FRESNO",NA,NA,1510,901,609,180,69,111,0.123,0.119,0.113,1802,486
"729",110556,1998,1,0,"CALIFORNIA STATE UNIVERSITY-FRESNO",NA,NA,1566,933,633,215,44,171,0.183,0.137,0.07,1754,488
"730",110556,1999,1,0,"CALIFORNIA STATE UNIVERSITY-FRESNO",NA,NA,1703,1002,701,225,56,169,0.169,0.132,0.08,0,573
"731",110556,2000,1,0,"CALIFORNIA STATE UNIVERSITY-FRESNO",NA,NA,1885,1138,747,227,67,160,0.141,0.12,0.09,0,629
"732",110556,2001,1,0,"CALIFORNIA STATE UNIVERSITY-FRESNO",NA,NA,1946,1179,767,275,74,201,0.17,0.141,0.096,0,704
"733",110556,2002,1,0,"CALIFORNIA STATE UNIVERSITY-FRESNO",NA,NA,2189,1274,915,346,109,237,0.186,0.158,0.119,0,825
"734",110556,2003,1,0,"CALIFORNIA STATE UNIVERSITY-FRESNO",NA,NA,2485,1503,982,353,101,252,0.168,0.142,0.103,0,915
"735",110556,2004,1,0,"CALIFORNIA STATE UNIVERSITY-FRESNO",NA,NA,2243,1351,892,378,102,276,0.204,0.169,0.114,0,839
"736",110556,2005,1,0,"California State University-Fresno",NA,NA,2356,1403,953,323,106,217,0.155,0.137,0.111,0,785
"737",110556,2006,1,0,"California State University-Fresno",NA,NA,2528,1501,1027,344,108,236,0.157,0.136,0.105,0,843
"738",110556,2007,1,0,"California State University-Fresno",NA,NA,2552,1526,1026,350,112,238,0.156,0.137,0.109,0,797
"739",110556,2008,1,0,"California State University-Fresno",NA,NA,2731,1604,1127,402,121,281,0.175,0.147,0.107,0,847
"740",110556,2009,1,0,"California State University-Fresno",NA,NA,2619,1574,1045,407,123,284,0.18,0.155,0.118,0,780
"741",110556,2010,1,0,"California State University-Fresno",NA,NA,2582,1551,1031,420,116,304,0.196,0.163,0.113,0,667
"742",110565,1991,1,0,"CALIFORNIA STATE UNIVERSITY-FULLERTON",NA,NA,1847,1094,753,137,30,107,0.098,0.074,0.04,936,714
"743",110565,1992,1,0,"CALIFORNIA STATE UNIVERSITY-FULLERTON",NA,NA,1589,926,663,108,27,81,0.088,0.068,0.041,1480,562
"744",110565,1993,1,0,"CALIFORNIA STATE UNIVERSITY-FULLERTON",NA,NA,1309,748,561,112,40,72,0.096,0.086,0.071,1674,431
"745",110565,1995,1,0,"CALIFORNIA STATE UNIVERSITY-FULLERTON",NA,NA,1832,1036,796,148,41,107,0.103,0.081,0.052,1891,556
"746",110565,1996,1,0,"CALIFORNIA STATE UNIVERSITY-FULLERTON",NA,NA,2028,1158,870,199,48,151,0.13,0.098,0.055,1935,610
"747",110565,1997,1,0,"CALIFORNIA STATE UNIVERSITY-FULLERTON",NA,NA,2192,1317,875,215,48,167,0.127,0.098,0.055,1936,625
"748",110565,1998,1,0,"CALIFORNIA STATE UNIVERSITY-FULLERTON",NA,NA,2146,1240,906,274,65,209,0.168,0.128,0.072,1858,636
"749",110565,1999,1,0,"CALIFORNIA STATE UNIVERSITY-FULLERTON",NA,NA,2544,1543,1001,349,63,286,0.185,0.137,0.063,0,758
"750",110565,2000,1,0,"CALIFORNIA STATE UNIVERSITY-FULLERTON",NA,NA,2655,1609,1046,381,83,298,0.185,0.144,0.079,0,843
"751",110565,2001,1,0,"CALIFORNIA STATE UNIVERSITY-FULLERTON",NA,NA,2772,1673,1099,416,86,330,0.197,0.15,0.078,0,846
"752",110565,2002,1,0,"CALIFORNIA STATE UNIVERSITY-FULLERTON",NA,NA,3291,2039,1252,481,111,370,0.182,0.146,0.089,0,1076
"753",110565,2003,1,0,"CALIFORNIA STATE UNIVERSITY-FULLERTON",NA,NA,3098,1873,1225,481,107,374,0.2,0.155,0.087,0,1018
"754",110565,2004,1,0,"CALIFORNIA STATE UNIVERSITY-FULLERTON",NA,NA,3539,2094,1445,583,148,435,0.208,0.165,0.102,0,1117
"755",110565,2005,1,0,"California State University-Fullerton",NA,NA,3816,2241,1575,524,134,390,0.174,0.137,0.085,0,1127
"756",110565,2006,1,0,"California State University-Fullerton",NA,NA,3736,2262,1474,500,122,378,0.167,0.134,0.083,0,1045
"757",110565,2007,1,0,"California State University-Fullerton",NA,NA,4040,2430,1610,550,135,415,0.171,0.136,0.084,0,1078
"758",110565,2008,1,0,"California State University-Fullerton",NA,NA,4519,2673,1846,630,180,450,0.168,0.139,0.098,0,1275
"759",110565,2009,1,0,"California State University-Fullerton",NA,NA,3842,2233,1609,666,180,486,0.218,0.173,0.112,0,1034
"760",110565,2010,1,0,"California State University-Fullerton",NA,NA,3749,2160,1589,660,173,487,0.226,0.176,0.109,0,975
"761",110574,1991,0,1,"CALIFORNIA STATE UNIVERSITY-HAYWARD",9999,0,649,445,204,87,22,65,0.146,0.134,0.108,936,217
"762",110574,1992,0,1,"CALIFORNIA STATE UNIVERSITY-HAYWARD",9999,0,572,394,178,76,17,59,0.15,0.133,0.096,1423,135
"763",110574,1993,0,1,"CALIFORNIA STATE UNIVERSITY-HAYWARD",9999,0,553,371,182,59,11,48,0.129,0.107,0.06,1674,134
"764",110574,1995,0,1,"CALIFORNIA STATE UNIVERSITY-HAYWARD",9999,0,542,331,211,55,22,33,0.1,0.101,0.104,1891,119
"765",110574,1996,0,1,"CALIFORNIA STATE UNIVERSITY-HAYWARD",9999,0,661,420,241,83,26,57,0.136,0.126,0.108,1935,129
"766",110574,1997,0,1,"CALIFORNIA STATE UNIVERSITY-HAYWARD",9999,0,711,451,260,94,26,68,0.151,0.132,0.1,1812,128
"767",110574,1998,0,1,"CALIFORNIA STATE UNIVERSITY-HAYWARD",9999,0,732,470,262,106,24,82,0.174,0.145,0.092,1746,159
"768",110574,1999,0,1,"CALIFORNIA STATE UNIVERSITY-HAYWARD",9999,0,714,466,248,119,26,93,0.2,0.167,0.105,0,147
"769",110574,2000,0,1,"CALIFORNIA STATE UNIVERSITY-HAYWARD",9999,0,669,452,217,109,26,83,0.184,0.163,0.12,0,156
"770",110574,2001,0,1,"CALIFORNIA STATE UNIVERSITY-HAYWARD",9999,0,692,435,257,75,17,58,0.133,0.108,0.066,0,131
"771",110574,2002,0,1,"CALIFORNIA STATE UNIVERSITY-HAYWARD",9999,0,746,473,273,119,43,76,0.161,0.16,0.158,0,164
"772",110574,2003,0,1,"CALIFORNIA STATE UNIVERSITY-HAYWARD",9999,0,672,415,257,111,32,79,0.19,0.165,0.125,0,140
"773",110574,2004,0,1,"CALIFORNIA STATE UNIVERSITY-EAST BAY",9999,0,840,516,324,122,38,84,0.163,0.145,0.117,0,159
"774",110574,2005,0,1,"California State University-East Bay",9999,0,686,414,272,110,39,71,0.171,0.16,0.143,0,138
"775",110574,2006,0,1,"California State University-East Bay",9999,0,881,506,375,131,48,83,0.164,0.149,0.128,0,126
"776",110574,2007,0,1,"California State University-East Bay",9999,0,1032,602,430,111,49,62,0.103,0.108,0.114,0,124
"777",110574,2008,0,1,"California State University-East Bay",9999,0,1356,828,528,141,45,96,0.116,0.104,0.085,0,188
"778",110574,2009,0,1,"California State University-East Bay",9999,0,1436,884,552,184,54,130,0.147,0.128,0.098,0,187
"779",110574,2010,0,1,"California State University-East Bay",9999,0,1192,751,441,168,47,121,0.161,0.141,0.107,0,165
"780",110583,1991,1,0,"CALIFORNIA STATE UNIVERSITY-LONG BEACH",NA,NA,2142,1283,859,88,25,63,0.049,0.041,0.029,936,791
"781",110583,1992,1,0,"CALIFORNIA STATE UNIVERSITY-LONG BEACH",NA,NA,1565,961,604,79,27,52,0.054,0.05,0.045,1425,497
"782",110583,1993,1,0,"CALIFORNIA STATE UNIVERSITY-LONG BEACH",NA,NA,1835,1125,710,80,21,59,0.052,0.044,0.03,1674,439
"783",110583,1995,1,0,"CALIFORNIA STATE UNIVERSITY-LONG BEACH",NA,NA,2057,1307,750,88,26,62,0.047,0.043,0.035,1891,515
"784",110583,1996,1,0,"CALIFORNIA STATE UNIVERSITY-LONG BEACH",NA,NA,2299,1407,892,152,38,114,0.081,0.066,0.043,1935,641
"785",110583,1997,1,0,"CALIFORNIA STATE UNIVERSITY-LONG BEACH",NA,NA,2498,1597,901,205,60,145,0.091,0.082,0.067,1844,706
"786",110583,1998,1,0,"CALIFORNIA STATE UNIVERSITY-LONG BEACH",NA,NA,2652,1707,945,285,61,224,0.131,0.107,0.065,1766,809
"787",110583,1999,1,0,"CALIFORNIA STATE UNIVERSITY-LONG BEACH",NA,NA,3309,2128,1181,361,75,286,0.134,0.109,0.064,0,1068
"788",110583,2000,1,0,"CALIFORNIA STATE UNIVERSITY-LONG BEACH",NA,NA,3214,2038,1176,375,87,288,0.141,0.117,0.074,0,1078
"789",110583,2001,1,0,"CALIFORNIA STATE UNIVERSITY-LONG BEACH",NA,NA,4324,2751,1573,420,117,303,0.11,0.097,0.074,0,1474
"790",110583,2002,1,0,"CALIFORNIA STATE UNIVERSITY-LONG BEACH",NA,NA,2912,1871,1041,365,91,274,0.146,0.125,0.087,0,1064
"791",110583,2003,1,0,"CALIFORNIA STATE UNIVERSITY-LONG BEACH",NA,NA,3339,2236,1103,432,103,329,0.147,0.129,0.093,0,1233
"792",110583,2004,1,0,"CALIFORNIA STATE UNIVERSITY-LONG BEACH",NA,NA,3300,2222,1078,406,103,303,0.136,0.123,0.096,0,1000
"793",110583,2005,1,0,"California State University-Long Beach",NA,NA,4241,2666,1575,524,153,371,0.139,0.124,0.097,0,1348
"794",110583,2006,1,0,"California State University-Long Beach",NA,NA,4334,2757,1577,550,175,375,0.136,0.127,0.111,0,1307
"795",110583,2007,1,0,"California State University-Long Beach",NA,NA,4134,2620,1514,581,166,415,0.158,0.141,0.11,0,1135
"796",110583,2008,1,0,"California State University-Long Beach",NA,NA,4536,2856,1680,676,183,493,0.173,0.149,0.109,0,1324
"797",110583,2009,1,0,"California State University-Long Beach",NA,NA,3473,2133,1340,551,172,379,0.178,0.159,0.128,0,779
"798",110583,2010,1,0,"California State University-Long Beach",NA,NA,3913,2310,1603,585,189,396,0.171,0.15,0.118,0,808
"799",110592,1991,0,1,"CALIFORNIA STATE UNIVERSITY-LOS ANGELES",9999,0,1491,938,553,41,9,32,0.034,0.027,0.016,936,75
"800",110592,1992,0,1,"CALIFORNIA STATE UNIVERSITY-LOS ANGELES",9999,0,1206,738,468,45,16,29,0.039,0.037,0.034,1427,47
"801",110592,1993,0,1,"CALIFORNIA STATE UNIVERSITY-LOS ANGELES",9999,0,1133,697,436,34,11,23,0.033,0.03,0.025,1674,33
"802",110592,1995,0,1,"CALIFORNIA STATE UNIVERSITY-LOS ANGELES",9999,0,1243,766,477,49,12,37,0.048,0.039,0.025,1891,62
"803",110592,1996,0,1,"CALIFORNIA STATE UNIVERSITY-LOS ANGELES",9999,0,1313,763,550,51,15,36,0.047,0.039,0.027,1935,66
"804",110592,1997,0,1,"CALIFORNIA STATE UNIVERSITY-LOS ANGELES",9999,0,1274,828,446,82,17,65,0.078,0.064,0.038,1758,64
"805",110592,1998,0,1,"CALIFORNIA STATE UNIVERSITY-LOS ANGELES",9999,0,1255,789,466,103,22,81,0.103,0.082,0.047,1679,80
"806",110592,1999,0,1,"CALIFORNIA STATE UNIVERSITY-LOS ANGELES",9999,0,1186,750,436,111,32,79,0.105,0.094,0.073,0,86
"807",110592,2000,0,1,"CALIFORNIA STATE UNIVERSITY-LOS ANGELES",9999,0,1184,755,429,126,24,102,0.135,0.106,0.056,0,75
"808",110592,2001,0,1,"CALIFORNIA STATE UNIVERSITY-LOS ANGELES",9999,0,1223,767,456,117,26,91,0.119,0.096,0.057,0,70
"809",110592,2002,0,1,"CALIFORNIA STATE UNIVERSITY-LOS ANGELES",9999,0,1404,906,498,116,34,82,0.091,0.083,0.068,0,97
"810",110592,2003,0,1,"CALIFORNIA STATE UNIVERSITY-LOS ANGELES",9999,0,1305,845,460,115,32,83,0.098,0.088,0.07,0,83
"811",110592,2004,0,1,"CALIFORNIA STATE UNIVERSITY-LOS ANGELES",9999,0,1087,687,400,87,22,65,0.095,0.08,0.055,0,61
"812",110592,2005,0,1,"California State University-Los Angeles",9999,0,1253,823,430,111,31,80,0.097,0.089,0.072,0,60
"813",110592,2006,0,1,"California State University-Los Angeles",9999,0,1542,961,581,113,36,77,0.08,0.073,0.062,0,76
"814",110592,2007,0,1,"California State University-Los Angeles",9999,0,1767,1106,661,119,40,79,0.071,0.067,0.061,0,65
"815",110592,2008,0,1,"California State University-Los Angeles",9999,0,1676,1014,662,105,40,65,0.064,0.063,0.06,0,67
"816",110592,2009,0,1,"California State University-Los Angeles",9999,0,1877,1173,704,127,40,87,0.074,0.068,0.057,0,81
"817",110592,2010,0,1,"California State University-Los Angeles",9999,0,2013,1222,791,127,48,79,0.065,0.063,0.061,0,80
"818",110617,1991,1,0,"CALIFORNIA STATE UNIVERSITY-SACRAMENTO",NA,NA,1210,694,516,108,28,80,0.115,0.089,0.054,936,678
"819",110617,1992,1,0,"CALIFORNIA STATE UNIVERSITY-SACRAMENTO",NA,NA,922,513,409,71,20,51,0.099,0.077,0.049,1460,418
"820",110617,1993,1,0,"CALIFORNIA STATE UNIVERSITY-SACRAMENTO",NA,NA,1086,635,451,51,8,43,0.068,0.047,0.018,1674,496
"821",110617,1995,1,0,"CALIFORNIA STATE UNIVERSITY-SACRAMENTO",NA,NA,1219,735,484,96,24,72,0.098,0.079,0.05,1891,473
"822",110617,1996,1,0,"CALIFORNIA STATE UNIVERSITY-SACRAMENTO",NA,NA,1396,826,570,84,23,61,0.074,0.06,0.04,1935,524
"823",110617,1997,1,0,"CALIFORNIA STATE UNIVERSITY-SACRAMENTO",NA,NA,1350,777,573,95,31,64,0.082,0.07,0.054,1982,505
"824",110617,1998,1,0,"CALIFORNIA STATE UNIVERSITY-SACRAMENTO",NA,NA,1467,828,639,136,30,106,0.128,0.093,0.047,1934,589
"825",110617,1999,1,0,"CALIFORNIA STATE UNIVERSITY-SACRAMENTO",NA,NA,1753,1013,740,159,39,120,0.118,0.091,0.053,0,704
"826",110617,2000,1,0,"CALIFORNIA STATE UNIVERSITY-SACRAMENTO",NA,NA,2055,1198,857,178,36,142,0.118,0.087,0.042,0,741
"827",110617,2001,1,0,"CALIFORNIA STATE UNIVERSITY-SACRAMENTO",NA,NA,2278,1387,891,221,49,172,0.124,0.097,0.055,0,891
"828",110617,2002,1,0,"CALIFORNIA STATE UNIVERSITY-SACRAMENTO",NA,NA,2378,1395,983,221,56,165,0.118,0.093,0.057,0,944
"829",110617,2003,1,0,"CALIFORNIA STATE UNIVERSITY-SACRAMENTO",NA,NA,2347,1415,932,227,62,165,0.117,0.097,0.067,0,941
"830",110617,2004,1,0,"CALIFORNIA STATE UNIVERSITY-SACRAMENTO",NA,NA,2268,1375,893,240,57,183,0.133,0.106,0.064,0,884
"831",110617,2005,1,0,"California State University-Sacramento",NA,NA,2436,1483,953,256,73,183,0.123,0.105,0.077,0,911
"832",110617,2006,1,0,"California State University-Sacramento",NA,NA,2590,1570,1020,263,79,184,0.117,0.102,0.077,0,901
"833",110617,2007,1,0,"California State University-Sacramento",NA,NA,2357,1426,931,194,64,130,0.091,0.082,0.069,0,682
"834",110617,2008,1,0,"California State University-Sacramento",NA,NA,2536,1493,1043,191,50,141,0.094,0.075,0.048,0,869
"835",110617,2009,1,0,"California State University-Sacramento",NA,NA,2954,1712,1242,196,50,146,0.085,0.066,0.04,0,906
"836",110617,2010,1,0,"California State University-Sacramento",NA,NA,2625,1548,1077,238,69,169,0.109,0.091,0.064,0,783
"837",113698,1991,1,0,"DOMINICAN COLLEGE OF SAN RAFAEL",NA,NA,66,50,16,22,3,19,0.38,0.333,0.188,10390,44
"838",113698,1992,1,0,"DOMINICAN COLLEGE OF SAN RAFAEL",NA,NA,65,45,20,24,8,16,0.356,0.369,0.4,11280,44
"839",113698,1993,1,0,"DOMINICAN COLLEGE OF SAN RAFAEL",NA,NA,75,46,29,17,4,13,0.283,0.227,0.138,12180,49
"840",113698,1995,1,0,"DOMINICAN COLLEGE OF SAN RAFAEL",NA,NA,69,51,18,27,5,22,0.431,0.391,0.278,13890,49
"841",113698,1996,1,0,"DOMINICAN COLLEGE OF SAN RAFAEL",NA,NA,58,41,17,23,6,17,0.415,0.397,0.353,14670,31
"842",113698,1997,1,0,"DOMINICAN COLLEGE OF SAN RAFAEL",NA,NA,74,55,19,24,5,19,0.346,0.324,0.263,15424,38
"843",113698,1998,1,0,"DOMINICAN COLLEGE OF SAN RAFAEL",NA,NA,72,58,14,30,6,24,0.414,0.417,0.429,16160,45
"844",113698,1999,1,0,"DOMINICAN COLLEGE OF SAN RAFAEL",NA,NA,111,88,23,50,10,40,0.454,0.45,0.435,16512,67
"845",113698,2000,1,0,"DOMINICAN UNIVERSITY OF CALIFORNIA",NA,NA,113,86,27,48,13,35,0.407,0.425,0.481,17256,58
"846",113698,2001,1,0,"DOMINICAN UNIVERSITY OF CALIFORNIA",NA,NA,127,90,37,51,13,38,0.422,0.402,0.351,18648,59
"847",113698,2002,1,0,"DOMINICAN UNIVERSITY OF CALIFORNIA",NA,NA,202,145,57,75,19,56,0.386,0.371,0.333,20320,78
"848",113698,2003,1,0,"DOMINICAN UNIVERSITY OF CALIFORNIA",NA,NA,244,188,56,98,24,74,0.394,0.402,0.429,22250,88
"849",113698,2004,1,0,"DOMINICAN UNIVERSITY OF CALIFORNIA",NA,NA,276,205,71,119,24,95,0.463,0.431,0.338,24254,109
"850",113698,2005,1,0,"Dominican University of California",NA,NA,227,168,59,98,22,76,0.452,0.432,0.373,25950,82
"851",113698,2006,1,0,"Dominican University of California",NA,NA,263,193,70,100,18,82,0.425,0.38,0.257,27770,99
"852",113698,2007,1,0,"Dominican University of California",NA,NA,297,225,72,107,23,84,0.373,0.36,0.319,30270,100
"853",113698,2008,1,0,"Dominican University of California",NA,NA,267,202,65,146,31,115,0.569,0.547,0.477,32090,71
"854",113698,2009,1,0,"Dominican University of California",NA,NA,289,207,82,152,25,127,0.614,0.526,0.305,33540,98
"855",113698,2010,1,0,"Dominican University of California",NA,NA,338,255,83,192,45,147,0.577,0.568,0.542,35220,91
"856",115755,1991,1,0,"HUMBOLDT STATE UNIVERSITY",NA,NA,862,468,394,61,19,42,0.09,0.071,0.048,936,649
"857",115755,1992,1,0,"HUMBOLDT STATE UNIVERSITY",NA,NA,779,421,358,45,16,29,0.069,0.058,0.045,1467,560
"858",115755,1993,1,0,"HUMBOLDT STATE UNIVERSITY",NA,NA,553,324,229,60,9,51,0.157,0.108,0.039,1674,390
"859",115755,1995,1,0,"HUMBOLDT STATE UNIVERSITY",NA,NA,908,503,405,69,18,51,0.101,0.076,0.044,1891,644
"860",115755,1996,1,0,"HUMBOLDT STATE UNIVERSITY",NA,NA,823,471,352,62,13,49,0.104,0.075,0.037,1935,529
"861",115755,1997,1,0,"HUMBOLDT STATE UNIVERSITY",NA,NA,718,401,317,85,14,71,0.177,0.118,0.044,1923,481
"862",115755,1998,1,0,"HUMBOLDT STATE UNIVERSITY",NA,NA,731,405,326,71,24,47,0.116,0.097,0.074,1905,477
"863",115755,1999,1,0,"HUMBOLDT STATE UNIVERSITY",NA,NA,751,436,315,89,25,64,0.147,0.119,0.079,0,511
"864",115755,2000,1,0,"HUMBOLDT STATE UNIVERSITY",NA,NA,769,460,309,94,32,62,0.135,0.122,0.104,0,535
"865",115755,2001,1,0,"HUMBOLDT STATE UNIVERSITY",NA,NA,725,416,309,81,18,63,0.151,0.112,0.058,0,461
"866",115755,2002,1,0,"HUMBOLDT STATE UNIVERSITY",NA,NA,836,505,331,97,28,69,0.137,0.116,0.085,0,499
"867",115755,2003,1,0,"HUMBOLDT STATE UNIVERSITY",NA,NA,853,481,372,97,26,71,0.148,0.114,0.07,0,506
"868",115755,2004,1,0,"HUMBOLDT STATE UNIVERSITY",NA,NA,760,427,333,66,18,48,0.112,0.087,0.054,0,426
"869",115755,2005,1,0,"Humboldt State University",NA,NA,813,461,352,99,32,67,0.145,0.122,0.091,0,433
"870",115755,2006,1,0,"Humboldt State University",NA,NA,966,550,416,132,46,86,0.156,0.137,0.111,0,485
"871",115755,2007,1,0,"Humboldt State University",NA,NA,1039,551,488,112,39,73,0.132,0.108,0.08,0,472
"872",115755,2008,1,0,"Humboldt State University",NA,NA,1168,661,507,147,37,110,0.166,0.126,0.073,0,555
"873",115755,2009,1,0,"Humboldt State University",NA,NA,1345,745,600,214,57,157,0.211,0.159,0.095,0,741
"874",115755,2010,1,0,"Humboldt State University",NA,NA,1282,701,581,188,65,123,0.176,0.147,0.112,0,644
"875",119173,1991,1,0,"MOUNT SAINT MARY'S COLLEGE",NA,NA,190,190,0,32,0,32,0.168,0.168,NA,9950,29
"876",119173,1992,1,0,"MOUNT SAINT MARY'S COLLEGE",NA,NA,217,217,0,64,0,64,0.295,0.295,NA,10830,29
"877",119173,1993,1,0,"MOUNT SAINT MARYS COLLEGE",NA,NA,276,273,3,56,0,56,0.205,0.203,0,11690,39
"878",119173,1995,1,0,"MOUNT SAINT MARYS COLLEGE",NA,NA,222,220,2,50,2,48,0.218,0.225,1,13812,30
"879",119173,1996,1,0,"MOUNT SAINT MARYS COLLEGE",NA,NA,112,112,0,61,0,61,0.545,0.545,NA,14014,30
"880",119173,1997,1,0,"MOUNT SAINT MARYS COLLEGE",NA,NA,258,258,0,82,0,82,0.318,0.318,NA,14716,44
"881",119173,1998,1,0,"MOUNT SAINT MARYS COLLEGE",NA,NA,295,293,2,62,0,62,0.212,0.21,0,15452,43
"882",119173,1999,1,0,"MOUNT ST MARY'S COLLEGE",NA,NA,294,293,1,57,0,57,0.194,0.194,0,16776,26
"883",119173,2000,1,0,"MOUNT ST MARY'S COLLEGE",NA,NA,297,296,1,67,1,66,0.223,0.226,1,17036,33
"884",119173,2001,1,0,"MOUNT ST MARY'S COLLEGE",NA,NA,328,325,3,47,1,46,0.142,0.143,0.333,17888,38
"885",119173,2002,1,0,"MOUNT ST MARY'S COLLEGE",NA,NA,127,123,4,64,1,63,0.512,0.504,0.25,18782,21
"886",119173,2003,1,0,"MOUNT ST MARY'S COLLEGE",NA,NA,339,330,9,84,4,80,0.242,0.248,0.444,19722,40
"887",119173,2004,1,0,"MOUNT ST MARY'S COLLEGE",NA,NA,364,352,12,93,4,89,0.253,0.255,0.333,20708,33
"888",119173,2005,1,0,"Mount St Mary's College",NA,NA,393,378,15,68,3,65,0.172,0.173,0.2,22054,46
"889",119173,2006,1,0,"Mount St Mary's College",NA,NA,345,336,9,76,1,75,0.223,0.22,0.111,23380,26
"890",119173,2007,1,0,"Mount St Mary's College",NA,NA,348,331,17,93,7,86,0.26,0.267,0.412,24550,20
"891",119173,2008,1,0,"Mount St Mary's College",NA,NA,313,302,11,84,2,82,0.272,0.268,0.182,26280,21
"892",119173,2009,1,0,"Mount St Mary's College",NA,NA,367,351,16,109,5,104,0.296,0.297,0.312,27840,17
"893",119173,2010,1,0,"Mount St Mary's College",NA,NA,525,507,18,140,3,137,0.27,0.267,0.167,29232,29
"894",120184,1991,1,0,"COLLEGE OF NOTRE DAME",NA,NA,71,51,20,25,6,19,0.372,0.352,0.3,10165,32
"895",120184,1992,1,0,"COLLEGE OF NOTRE DAME",NA,NA,85,54,31,34,14,20,0.37,0.4,0.452,11015,32
"896",120184,1993,1,0,"COLLEGE OF NOTRE DAME",NA,NA,96,76,20,36,5,31,0.408,0.375,0.25,11750,39
"897",120184,1995,1,0,"COLLEGE OF NOTRE DAME",NA,NA,115,79,36,44,9,35,0.443,0.383,0.25,13535,42
"898",120184,1996,1,0,"COLLEGE OF NOTRE DAME",NA,NA,124,75,49,49,16,33,0.44,0.395,0.327,14400,40
"899",120184,1997,1,0,"COLLEGE OF NOTRE DAME",NA,NA,129,79,50,38,15,23,0.291,0.295,0.3,14976,41
"900",120184,1998,1,0,"COLLEGE OF NOTRE DAME",NA,NA,130,80,50,52,14,38,0.475,0.4,0.28,15576,40
"901",120184,1999,1,0,"COLLEGE OF NOTRE DAME",NA,NA,129,85,44,50,17,33,0.388,0.388,0.386,16200,38
"902",120184,2000,1,0,"COLLEGE OF NOTRE DAME",NA,NA,137,99,38,54,15,39,0.394,0.394,0.395,16850,49
"903",120184,2001,1,0,"NOTRE DAME DE NAMUR UNIVERSITY",NA,NA,111,85,26,55,10,45,0.529,0.495,0.385,18200,29
"904",120184,2002,1,0,"NOTRE DAME DE NAMUR UNIVERSITY",NA,NA,97,57,40,42,12,30,0.526,0.433,0.3,19110,43
"905",120184,2003,1,0,"NOTRE DAME DE NAMUR UNIVERSITY",NA,NA,190,106,84,90,36,54,0.509,0.474,0.429,20050,70
"906",120184,2004,1,0,"NOTRE DAME DE NAMUR UNIVERSITY",NA,NA,161,108,53,68,19,49,0.454,0.422,0.358,21350,78
"907",120184,2005,1,0,"Notre Dame de Namur University",NA,NA,144,95,49,59,14,45,0.474,0.41,0.286,22520,50
"908",120184,2006,1,0,"Notre Dame de Namur University",NA,NA,134,93,41,51,15,36,0.387,0.381,0.366,23650,59
"909",120184,2007,1,0,"Notre Dame de Namur University",NA,NA,96,57,39,35,12,23,0.404,0.365,0.308,24450,30
"910",120184,2008,1,0,"Notre Dame de Namur University",NA,NA,147,85,62,63,21,42,0.494,0.429,0.339,25300,32
"911",120184,2009,1,0,"Notre Dame de Namur University",NA,NA,116,78,38,33,10,23,0.295,0.284,0.263,26830,26
"912",120184,2010,1,0,"Notre Dame de Namur University",NA,NA,145,94,51,50,15,35,0.372,0.345,0.294,28200,31
"913",121309,1991,0,1,"POINT LOMA NAZARENE COLLEGE",1992,0,317,194,123,103,34,69,0.356,0.325,0.276,8058,243
"914",121309,1992,1,0,"POINT LOMA NAZARENE COLLEGE",1992,1,374,248,126,94,27,67,0.27,0.251,0.214,8838,317
"915",121309,1993,1,0,"POINT LOMA NAZARENE COLLEGE",1992,1,425,255,170,127,34,93,0.365,0.299,0.2,9542,361
"916",121309,1995,1,0,"POINT LOMA NAZARENE COLLEGE",1992,1,475,313,162,185,57,128,0.409,0.389,0.352,10880,405
"917",121309,1996,1,0,"POINT LOMA NAZARENE COLLEGE",1992,1,515,313,202,218,70,148,0.473,0.423,0.347,11824,445
"918",121309,1997,1,0,"POINT LOMA NAZARENE COLLEGE",1992,1,494,306,188,187,64,123,0.402,0.379,0.34,12464,424
"919",121309,1998,1,0,"POINT LOMA NAZARENE UNIVERSITY",1992,1,598,375,223,261,87,174,0.464,0.436,0.39,12650,499
"920",121309,1999,1,0,"POINT LOMA NAZARENE UNIVERSITY",1992,1,613,392,221,332,117,215,0.548,0.542,0.529,13186,520
"921",121309,2000,1,0,"POINT LOMA NAZARENE UNIVERSITY",1992,1,539,312,227,274,101,173,0.554,0.508,0.445,13900,457
"922",121309,2001,1,0,"POINT LOMA NAZARENE UNIVERSITY",1992,1,545,346,199,327,106,221,0.639,0.6,0.533,14800,478
"923",121309,2002,1,0,"POINT LOMA NAZARENE UNIVERSITY",1992,1,535,324,211,321,111,210,0.648,0.6,0.526,15760,459
"924",121309,2003,1,0,"POINT LOMA NAZARENE UNIVERSITY",1992,1,566,356,210,353,119,234,0.657,0.624,0.567,18000,455
"925",121309,2004,1,0,"POINT LOMA NAZARENE UNIVERSITY",1992,1,535,339,196,395,141,254,0.749,0.738,0.719,19040,425
"926",121309,2005,1,0,"Point Loma Nazarene University",1992,1,562,339,223,348,125,223,0.658,0.619,0.561,20200,446
"927",121309,2006,1,0,"Point Loma Nazarene University",1992,1,537,342,195,352,118,234,0.684,0.655,0.605,21620,412
"928",121309,2007,1,0,"Point Loma Nazarene University",1992,1,530,336,194,327,109,218,0.649,0.617,0.562,23200,420
"929",121309,2008,1,0,"Point Loma Nazarene University",1992,1,538,327,211,318,116,202,0.618,0.591,0.55,24580,425
"930",121309,2009,1,0,"Point Loma Nazarene University",1992,1,533,343,190,338,113,225,0.656,0.634,0.595,25300,390
"931",121309,2010,1,0,"Point Loma Nazarene University",1992,1,588,360,228,367,130,237,0.658,0.624,0.57,26500,409
"932",121345,1991,1,0,"POMONA COLLEGE",NA,NA,359,164,195,294,155,139,0.848,0.819,0.795,14800,209
"933",121345,1992,1,0,"POMONA COLLEGE",NA,NA,382,192,190,316,148,168,0.875,0.827,0.779,15700,212
"934",121345,1993,1,0,"POMONA COLLEGE",NA,NA,390,183,207,317,167,150,0.82,0.813,0.807,16720,205
"935",121345,1995,1,0,"POMONA COLLEGE",NA,NA,392,190,202,336,166,170,0.895,0.857,0.822,18600,209
"936",121345,1996,1,0,"POMONA COLLEGE",NA,NA,396,187,209,331,173,158,0.845,0.836,0.828,19530,190
"937",121345,1997,1,0,"POMONA COLLEGE",NA,NA,393,195,198,338,166,172,0.882,0.86,0.838,20500,210
"938",121345,1998,1,0,"POMONA COLLEGE",NA,NA,396,182,214,321,168,153,0.841,0.811,0.785,21420,211
"939",121345,1999,1,0,"POMONA COLLEGE",NA,NA,390,194,196,338,167,171,0.881,0.867,0.852,22940,224
"940",121345,2000,1,0,"POMONA COLLEGE",NA,NA,398,208,190,346,163,183,0.88,0.869,0.858,23910,238
"941",121345,2001,1,0,"POMONA COLLEGE",NA,NA,393,192,201,339,173,166,0.865,0.863,0.861,24750,234
"942",121345,2002,1,0,"POMONA COLLEGE",NA,NA,374,191,183,338,158,180,0.942,0.904,0.863,25730,224
"943",121345,2003,1,0,"POMONA COLLEGE",NA,NA,398,202,196,354,170,184,0.911,0.889,0.867,26890,208
"944",121345,2004,1,0,"POMONA COLLEGE",NA,NA,393,196,197,356,181,175,0.893,0.906,0.919,28100,204
"945",121345,2005,1,0,"Pomona College",NA,NA,382,193,189,347,169,178,0.922,0.908,0.894,29650,186
"946",121345,2006,1,0,"Pomona College",NA,NA,378,190,188,337,162,175,0.921,0.892,0.862,31580,185
"947",121345,2007,1,0,"Pomona College",NA,NA,375,188,187,348,172,176,0.936,0.928,0.92,33635,173
"948",121345,2008,1,0,"Pomona College",NA,NA,382,194,188,344,168,176,0.907,0.901,0.894,35318,174
"949",121345,2009,1,0,"Pomona College",NA,NA,389,190,199,355,180,175,0.921,0.913,0.905,36710,166
"950",121345,2010,1,0,"Pomona College",NA,NA,401,217,184,369,169,200,0.922,0.92,0.918,38087,191
"951",122409,1991,1,0,"SAN DIEGO STATE UNIVERSITY",NA,NA,2479,1440,1039,151,39,112,0.078,0.061,0.038,936,1325
"952",122409,1992,1,0,"SAN DIEGO STATE UNIVERSITY",NA,NA,1974,1129,845,154,45,109,0.096,0.078,0.053,1500,947
"953",122409,1993,1,0,"SAN DIEGO STATE UNIVERSITY",NA,NA,1973,1081,892,126,25,101,0.093,0.064,0.028,1674,842
"954",122409,1995,1,0,"SAN DIEGO STATE UNIVERSITY",NA,NA,2840,1716,1124,212,58,154,0.09,0.075,0.052,1891,1238
"955",122409,1996,1,0,"SAN DIEGO STATE UNIVERSITY",NA,NA,2908,1752,1156,208,55,153,0.087,0.072,0.048,1935,1234
"956",122409,1997,1,0,"SAN DIEGO STATE UNIVERSITY",NA,NA,3008,1766,1242,280,73,207,0.117,0.093,0.059,1932,1347
"957",122409,1998,1,0,"SAN DIEGO STATE UNIVERSITY",NA,NA,3128,1815,1313,308,79,229,0.126,0.098,0.06,1784,1419
"958",122409,1999,1,0,"SAN DIEGO STATE UNIVERSITY",NA,NA,2834,1574,1260,394,119,275,0.175,0.139,0.094,0,1433
"959",122409,2000,1,0,"SAN DIEGO STATE UNIVERSITY",NA,NA,2719,1598,1121,472,130,342,0.214,0.174,0.116,0,1441
"960",122409,2001,1,0,"SAN DIEGO STATE UNIVERSITY",NA,NA,3338,1986,1352,664,178,486,0.245,0.199,0.132,0,1694
"961",122409,2002,1,0,"SAN DIEGO STATE UNIVERSITY",NA,NA,3662,2217,1445,879,237,642,0.29,0.24,0.164,0,1890
"962",122409,2003,1,0,"SAN DIEGO STATE UNIVERSITY",NA,NA,3418,2106,1312,973,286,687,0.326,0.285,0.218,0,1859
"963",122409,2004,1,0,"SAN DIEGO STATE UNIVERSITY",NA,NA,3527,2128,1399,1073,307,766,0.36,0.304,0.219,0,1905
"964",122409,2005,1,0,"San Diego State University",NA,NA,3439,2039,1400,1011,323,688,0.337,0.294,0.231,0,1807
"965",122409,2006,1,0,"San Diego State University",NA,NA,4109,2458,1651,1309,382,927,0.377,0.319,0.231,0,2158
"966",122409,2007,1,0,"San Diego State University",NA,NA,4506,2685,1821,1472,449,1023,0.381,0.327,0.247,0,2312
"967",122409,2008,1,0,"San Diego State University",NA,NA,3578,2086,1492,1053,346,707,0.339,0.294,0.232,0,1577
"968",122409,2009,1,0,"San Diego State University",NA,NA,3291,1881,1410,990,332,658,0.35,0.301,0.235,0,1389
"969",122409,2010,1,0,"San Diego State University",NA,NA,3031,1802,1229,1017,352,665,0.369,0.336,0.286,0,1332
"970",122436,1991,1,0,"UNIVERSITY OF SAN DIEGO",NA,NA,882,528,354,471,181,290,0.549,0.534,0.511,11440,645
"971",122436,1992,1,0,"UNIVERSITY OF SAN DIEGO",NA,NA,929,524,405,462,175,287,0.548,0.497,0.432,12240,636
"972",122436,1993,1,0,"UNIVERSITY OF SAN DIEGO",NA,NA,890,516,374,468,171,297,0.576,0.526,0.457,12970,619
"973",122436,1995,1,0,"UNIVERSITY OF SAN DIEGO",NA,NA,978,597,381,500,186,314,0.526,0.511,0.488,14320,674
"974",122436,1996,1,0,"UNIVERSITY OF SAN DIEGO",NA,NA,1042,569,473,542,213,329,0.578,0.52,0.45,14960,734
"975",122436,1997,1,0,"UNIVERSITY OF SAN DIEGO",NA,NA,1036,630,406,589,194,395,0.627,0.569,0.478,15780,736
"976",122436,1998,1,0,"UNIVERSITY OF SAN DIEGO",NA,NA,1028,614,414,610,222,388,0.632,0.593,0.536,16470,719
"977",122436,1999,1,0,"UNIVERSITY OF SAN DIEGO",NA,NA,990,621,369,611,204,407,0.655,0.617,0.553,17780,726
"978",122436,2000,1,0,"UNIVERSITY OF SAN DIEGO",NA,NA,1024,642,382,656,225,431,0.671,0.641,0.589,19020,745
"979",122436,2001,1,0,"UNIVERSITY OF SAN DIEGO",NA,NA,1003,646,357,635,217,418,0.647,0.633,0.608,20350,677
"980",122436,2002,1,0,"UNIVERSITY OF SAN DIEGO",NA,NA,1049,681,368,672,219,453,0.665,0.641,0.595,21880,732
"981",122436,2003,1,0,"UNIVERSITY OF SAN DIEGO",NA,NA,1059,718,341,695,208,487,0.678,0.656,0.61,23410,726
"982",122436,2004,1,0,"UNIVERSITY OF SAN DIEGO",NA,NA,1174,705,469,706,259,447,0.634,0.601,0.552,24860,830
"983",122436,2005,1,0,"University of San Diego",NA,NA,1131,710,421,726,238,488,0.687,0.642,0.565,26350,760
"984",122436,2006,1,0,"University of San Diego",NA,NA,1103,703,400,714,214,500,0.711,0.647,0.535,30480,702
"985",122436,2007,1,0,"University of San Diego",NA,NA,1089,635,454,704,254,450,0.709,0.646,0.559,32300,654
"986",122436,2008,1,0,"University of San Diego",NA,NA,1259,771,488,838,289,549,0.712,0.666,0.592,34000,810
"987",122436,2009,1,0,"University of San Diego",NA,NA,1081,621,460,714,259,455,0.733,0.66,0.563,35870,645
"988",122436,2010,1,0,"University of San Diego",NA,NA,1148,662,486,752,280,472,0.713,0.655,0.576,36950,729
"989",122597,1991,1,0,"SAN FRANCISCO STATE UNIVERSITY",NA,NA,1219,774,445,72,28,44,0.057,0.059,0.063,936,308
"990",122597,1992,1,0,"SAN FRANCISCO STATE UNIVERSITY",NA,NA,1125,693,432,73,19,54,0.078,0.065,0.044,1444,276
"991",122597,1993,1,0,"SAN FRANCISCO STATE UNIVERSITY",NA,NA,1141,668,473,60,16,44,0.066,0.053,0.034,1674,263
"992",122597,1995,1,0,"SAN FRANCISCO STATE UNIVERSITY",NA,NA,1539,966,573,89,26,63,0.065,0.058,0.045,1891,349
"993",122597,1996,1,0,"SAN FRANCISCO STATE UNIVERSITY",NA,NA,1727,1102,625,111,35,76,0.069,0.064,0.056,1935,393
"994",122597,1997,1,0,"SAN FRANCISCO STATE UNIVERSITY",NA,NA,1732,1086,646,115,36,79,0.073,0.066,0.056,1978,380
"995",122597,1998,1,0,"SAN FRANCISCO STATE UNIVERSITY",NA,NA,1805,1143,662,134,23,111,0.097,0.074,0.035,1884,413
"996",122597,1999,1,0,"SAN FRANCISCO STATE UNIVERSITY",NA,NA,1898,1158,740,178,54,124,0.107,0.094,0.073,0,491
"997",122597,2000,1,0,"SAN FRANCISCO STATE UNIVERSITY",NA,NA,1870,1212,658,205,54,151,0.125,0.11,0.082,0,474
"998",122597,2001,1,0,"SAN FRANCISCO STATE UNIVERSITY",NA,NA,1820,1157,663,209,58,151,0.13,0.115,0.087,0,477
"999",122597,2002,1,0,"SAN FRANCISCO STATE UNIVERSITY",NA,NA,2130,1378,752,211,52,159,0.115,0.099,0.069,0,510
"1000",122597,2003,1,0,"SAN FRANCISCO STATE UNIVERSITY",NA,NA,2291,1474,817,267,69,198,0.134,0.117,0.084,0,685
"1001",122597,2004,1,0,"SAN FRANCISCO STATE UNIVERSITY",NA,NA,2739,1770,969,390,114,276,0.156,0.142,0.118,0,843
"1002",122597,2005,1,0,"San Francisco State University",NA,NA,2999,1942,1057,360,105,255,0.131,0.12,0.099,0,981
"1003",122597,2006,1,0,"San Francisco State University",NA,NA,3117,2017,1100,418,128,290,0.144,0.134,0.116,0,1019
"1004",122597,2007,1,0,"San Francisco State University",NA,NA,3341,2123,1218,424,118,306,0.144,0.127,0.097,0,1118
"1005",122597,2008,1,0,"San Francisco State University",NA,NA,3512,2334,1178,524,145,379,0.162,0.149,0.123,0,1157
"1006",122597,2009,1,0,"San Francisco State University",NA,NA,3855,2497,1358,704,178,526,0.211,0.183,0.131,0,1182
"1007",122597,2010,1,0,"San Francisco State University",NA,NA,3609,2179,1430,648,210,438,0.201,0.18,0.147,0,1049
"1008",122612,1991,1,0,"UNIVERSITY OF SAN FRANCISCO",NA,NA,459,299,160,205,72,133,0.445,0.447,0.45,11040,227
"1009",122612,1992,1,0,"UNIVERSITY OF SAN FRANCISCO",NA,NA,492,319,173,233,75,158,0.495,0.474,0.434,11816,219
"1010",122612,1993,1,0,"UNIVERSITY OF SAN FRANCISCO",NA,NA,530,359,171,225,61,164,0.457,0.425,0.357,12578,208
"1011",122612,1995,1,0,"UNIVERSITY OF SAN FRANCISCO",NA,NA,550,350,200,237,71,166,0.474,0.431,0.355,14108,196
"1012",122612,1996,1,0,"UNIVERSITY OF SAN FRANCISCO",NA,NA,616,413,203,307,89,218,0.528,0.498,0.438,14920,214
"1013",122612,1997,1,0,"UNIVERSITY OF SAN FRANCISCO",NA,NA,600,385,215,285,96,189,0.491,0.475,0.447,15850,210
"1014",122612,1998,1,0,"UNIVERSITY OF SAN FRANCISCO",NA,NA,640,436,204,296,80,216,0.495,0.462,0.392,16630,249
"1015",122612,1999,1,0,"UNIVERSITY OF SAN FRANCISCO",NA,NA,757,500,257,379,109,270,0.54,0.501,0.424,17710,328
"1016",122612,2000,1,0,"UNIVERSITY OF SAN FRANCISCO",NA,NA,757,518,239,363,100,263,0.508,0.48,0.418,18860,315
"1017",122612,2001,1,0,"UNIVERSITY OF SAN FRANCISCO",NA,NA,840,572,268,411,114,297,0.519,0.489,0.425,20190,357
"1018",122612,2002,1,0,"UNIVERSITY OF SAN FRANCISCO",NA,NA,839,582,257,431,132,299,0.514,0.514,0.514,21660,303
"1019",122612,2003,1,0,"UNIVERSITY OF SAN FRANCISCO",NA,NA,914,632,282,452,131,321,0.508,0.495,0.465,23220,351
"1020",122612,2004,1,0,"UNIVERSITY OF SAN FRANCISCO",NA,NA,929,614,315,518,151,367,0.598,0.558,0.479,24800,358
"1021",122612,2005,1,0,"University of San Francisco",NA,NA,932,665,267,542,131,411,0.618,0.582,0.491,26680,372
"1022",122612,2006,1,0,"University of San Francisco",NA,NA,1073,733,340,582,166,416,0.568,0.542,0.488,28420,417
"1023",122612,2007,1,0,"University of San Francisco",NA,NA,1052,680,372,595,179,416,0.612,0.566,0.481,30840,428
"1024",122612,2008,1,0,"University of San Francisco",NA,NA,1036,686,350,632,196,436,0.636,0.61,0.56,33160,439
"1025",122612,2009,1,0,"University of San Francisco",NA,NA,1073,744,329,648,172,476,0.64,0.604,0.523,34430,416
"1026",122612,2010,1,0,"University of San Francisco",NA,NA,1171,750,421,721,233,488,0.651,0.616,0.553,36000,413
"1027",122931,1991,0,1,"SANTA CLARA UNIVERSITY",9999,0,928,457,471,675,335,340,0.744,0.727,0.711,11271,620
"1028",122931,1992,0,1,"SANTA CLARA UNIVERSITY",9999,0,900,458,442,661,303,358,0.782,0.734,0.686,12150,552
"1029",122931,1993,0,1,"SANTA CLARA UNIVERSITY",9999,0,888,489,399,657,287,370,0.757,0.74,0.719,12879,492
"1030",122931,1995,0,1,"SANTA CLARA UNIVERSITY",9999,0,1043,558,485,757,329,428,0.767,0.726,0.678,14604,580
"1031",122931,1996,0,1,"SANTA CLARA UNIVERSITY",9999,0,1075,586,489,798,349,449,0.766,0.742,0.714,15450,618
"1032",122931,1997,0,1,"SANTA CLARA UNIVERSITY",9999,0,1004,543,461,766,328,438,0.807,0.763,0.711,16455,592
"1033",122931,1998,0,1,"SANTA CLARA UNIVERSITY",9999,0,1032,570,462,783,331,452,0.793,0.759,0.716,17442,588
"1034",122931,1999,0,1,"SANTA CLARA UNIVERSITY",9999,0,1101,619,482,854,358,496,0.801,0.776,0.743,19095,649
"1035",122931,2000,0,1,"SANTA CLARA UNIVERSITY",9999,0,1025,544,481,814,366,448,0.824,0.794,0.761,20337,601
"1036",122931,2001,0,1,"SANTA CLARA UNIVERSITY",9999,0,1017,556,461,799,339,460,0.827,0.786,0.735,22572,597
"1037",122931,2002,0,1,"SANTA CLARA UNIVERSITY",9999,0,1116,659,457,873,342,531,0.806,0.782,0.748,23925,694
"1038",122931,2003,0,1,"SANTA CLARA UNIVERSITY",9999,0,892,509,383,690,284,406,0.798,0.774,0.742,25365,566
"1039",122931,2004,0,1,"SANTA CLARA UNIVERSITY",9999,0,1171,658,513,941,392,549,0.834,0.804,0.764,27135,693
"1040",122931,2005,0,1,"Santa Clara University",9999,0,1197,667,530,917,384,533,0.799,0.766,0.725,28899,699
"1041",122931,2006,0,1,"Santa Clara University",9999,0,1340,740,600,1055,448,607,0.82,0.787,0.747,30900,655
"1042",122931,2007,0,1,"Santa Clara University",9999,0,1201,619,582,923,431,492,0.795,0.769,0.741,33000,548
"1043",122931,2008,0,1,"Santa Clara University",9999,0,1220,623,597,951,436,515,0.827,0.78,0.73,34950,471
"1044",122931,2009,0,1,"Santa Clara University",9999,0,1084,571,513,830,371,459,0.804,0.766,0.723,36000,412
"1045",122931,2010,0,1,"Santa Clara University",9999,0,1295,644,651,1056,498,558,0.867,0.815,0.765,37368,639
"1046",123554,1991,1,0,"SAINT MARY'S COLLEGE OF CALIFORNIA",NA,NA,437,241,196,247,101,146,0.606,0.565,0.515,11036,292
"1047",123554,1992,1,0,"SAINT MARY'S COLLEGE OF CALIFORNIA",NA,NA,472,257,215,289,126,163,0.634,0.612,0.586,11966,324
"1048",123554,1993,1,0,"SAINT MARYS COLLEGE OF CALIFORNIA",NA,NA,464,249,215,294,128,166,0.667,0.634,0.595,12636,301
"1049",123554,1995,1,0,"SAINT MARYS COLLEGE OF CALIFORNIA",NA,NA,474,256,218,306,141,165,0.645,0.646,0.647,14250,326
"1050",123554,1996,1,0,"SAINT MARYS COLLEGE OF CALIFORNIA",NA,NA,488,288,200,307,102,205,0.712,0.629,0.51,15098,317
"1051",123554,1997,1,0,"SAINT MARYS COLLEGE OF CALIFORNIA",NA,NA,596,348,248,390,144,246,0.707,0.654,0.581,15880,388
"1052",123554,1998,1,0,"SAINT MARYS COLLEGE OF CALIFORNIA",NA,NA,573,343,230,352,125,227,0.662,0.614,0.543,16809,386
"1053",123554,1999,1,0,"SAINT MARYS COLLEGE OF CALIFORNIA",NA,NA,629,363,266,369,142,227,0.625,0.587,0.534,17340,404
"1054",123554,2000,1,0,"SAINT MARYS COLLEGE OF CALIFORNIA",NA,NA,620,366,254,368,149,219,0.598,0.594,0.587,18120,388
"1055",123554,2001,1,0,"SAINT MARYS COLLEGE OF CALIFORNIA",NA,NA,580,352,228,350,129,221,0.628,0.603,0.566,19390,344
"1056",123554,2002,1,0,"SAINT MARYS COLLEGE OF CALIFORNIA",NA,NA,663,408,255,381,141,240,0.588,0.575,0.553,20750,389
"1057",123554,2003,1,0,"SAINT MARYS COLLEGE OF CALIFORNIA",NA,NA,562,317,245,285,106,179,0.565,0.507,0.433,23640,327
"1058",123554,2004,1,0,"SAINT MARYS COLLEGE OF CALIFORNIA",NA,NA,603,388,215,319,102,217,0.559,0.529,0.474,25000,299
"1059",123554,2005,1,0,"Saint Marys College of California",NA,NA,659,399,260,313,107,206,0.516,0.475,0.412,27130,347
"1060",123554,2006,1,0,"Saint Marys College of California",NA,NA,600,384,216,292,105,187,0.487,0.487,0.486,28900,299
"1061",123554,2007,1,0,"Saint Marys College of California",NA,NA,600,366,234,283,102,181,0.495,0.472,0.436,30930,342
"1062",123554,2008,1,0,"Saint Marys College of California",NA,NA,665,436,229,349,100,249,0.571,0.525,0.437,33100,326
"1063",123554,2009,1,0,"Saint Marys College of California",NA,NA,567,354,213,320,101,219,0.619,0.564,0.474,33760,254
"1064",123554,2010,1,0,"Saint Marys College of California",NA,NA,694,421,273,387,139,248,0.589,0.558,0.509,35280,308
"1065",123572,1991,1,0,"SONOMA STATE UNIVERSITY",NA,NA,680,429,251,95,18,77,0.18,0.14,0.072,936,459
"1066",123572,1992,1,0,"SONOMA STATE UNIVERSITY",NA,NA,591,380,211,97,20,77,0.203,0.164,0.095,1474,407
"1067",123572,1993,1,0,"SONOMA STATE UNIVERSITY",NA,NA,539,362,177,82,18,64,0.177,0.152,0.102,1674,355
"1068",123572,1995,1,0,"SONOMA STATE UNIVERSITY",NA,NA,681,441,240,131,41,90,0.204,0.192,0.171,1891,459
"1069",123572,1996,1,0,"SONOMA STATE UNIVERSITY",NA,NA,781,502,279,156,36,120,0.239,0.2,0.129,1935,538
"1070",123572,1997,1,0,"SONOMA STATE UNIVERSITY",NA,NA,872,581,291,192,43,149,0.256,0.22,0.148,2110,586
"1071",123572,1998,1,0,"SONOMA STATE UNIVERSITY",NA,NA,823,557,266,177,37,140,0.251,0.215,0.139,2082,545
"1072",123572,1999,1,0,"SONOMA STATE UNIVERSITY",NA,NA,844,555,289,161,24,137,0.247,0.191,0.083,0,551
"1073",123572,2000,1,0,"SONOMA STATE UNIVERSITY",NA,NA,1064,714,350,236,46,190,0.266,0.222,0.131,0,705
"1074",123572,2001,1,0,"SONOMA STATE UNIVERSITY",NA,NA,1018,673,345,258,53,205,0.305,0.253,0.154,0,691
"1075",123572,2002,1,0,"SONOMA STATE UNIVERSITY",NA,NA,1210,816,394,289,53,236,0.289,0.239,0.135,0,825
"1076",123572,2003,1,0,"SONOMA STATE UNIVERSITY",NA,NA,1287,838,449,341,80,261,0.312,0.265,0.178,0,918
"1077",123572,2004,1,0,"SONOMA STATE UNIVERSITY",NA,NA,1102,713,389,344,76,268,0.376,0.312,0.195,0,778
"1078",123572,2005,1,0,"Sonoma State University",NA,NA,1043,697,346,309,69,240,0.344,0.296,0.199,0,719
"1079",123572,2006,1,0,"Sonoma State University",NA,NA,1513,1033,480,410,104,306,0.296,0.271,0.217,0,985
"1080",123572,2007,1,0,"Sonoma State University",NA,NA,1673,1073,600,434,97,337,0.314,0.259,0.162,0,1150
"1081",123572,2008,1,0,"Sonoma State University",NA,NA,1631,1058,573,444,96,348,0.329,0.272,0.168,0,1136
"1082",123572,2009,1,0,"Sonoma State University",NA,NA,1465,953,512,413,94,319,0.335,0.282,0.184,0,913
"1083",123572,2010,1,0,"Sonoma State University",NA,NA,1547,925,622,430,106,324,0.35,0.278,0.17,0,878
"1084",126562,1991,1,0,"UNIVERSITY OF COLORADO AT DENVER",NA,NA,262,152,110,25,7,18,0.118,0.095,0.064,1808,128
"1085",126562,1992,1,0,"UNIVERSITY OF COLORADO AT DENVER",NA,NA,272,175,97,29,6,23,0.131,0.107,0.062,1917,131
"1086",126562,1993,1,0,"UNIVERSITY OF COLORADO AT DENVER",NA,NA,243,141,102,38,9,29,0.206,0.156,0.088,1955,131
"1087",126562,1995,1,0,"UNIVERSITY OF COLORADO AT DENVER",NA,NA,266,166,100,41,14,27,0.163,0.154,0.14,2098,124
"1088",126562,1996,1,0,"UNIVERSITY OF COLORADO AT DENVER",NA,NA,373,215,158,54,20,34,0.158,0.145,0.127,2183,229
"1089",126562,1997,1,0,"UNIVERSITY OF COLORADO AT DENVER",NA,NA,439,245,194,63,23,40,0.163,0.144,0.119,2191,231
"1090",126562,1998,1,0,"UNIVERSITY OF COLORADO AT DENVER",NA,NA,394,223,171,58,17,41,0.184,0.147,0.099,2255,202
"1091",126562,1999,1,0,"UNIVERSITY OF COLORADO AT DENVER",NA,NA,478,259,219,76,30,46,0.178,0.159,0.137,2068,253
"1092",126562,2000,1,0,"UNIVERSITY OF COLORADO AT DENVER",NA,NA,515,296,219,71,23,48,0.162,0.138,0.105,2298,271
"1093",126562,2001,1,0,"UNIVERSITY OF COLORADO AT DENVER",NA,NA,492,288,204,63,27,36,0.125,0.128,0.132,2934,287
"1094",126562,2002,1,0,"UNIVERSITY OF COLORADO AT DENVER",NA,NA,580,326,254,86,26,60,0.184,0.148,0.102,2752,356
"1095",126562,2003,1,0,"UNIVERSITY OF COLORADO AT DENVER",NA,NA,624,353,271,104,36,68,0.193,0.167,0.133,3028,380
"1096",126562,2004,1,0,"UNIVERSITY OF COLORADO AT DENVER",NA,NA,686,387,299,101,34,67,0.173,0.147,0.114,3300,414
"1097",126562,2005,1,0,"University of Colorado at Denver and Health Sciences Center",NA,NA,744,414,330,108,30,78,0.188,0.145,0.091,4224,435
"1098",126562,2006,1,0,"University of Colorado at Denver and Health Sciences Center",NA,NA,885,510,375,155,52,103,0.202,0.175,0.139,4330,514
"1099",126562,2007,1,0,"University of Colorado Denver",NA,NA,1010,571,439,163,66,97,0.17,0.161,0.15,5054,565
"1100",126562,2008,1,0,"University of Colorado Denver",NA,NA,1036,603,433,156,68,88,0.146,0.151,0.157,5484,597
"1101",126562,2009,1,0,"University of Colorado Denver",NA,NA,1037,556,481,172,64,108,0.194,0.166,0.133,5712,524
"1102",126562,2010,1,0,"University of Colorado Denver",NA,NA,1020,551,469,210,76,134,0.243,0.206,0.162,6216,522
"1103",126580,1991,1,0,"UNIVERSITY OF COLORADO-COLORADO SPRINGS",NA,NA,319,183,136,36,12,24,0.131,0.113,0.088,2044,270
"1104",126580,1992,1,0,"UNIVERSITY OF COLORADO-COLORADO SPRINGS",NA,NA,313,174,139,29,9,20,0.115,0.093,0.065,2167,241
"1105",126580,1993,1,0,"UNIVERSITY OF COLORADO AT COLORADO SPRINGS",NA,NA,306,164,142,46,18,28,0.171,0.15,0.127,2225,252
"1106",126580,1995,1,0,"UNIVERSITY OF COLORADO AT COLORADO SPRINGS",NA,NA,363,197,166,88,36,52,0.264,0.242,0.217,2375,283
"1107",126580,1996,1,0,"UNIVERSITY OF COLORADO AT COLORADO SPRINGS",NA,NA,375,227,148,63,18,45,0.198,0.168,0.122,2439,295
"1108",126580,1997,1,0,"UNIVERSITY OF COLORADO AT COLORADO SPRINGS",NA,NA,519,298,221,83,27,56,0.188,0.16,0.122,2681,400
"1109",126580,1998,1,0,"UNIVERSITY OF COLORADO AT COLORADO SPRINGS",NA,NA,635,372,263,154,53,101,0.272,0.243,0.202,2681,500
"1110",126580,1999,1,0,"UNIVERSITY OF COLORADO AT COLORADO SPRINGS",NA,NA,682,395,287,104,35,69,0.175,0.152,0.122,2234,524
"1111",126580,2000,1,0,"UNIVERSITY OF COLORADO AT COLORADO SPRINGS",NA,NA,718,457,261,162,38,124,0.271,0.226,0.146,2690,551
"1112",126580,2001,1,0,"UNIVERSITY OF COLORADO AT COLORADO SPRINGS",NA,NA,785,453,332,171,54,117,0.258,0.218,0.163,2864,596
"1113",126580,2002,1,0,"UNIVERSITY OF COLORADO AT COLORADO SPRINGS",NA,NA,834,501,333,211,66,145,0.289,0.253,0.198,3154,658
"1114",126580,2003,1,0,"UNIVERSITY OF COLORADO AT COLORADO SPRINGS",NA,NA,892,552,340,193,43,150,0.272,0.216,0.126,3026,694
"1115",126580,2004,1,0,"UNIVERSITY OF COLORADO AT COLORADO SPRINGS",NA,NA,939,562,377,198,54,144,0.256,0.211,0.143,3296,726
"1116",126580,2005,1,0,"University of Colorado at Colorado Springs",NA,NA,947,595,352,210,50,160,0.269,0.222,0.142,3966,737
"1117",126580,2006,1,0,"University of Colorado at Colorado Springs",NA,NA,914,531,383,216,75,141,0.266,0.236,0.196,4054,693
"1118",126580,2007,1,0,"University of Colorado at Colorado Springs",NA,NA,933,511,422,247,89,158,0.309,0.265,0.211,4338,676
"1119",126580,2008,1,0,"University of Colorado at Colorado Springs",NA,NA,1075,577,498,288,110,178,0.308,0.268,0.221,4464,815
"1120",126580,2009,1,0,"University of Colorado at Colorado Springs",NA,NA,1035,543,492,247,98,149,0.274,0.239,0.199,4680,742
"1121",126580,2010,1,0,"University of Colorado at Colorado Springs",NA,NA,1123,568,555,284,112,172,0.303,0.253,0.202,5016,798
"1122",126614,1991,1,0,"UNIVERSITY OF COLORADO AT BOULDER",NA,NA,3421,1631,1790,1268,550,718,0.44,0.371,0.307,3066,2666
"1123",126614,1992,1,0,"UNIVERSITY OF COLORADO AT BOULDER",NA,NA,3559,1700,1859,1198,514,684,0.402,0.337,0.276,2560,2818
"1124",126614,1993,1,0,"UNIVERSITY OF COLORADO AT BOULDER",NA,NA,3440,1693,1747,1215,509,706,0.417,0.353,0.291,2574,2656
"1125",126614,1995,1,0,"UNIVERSITY OF COLORADO AT BOULDER",NA,NA,4170,2020,2150,1454,602,852,0.422,0.349,0.28,2770,3359
"1126",126614,1996,1,0,"UNIVERSITY OF COLORADO AT BOULDER",NA,NA,3953,1983,1970,1529,623,906,0.457,0.387,0.316,2840,3224
"1127",126614,1997,1,0,"UNIVERSITY OF COLORADO AT BOULDER",NA,NA,4259,2157,2102,1565,633,932,0.432,0.367,0.301,2939,3456
"1128",126614,1998,1,0,"UNIVERSITY OF COLORADO AT BOULDER",NA,NA,4263,2037,2226,1545,647,898,0.441,0.362,0.291,3038,3483
"1129",126614,1999,1,0,"UNIVERSITY OF COLORADO AT BOULDER",NA,NA,4545,2303,2242,1728,700,1028,0.446,0.38,0.312,2444,3768
"1130",126614,2000,1,0,"UNIVERSITY OF COLORADO AT BOULDER",NA,NA,5047,2445,2602,1937,829,1108,0.453,0.384,0.319,2514,4131
"1131",126614,2001,1,0,"UNIVERSITY OF COLORADO AT BOULDER",NA,NA,4962,2396,2566,2013,887,1126,0.47,0.406,0.346,2614,3899
"1132",126614,2002,1,0,"UNIVERSITY OF COLORADO AT BOULDER",NA,NA,5377,2607,2770,2218,1001,1217,0.467,0.412,0.361,2776,4294
"1133",126614,2003,1,0,"UNIVERSITY OF COLORADO AT BOULDER",NA,NA,5515,2761,2754,2267,966,1301,0.471,0.411,0.351,3192,4461
"1134",126614,2004,1,0,"UNIVERSITY OF COLORADO AT BOULDER",NA,NA,5124,2484,2640,2093,909,1184,0.477,0.408,0.344,3480,4025
"1135",126614,2005,1,0,"University of Colorado at Boulder",NA,NA,5007,2364,2643,2007,900,1107,0.468,0.401,0.341,4446,3977
"1136",126614,2006,1,0,"University of Colorado at Boulder",NA,NA,5606,2688,2918,2336,1016,1320,0.491,0.417,0.348,4554,4416
"1137",126614,2007,1,0,"University of Colorado at Boulder",NA,NA,5540,2734,2806,2456,1059,1397,0.511,0.443,0.377,5418,4405
"1138",126614,2008,1,0,"University of Colorado at Boulder",NA,NA,5811,2890,2921,2678,1158,1520,0.526,0.461,0.396,5922,4568
"1139",126614,2009,1,0,"University of Colorado at Boulder",NA,NA,5515,2719,2796,2598,1102,1496,0.55,0.471,0.394,6446,4285
"1140",126614,2010,1,0,"University of Colorado Boulder",NA,NA,5138,2403,2735,2438,1094,1344,0.559,0.475,0.4,7018,4000
"1141",126818,1991,1,0,"COLORADO STATE UNIVERSITY",NA,NA,2155,1144,1011,516,173,343,0.3,0.239,0.171,2362,1773
"1142",126818,1992,1,0,"COLORADO STATE UNIVERSITY",NA,NA,2202,1150,1052,575,205,370,0.322,0.261,0.195,2511,1872
"1143",126818,1993,1,0,"COLORADO STATE UNIVERSITY",NA,NA,2168,1160,1008,611,210,401,0.346,0.282,0.208,2558,1803
"1144",126818,1995,1,0,"COLORADO STATE UNIVERSITY",NA,NA,2546,1354,1192,805,287,518,0.383,0.316,0.241,2771,2155
"1145",126818,1996,1,0,"COLORADO STATE UNIVERSITY",NA,NA,2695,1511,1184,847,307,540,0.357,0.314,0.259,2847,2299
"1146",126818,1997,1,0,"COLORADO STATE UNIVERSITY",NA,NA,2615,1435,1180,861,304,557,0.388,0.329,0.258,2925,2230
"1147",126818,1998,1,0,"COLORADO STATE UNIVERSITY",NA,NA,3028,1772,1256,1028,301,727,0.41,0.339,0.24,2986,2590
"1148",126818,1999,1,0,"COLORADO STATE UNIVERSITY",NA,NA,3076,1702,1374,1054,371,683,0.401,0.343,0.27,2340,2642
"1149",126818,2000,1,0,"COLORADO STATE UNIVERSITY",NA,NA,3240,1862,1378,1119,370,749,0.402,0.345,0.269,2408,2710
"1150",126818,2001,1,0,"COLORADO STATE UNIVERSITY",NA,NA,3683,2061,1622,1285,420,865,0.42,0.349,0.259,2502,3112
"1151",126818,2002,1,0,"COLORADO STATE UNIVERSITY",NA,NA,3783,2121,1662,1340,442,898,0.423,0.354,0.266,2655,3159
"1152",126818,2003,1,0,"COLORADO STATE UNIVERSITY",NA,NA,3730,2012,1718,1319,483,836,0.416,0.354,0.281,2908,3142
"1153",126818,2004,1,0,"COLORADO STATE UNIVERSITY",NA,NA,4047,2216,1831,1484,522,962,0.434,0.367,0.285,2940,3412
"1154",126818,2005,1,0,"Colorado State University",NA,NA,3622,2036,1586,1278,406,872,0.428,0.353,0.256,3381,2994
"1155",126818,2006,1,0,"Colorado State University",NA,NA,3825,2166,1659,1448,441,1007,0.465,0.379,0.266,3466,3136
"1156",126818,2007,1,0,"Colorado State University",NA,NA,4352,2387,1965,1609,564,1045,0.438,0.37,0.287,4040,3659
"1157",126818,2008,1,0,"Colorado State University",NA,NA,4386,2435,1951,1693,567,1126,0.462,0.386,0.291,4424,3479
"1158",126818,2009,1,0,"Colorado State University",NA,NA,4274,2360,1914,1732,593,1139,0.483,0.405,0.31,4822,3303
"1159",126818,2010,1,0,"Colorado State University-Fort Collins",NA,NA,4321,2414,1907,1820,656,1164,0.482,0.421,0.344,5256,3339
"1160",127060,1991,0,1,"UNIVERSITY OF DENVER",9999,0,504,265,239,280,123,157,0.593,0.556,0.515,12990,396
"1161",127060,1992,0,1,"UNIVERSITY OF DENVER",9999,0,555,284,271,303,130,173,0.609,0.546,0.48,13572,425
"1162",127060,1993,0,1,"UNIVERSITY OF DENVER",9999,0,576,306,270,332,144,188,0.614,0.576,0.533,14472,438
"1163",127060,1995,0,1,"UNIVERSITY OF DENVER",9999,0,654,330,324,376,175,201,0.609,0.575,0.54,16056,506
"1164",127060,1996,0,1,"UNIVERSITY OF DENVER",9999,0,717,372,345,389,168,221,0.594,0.543,0.487,16848,515
"1165",127060,1997,0,1,"UNIVERSITY OF DENVER",9999,0,689,354,335,387,173,214,0.605,0.562,0.516,17640,495
"1166",127060,1998,0,1,"UNIVERSITY OF DENVER",9999,0,768,393,375,414,185,229,0.583,0.539,0.493,18468,598
"1167",127060,1999,0,1,"UNIVERSITY OF DENVER",9999,0,812,410,402,420,181,239,0.583,0.517,0.45,18936,671
"1168",127060,2000,0,1,"UNIVERSITY OF DENVER",9999,0,926,505,421,526,214,312,0.618,0.568,0.508,20052,764
"1169",127060,2001,0,1,"UNIVERSITY OF DENVER",9999,0,933,486,447,561,249,312,0.642,0.601,0.557,21456,749
"1170",127060,2002,0,1,"UNIVERSITY OF DENVER",9999,0,988,527,461,571,235,336,0.638,0.578,0.51,22680,803
"1171",127060,2003,0,1,"UNIVERSITY OF DENVER",9999,0,1010,549,461,540,216,324,0.59,0.535,0.469,24264,850
"1172",127060,2004,0,1,"UNIVERSITY OF DENVER",9999,0,1124,588,536,633,286,347,0.59,0.563,0.534,25956,924
"1173",127060,2005,0,1,"University of Denver",9999,0,1089,608,481,655,251,404,0.665,0.601,0.522,27756,895
"1174",127060,2006,0,1,"University of Denver",9999,0,1135,615,520,692,290,402,0.654,0.61,0.558,29628,900
"1175",127060,2007,0,1,"University of Denver",9999,0,1130,619,511,752,321,431,0.696,0.665,0.628,31428,727
"1176",127060,2008,0,1,"University of Denver",9999,0,1131,633,498,743,317,426,0.673,0.657,0.637,32976,796
"1177",127060,2009,0,1,"University of Denver",9999,0,1196,684,512,797,314,483,0.706,0.666,0.613,34596,829
"1178",127060,2010,0,1,"University of Denver",9999,0,1215,663,552,806,320,486,0.733,0.663,0.58,35604,866
"1179",127185,1991,0,1,"FORT LEWIS COLLEGE",2000,0,935,424,511,67,30,37,0.087,0.072,0.059,1550,731
"1180",127185,1992,0,1,"FORT LEWIS COLLEGE",2000,0,1004,439,565,118,49,69,0.157,0.118,0.087,1701,785
"1181",127185,1993,0,1,"FORT LEWIS COLLEGE",2000,0,1078,438,640,95,39,56,0.128,0.088,0.061,1777,851
"1182",127185,1995,0,1,"FORT LEWIS COLLEGE",2000,0,1010,434,576,96,26,70,0.161,0.095,0.045,1904,777
"1183",127185,1996,0,1,"FORT LEWIS COLLEGE",2000,0,1124,493,631,122,43,79,0.16,0.109,0.068,2050,890
"1184",127185,1997,0,1,"FORT LEWIS COLLEGE",2000,0,1056,450,606,97,39,58,0.129,0.092,0.064,2084,797
"1185",127185,1998,0,1,"FORT LEWIS COLLEGE",2000,0,970,405,565,108,46,62,0.153,0.111,0.081,2110,722
"1186",127185,1999,0,1,"FORT LEWIS COLLEGE",2000,0,1019,429,590,102,37,65,0.152,0.1,0.063,1676,728
"1187",127185,2000,1,0,"FORT LEWIS COLLEGE",2000,1,938,428,510,120,45,75,0.175,0.128,0.088,1724,674
"1188",127185,2001,1,0,"FORT LEWIS COLLEGE",2000,1,1047,469,578,139,50,89,0.19,0.133,0.087,1792,702
"1189",127185,2002,1,0,"FORT LEWIS COLLEGE",2000,1,1035,467,568,147,59,88,0.188,0.142,0.104,1902,730
"1190",127185,2003,1,0,"FORT LEWIS COLLEGE",2000,1,899,422,477,138,51,87,0.206,0.154,0.107,2020,622
"1191",127185,2004,1,0,"FORT LEWIS COLLEGE",2000,1,930,448,482,181,67,114,0.254,0.195,0.139,2270,645
"1192",127185,2005,1,0,"Fort Lewis College",2000,1,860,386,474,161,70,91,0.236,0.187,0.148,4862,580
"1193",127185,2006,1,0,"Fort Lewis College",2000,1,821,367,454,161,59,102,0.278,0.196,0.13,5102,518
"1194",127185,2007,1,0,"Fort Lewis College",2000,1,863,404,459,149,50,99,0.245,0.173,0.109,5138,565
"1195",127185,2008,1,0,"Fort Lewis College",2000,1,758,355,403,136,62,74,0.209,0.179,0.154,2846,475
"1196",127185,2009,1,0,"Fort Lewis College",2000,1,766,344,422,138,64,74,0.215,0.18,0.152,3102,515
"1197",127185,2010,1,0,"Fort Lewis College",2000,1,830,393,437,203,74,129,0.328,0.245,0.169,3380,552
"1198",127565,1991,1,0,"METROPOLITAN STATE COLLEGE OF DENVER",NA,NA,1357,669,688,35,12,23,0.034,0.026,0.017,1483,1004
"1199",127565,1992,1,0,"METROPOLITAN STATE COLLEGE OF DENVER",NA,NA,1227,614,613,49,17,32,0.052,0.04,0.028,1709,905
"1200",127565,1993,1,0,"METROPOLITAN STATE COLLEGE OF DENVER",NA,NA,1380,682,698,43,22,21,0.031,0.031,0.032,1749,968
"1201",127565,1995,1,0,"METROPOLITAN STATE COLLEGE OF DENVER",NA,NA,1239,691,548,48,19,29,0.042,0.039,0.035,1850,801
"1202",127565,1996,1,0,"METROPOLITAN STATE COLLEGE OF DENVER",NA,NA,1324,677,647,51,15,36,0.053,0.039,0.023,1942,891
"1203",127565,1997,1,0,"METROPOLITAN STATE COLLEGE OF DENVER",NA,NA,1478,787,691,69,19,50,0.064,0.047,0.027,1976,1016
"1204",127565,1998,1,0,"METROPOLITAN STATE COLLEGE OF DENVER",NA,NA,1382,759,623,81,29,52,0.068,0.059,0.047,2033,935
"1205",127565,1999,1,0,"METROPOLITAN STATE COLLEGE OF DENVER",NA,NA,1440,764,676,86,40,46,0.06,0.06,0.059,1718,989
"1206",127565,2000,1,0,"METROPOLITAN STATE COLLEGE OF DENVER",NA,NA,1435,778,657,79,27,52,0.067,0.055,0.041,1768,950
"1207",127565,2001,1,0,"METROPOLITAN STATE COLLEGE OF DENVER",NA,NA,1596,816,780,97,42,55,0.067,0.061,0.054,1893,1087
"1208",127565,2002,1,0,"METROPOLITAN STATE COLLEGE OF DENVER",NA,NA,1655,852,803,73,25,48,0.056,0.044,0.031,1925,1143
"1209",127565,2003,1,0,"METROPOLITAN STATE COLLEGE OF DENVER",NA,NA,1809,931,878,82,26,56,0.06,0.045,0.03,2021,1209
"1210",127565,2004,1,0,"METROPOLITAN STATE COLLEGE OF DENVER",NA,NA,1815,937,878,86,34,52,0.056,0.047,0.039,2044,1242
"1211",127565,2005,1,0,"Metropolitan State College of Denver",NA,NA,1840,939,901,79,32,47,0.05,0.043,0.036,2191,1201
"1212",127565,2006,1,0,"Metropolitan State College of Denver",NA,NA,1711,925,786,102,33,69,0.075,0.06,0.042,2246,1014
"1213",127565,2007,1,0,"Metropolitan State College of Denver",NA,NA,1910,1036,874,108,38,70,0.068,0.057,0.043,2432,1287
"1214",127565,2008,1,0,"Metropolitan State College of Denver",NA,NA,1918,969,949,88,33,55,0.057,0.046,0.035,2615,1218
"1215",127565,2009,1,0,"Metropolitan State College of Denver",NA,NA,1959,985,974,115,46,69,0.07,0.059,0.047,2850,1168
"1216",127565,2010,1,0,"Metropolitan State College of Denver",NA,NA,1876,916,960,112,43,69,0.075,0.06,0.045,3107,1086
"1217",127741,1991,1,0,"UNIVERSITY OF NORTHERN COLORADO",NA,NA,1639,937,702,258,78,180,0.192,0.157,0.111,1926,1365
"1218",127741,1992,1,0,"UNIVERSITY OF NORTHERN COLORADO",NA,NA,1464,921,543,232,63,169,0.184,0.158,0.116,2027,1168
"1219",127741,1993,1,0,"UNIVERSITY OF NORTHERN COLORADO",NA,NA,1704,1019,685,309,81,228,0.224,0.181,0.118,2114,1372
"1220",127741,1995,1,0,"UNIVERSITY OF NORTHERN COLORADO",NA,NA,1763,1091,672,404,90,314,0.288,0.229,0.134,2408,1456
"1221",127741,1996,1,0,"UNIVERSITY OF NORTHERN COLORADO",NA,NA,1642,1000,642,413,120,293,0.293,0.252,0.187,2542,1365
"1222",127741,1997,1,0,"UNIVERSITY OF NORTHERN COLORADO",NA,NA,1905,1147,758,490,107,383,0.334,0.257,0.141,2578,1543
"1223",127741,1998,1,0,"UNIVERSITY OF NORTHERN COLORADO",NA,NA,2165,1314,851,515,123,392,0.298,0.238,0.145,2652,1825
"1224",127741,1999,1,0,"UNIVERSITY OF NORTHERN COLORADO",NA,NA,2291,1401,890,589,129,460,0.328,0.257,0.145,2014,1892
"1225",127741,2000,1,0,"UNIVERSITY OF NORTHERN COLORADO",NA,NA,2113,1240,873,605,162,443,0.357,0.286,0.186,2072,1748
"1226",127741,2001,1,0,"UNIVERSITY OF NORTHERN COLORADO",NA,NA,2108,1309,799,623,140,483,0.369,0.296,0.175,2155,1740
"1227",127741,2002,1,0,"UNIVERSITY OF NORTHERN COLORADO",NA,NA,1938,1253,685,548,116,432,0.345,0.283,0.169,2290,1622
"1228",127741,2003,1,0,"UNIVERSITY OF NORTHERN COLORADO",NA,NA,2118,1337,781,598,169,429,0.321,0.282,0.216,2520,1747
"1229",127741,2004,1,0,"UNIVERSITY OF NORTHERN COLORADO",NA,NA,2412,1459,953,648,190,458,0.314,0.269,0.199,2850,1906
"1230",127741,2005,1,0,"University of Northern Colorado",NA,NA,2483,1479,1004,620,173,447,0.302,0.25,0.172,3192,1987
"1231",127741,2006,1,0,"University of Northern Colorado",NA,NA,2491,1442,1049,659,204,455,0.316,0.265,0.194,3276,1950
"1232",127741,2007,1,0,"University of Northern Colorado",NA,NA,2199,1328,871,583,149,434,0.327,0.265,0.171,3600,1722
"1233",127741,2008,1,0,"University of Northern Colorado",NA,NA,2071,1227,844,558,156,402,0.328,0.269,0.185,3942,1613
"1234",127741,2009,1,0,"University of Northern Colorado",NA,NA,2275,1360,915,605,165,440,0.324,0.266,0.18,4296,1696
"1235",127741,2010,1,0,"University of Northern Colorado",NA,NA,2221,1420,801,653,183,470,0.331,0.294,0.228,4680,1537
"1236",128106,1991,1,0,"UNIVERSITY OF SOUTHERN COLORADO",NA,NA,579,287,292,59,23,36,0.125,0.102,0.079,1725,386
"1237",128106,1992,1,0,"UNIVERSITY OF SOUTHERN COLORADO",NA,NA,656,342,314,58,21,37,0.108,0.088,0.067,1833,433
"1238",128106,1993,1,0,"UNIVERSITY OF SOUTHERN COLORADO",NA,NA,678,321,357,78,34,44,0.137,0.115,0.095,1878,466
"1239",128106,1995,1,0,"UNIVERSITY OF SOUTHERN COLORADO",NA,NA,590,299,291,69,31,38,0.127,0.117,0.107,2080,377
"1240",128106,1996,1,0,"UNIVERSITY OF SOUTHERN COLORADO",NA,NA,574,305,269,68,19,49,0.161,0.118,0.071,2149,381
"1241",128106,1997,1,0,"UNIVERSITY OF SOUTHERN COLORADO",NA,NA,580,299,281,49,20,29,0.097,0.084,0.071,2186,369
"1242",128106,1998,1,0,"UNIVERSITY OF SOUTHERN COLORADO",NA,NA,611,345,266,80,30,50,0.145,0.131,0.113,2219,350
"1243",128106,1999,1,0,"UNIVERSITY OF SOUTHERN COLORADO",NA,NA,611,326,285,76,27,49,0.15,0.124,0.095,1808,391
"1244",128106,2000,1,0,"UNIVERSITY OF SOUTHERN COLORADO",NA,NA,641,331,310,101,41,60,0.181,0.158,0.132,1860,392
"1245",128106,2001,1,0,"UNIVERSITY OF SOUTHERN COLORADO",NA,NA,634,343,291,115,47,68,0.198,0.181,0.162,1940,353
"1246",128106,2002,1,0,"UNIVERSITY OF SOUTHERN COLORADO",NA,NA,642,329,313,105,39,66,0.201,0.164,0.125,2060,383
"1247",128106,2003,1,0,"COLORADO STATE UNIVERSITY-PUEBLO",NA,NA,686,372,314,93,35,58,0.156,0.136,0.111,1873,422
"1248",128106,2004,1,0,"COLORADO STATE UNIVERSITY-PUEBLO",NA,NA,753,423,330,118,34,84,0.199,0.157,0.103,2524,454
"1249",128106,2005,1,0,"Colorado State University-Pueblo",NA,NA,665,361,304,125,54,71,0.197,0.188,0.178,2903,382
"1250",128106,2006,1,0,"Colorado State University-Pueblo",NA,NA,628,350,278,112,42,70,0.2,0.178,0.151,2975,349
"1251",128106,2007,1,0,"Colorado State University-Pueblo",NA,NA,602,308,294,109,41,68,0.221,0.181,0.139,3184,314
"1252",128106,2008,1,0,"Colorado State University-Pueblo",NA,NA,1002,465,537,160,65,95,0.204,0.16,0.121,3422,517
"1253",128106,2009,1,0,"Colorado State University-Pueblo",NA,NA,1013,513,500,178,67,111,0.216,0.176,0.134,3732,521
"1254",128106,2010,1,0,"Colorado State University-Pueblo",NA,NA,977,467,510,182,80,102,0.218,0.186,0.157,4068,486
"1255",128744,1991,1,0,"UNIVERSITY OF BRIDGEPORT",NA,NA,208,110,98,12,5,7,0.064,0.058,0.051,12774,81
"1256",128744,1992,1,0,"UNIVERSITY OF BRIDGEPORT",NA,NA,18,12,6,1,0,1,0.083,0.056,0,12880,3
"1257",128744,1993,1,0,"UNIVERSITY OF BRIDGEPORT",NA,NA,137,66,71,58,20,38,0.576,0.423,0.282,12905,37
"1258",128744,1995,1,0,"UNIVERSITY OF BRIDGEPORT",NA,NA,123,73,50,38,14,24,0.329,0.309,0.28,13124,37
"1259",128744,1996,1,0,"UNIVERSITY OF BRIDGEPORT",NA,NA,116,58,58,35,17,18,0.31,0.302,0.293,13144,25
"1260",128744,1997,1,0,"UNIVERSITY OF BRIDGEPORT",NA,NA,187,93,94,58,24,34,0.366,0.31,0.255,13644,49
"1261",128744,1998,1,0,"UNIVERSITY OF BRIDGEPORT",NA,NA,233,94,139,80,48,32,0.34,0.343,0.345,14041,30
"1262",128744,1999,1,0,"UNIVERSITY OF BRIDGEPORT",NA,NA,190,96,94,39,15,24,0.25,0.205,0.16,13800,42
"1263",128744,2000,1,0,"UNIVERSITY OF BRIDGEPORT",NA,NA,161,80,81,53,21,32,0.4,0.329,0.259,14150,45
"1264",128744,2001,1,0,"UNIVERSITY OF BRIDGEPORT",NA,NA,175,97,78,49,17,32,0.33,0.28,0.218,14720,20
"1265",128744,2002,1,0,"UNIVERSITY OF BRIDGEPORT",NA,NA,234,144,90,66,23,43,0.299,0.282,0.256,15604,48
"1266",128744,2003,1,0,"UNIVERSITY OF BRIDGEPORT",NA,NA,286,158,128,61,14,47,0.298,0.213,0.109,17008,67
"1267",128744,2004,1,0,"UNIVERSITY OF BRIDGEPORT",NA,NA,241,134,107,47,19,28,0.209,0.195,0.178,18300,62
"1268",128744,2005,1,0,"University of Bridgeport",NA,NA,352,212,140,64,20,44,0.208,0.182,0.143,19200,78
"1269",128744,2006,1,0,"University of Bridgeport",NA,NA,303,176,127,70,20,50,0.284,0.231,0.157,20250,72
"1270",128744,2007,1,0,"University of Bridgeport",NA,NA,331,209,122,62,17,45,0.215,0.187,0.139,21150,70
"1271",128744,2008,1,0,"University of Bridgeport",NA,NA,444,266,178,90,30,60,0.226,0.203,0.169,22500,72
"1272",128744,2009,1,0,"University of Bridgeport",NA,NA,429,260,169,108,37,71,0.273,0.252,0.219,23400,75
"1273",128744,2010,1,0,"University of Bridgeport",NA,NA,594,397,197,122,41,81,0.204,0.205,0.208,24300,93
"1274",128771,1991,1,0,"CENTRAL CONNECTICUT STATE UNIVERSITY",NA,NA,1088,627,461,115,34,81,0.129,0.106,0.074,2414,914
"1275",128771,1992,1,0,"CENTRAL CONNECTICUT STATE UNIVERSITY",NA,NA,964,552,412,98,31,67,0.121,0.102,0.075,2804,801
"1276",128771,1993,1,0,"CENTRAL CONNECTICUT STATE UNIVERSITY",NA,NA,902,483,419,80,18,62,0.128,0.089,0.043,2976,714
"1277",128771,1995,1,0,"CENTRAL CONNECTICUT STATE UNIVERSITY",NA,NA,1076,566,510,68,28,40,0.071,0.063,0.055,3266,843
"1278",128771,1996,1,0,"CENTRAL CONNECTICUT STATE UNIVERSITY",NA,NA,1092,534,558,165,65,100,0.187,0.151,0.116,3542,886
"1279",128771,1997,1,0,"CENTRAL CONNECTICUT STATE UNIVERSITY",NA,NA,1213,626,587,82,36,46,0.074,0.068,0.061,3614,948
"1280",128771,1998,1,0,"CENTRAL CONNECTICUT STATE UNIVERSITY",NA,NA,1317,675,642,163,46,117,0.173,0.124,0.072,3670,1063
"1281",128771,1999,1,0,"CENTRAL CONNECTICUT STATE UNIVERSITY",NA,NA,1280,559,721,143,47,96,0.172,0.112,0.065,2062,932
"1282",128771,2000,1,0,"CENTRAL CONNECTICUT STATE UNIVERSITY",NA,NA,1304,635,669,141,42,99,0.156,0.108,0.063,2142,1001
"1283",128771,2001,1,0,"CENTRAL CONNECTICUT STATE UNIVERSITY",NA,NA,1261,623,638,169,74,95,0.152,0.134,0.116,2226,975
"1284",128771,2002,1,0,"CENTRAL CONNECTICUT STATE UNIVERSITY",NA,NA,1473,735,738,192,61,131,0.178,0.13,0.083,2314,1188
"1285",128771,2003,1,0,"CENTRAL CONNECTICUT STATE UNIVERSITY",NA,NA,1176,571,605,166,59,107,0.187,0.141,0.098,2648,906
"1286",128771,2004,1,0,"CENTRAL CONNECTICUT STATE UNIVERSITY",NA,NA,1278,596,682,213,80,133,0.223,0.167,0.117,2862,977
"1287",128771,2005,1,0,"Central Connecticut State University",NA,NA,1333,663,670,188,82,106,0.16,0.141,0.122,3034,1050
"1288",128771,2006,1,0,"Central Connecticut State University",NA,NA,1282,603,679,272,117,155,0.257,0.212,0.172,3187,1008
"1289",128771,2007,1,0,"Central Connecticut State University",NA,NA,1466,676,790,294,133,161,0.238,0.201,0.168,3346,1154
"1290",128771,2008,1,0,"Central Connecticut State University",NA,NA,1297,578,719,279,133,146,0.253,0.215,0.185,3514,992
"1291",128771,2009,1,0,"Central Connecticut State University",NA,NA,1277,621,656,321,128,193,0.311,0.251,0.195,3742,940
"1292",128771,2010,1,0,"Central Connecticut State University",NA,NA,1340,592,748,279,125,154,0.26,0.208,0.167,4023,1031
"1293",129020,1991,1,0,"UNIVERSITY OF CONNECTICUT",NA,NA,2904,1464,1440,977,359,618,0.422,0.336,0.249,3402,2381
"1294",129020,1992,1,0,"UNIVERSITY OF CONNECTICUT",NA,NA,2831,1454,1377,968,354,614,0.422,0.342,0.257,3902,2197
"1295",129020,1993,1,0,"UNIVERSITY OF CONNECTICUT",NA,NA,2052,1068,984,775,297,478,0.448,0.378,0.302,4290,1670
"1296",129020,1995,1,0,"UNIVERSITY OF CONNECTICUT",NA,NA,2010,1051,959,855,341,514,0.489,0.425,0.356,4810,1558
"1297",129020,1996,1,0,"UNIVERSITY OF CONNECTICUT",NA,NA,2142,1156,986,908,311,597,0.516,0.424,0.315,4974,1643
"1298",129020,1997,1,0,"UNIVERSITY OF CONNECTICUT",NA,NA,2172,1181,991,977,340,637,0.539,0.45,0.343,5242,1663
"1299",129020,1998,1,0,"UNIVERSITY OF CONNECTICUT",NA,NA,2536,1358,1178,1135,431,704,0.518,0.448,0.366,5330,1907
"1300",129020,1999,1,0,"UNIVERSITY OF CONNECTICUT",NA,NA,2940,1596,1344,1454,523,931,0.583,0.495,0.389,4158,2256
"1301",129020,2000,1,0,"UNIVERSITY OF CONNECTICUT",NA,NA,2802,1549,1253,1484,554,930,0.6,0.53,0.442,4282,2112
"1302",129020,2001,1,0,"UNIVERSITY OF CONNECTICUT",NA,NA,3122,1648,1474,1671,682,989,0.6,0.535,0.463,4448,1979
"1303",129020,2002,1,0,"UNIVERSITY OF CONNECTICUT",NA,NA,3157,1722,1435,1766,674,1092,0.634,0.559,0.47,4730,2382
"1304",129020,2003,1,0,"UNIVERSITY OF CONNECTICUT",NA,NA,3182,1733,1449,1912,757,1155,0.667,0.601,0.522,5260,2402
"1305",129020,2004,1,0,"UNIVERSITY OF CONNECTICUT",NA,NA,3229,1789,1440,2104,830,1274,0.712,0.652,0.576,5772,2402
"1306",129020,2005,1,0,"University of Connecticut",NA,NA,3239,1789,1450,2176,881,1295,0.724,0.672,0.608,6096,2212
"1307",129020,2006,1,0,"University of Connecticut",NA,NA,3222,1631,1591,2148,962,1186,0.727,0.667,0.605,6456,2074
"1308",129020,2007,1,0,"University of Connecticut",NA,NA,3160,1682,1478,2136,921,1215,0.722,0.676,0.623,6816,2012
"1309",129020,2008,1,0,"University of Connecticut",NA,NA,3587,1780,1807,2382,1098,1284,0.721,0.664,0.608,7200,2208
"1310",129020,2009,1,0,"University of Connecticut",NA,NA,3206,1652,1554,2216,986,1230,0.745,0.691,0.634,7632,2125
"1311",129020,2010,1,0,"University of Connecticut",NA,NA,3317,1629,1688,2300,1076,1224,0.751,0.693,0.637,8064,2284
"1312",129242,1991,1,0,"FAIRFIELD UNIVERSITY",NA,NA,749,429,320,597,255,342,0.797,0.797,0.797,12920,672
"1313",129242,1992,1,0,"FAIRFIELD UNIVERSITY",NA,NA,861,506,355,672,277,395,0.781,0.78,0.78,13720,780
"1314",129242,1993,1,0,"FAIRFIELD UNIVERSITY",NA,NA,773,392,381,595,283,312,0.796,0.77,0.743,14560,677
"1315",129242,1995,1,0,"FAIRFIELD UNIVERSITY",NA,NA,784,450,334,602,248,354,0.787,0.768,0.743,16340,681
"1316",129242,1996,1,0,"FAIRFIELD UNIVERSITY",NA,NA,876,440,436,642,299,343,0.78,0.733,0.686,17360,765
"1317",129242,1997,1,0,"FAIRFIELD UNIVERSITY",NA,NA,876,462,414,649,286,363,0.786,0.741,0.691,18310,781
"1318",129242,1998,1,0,"FAIRFIELD UNIVERSITY",NA,NA,875,478,397,679,299,380,0.795,0.776,0.753,19210,749
"1319",129242,1999,1,0,"FAIRFIELD UNIVERSITY",NA,NA,837,446,391,662,287,375,0.841,0.791,0.734,20000,756
"1320",129242,2000,1,0,"FAIRFIELD UNIVERSITY",NA,NA,1008,610,398,797,291,506,0.83,0.791,0.731,21000,908
"1321",129242,2001,1,0,"FAIRFIELD UNIVERSITY",NA,NA,831,463,368,646,265,381,0.823,0.777,0.72,22430,697
"1322",129242,2002,1,0,"FAIRFIELD UNIVERSITY",NA,NA,813,461,352,609,240,369,0.8,0.749,0.682,24100,708
"1323",129242,2003,1,0,"FAIRFIELD UNIVERSITY",NA,NA,789,459,330,636,260,376,0.819,0.806,0.788,26100,692
"1324",129242,2004,1,0,"FAIRFIELD UNIVERSITY",NA,NA,856,475,381,679,282,397,0.836,0.793,0.74,27930,784
"1325",129242,2005,1,0,"Fairfield University",NA,NA,940,551,389,744,297,447,0.811,0.791,0.763,29730,742
"1326",129242,2006,1,0,"Fairfield University",NA,NA,896,534,362,696,269,427,0.8,0.777,0.743,31450,614
"1327",129242,2007,1,0,"Fairfield University",NA,NA,842,496,346,664,268,396,0.798,0.789,0.775,33340,619
"1328",129242,2008,1,0,"Fairfield University",NA,NA,898,537,361,688,257,431,0.803,0.766,0.712,35510,536
"1329",129242,2009,1,0,"Fairfield University",NA,NA,848,479,369,664,270,394,0.823,0.783,0.732,36900,540
"1330",129242,2010,1,0,"Fairfield University",NA,NA,921,576,345,722,250,472,0.819,0.784,0.725,38450,627
"1331",129941,1991,1,0,"UNIVERSITY OF NEW HAVEN",NA,NA,320,84,236,60,42,18,0.214,0.188,0.178,9600,208
"1332",129941,1992,1,0,"UNIVERSITY OF NEW HAVEN",NA,NA,302,74,228,42,30,12,0.162,0.139,0.132,9870,194
"1333",129941,1993,1,0,"UNIVERSITY OF NEW HAVEN",NA,NA,289,103,186,47,27,20,0.194,0.163,0.145,10180,171
"1334",129941,1995,1,0,"UNIVERSITY OF NEW HAVEN",NA,NA,352,115,237,110,74,36,0.313,0.312,0.312,11450,247
"1335",129941,1996,1,0,"UNIVERSITY OF NEW HAVEN",NA,NA,329,109,220,68,40,28,0.257,0.207,0.182,12110,229
"1336",129941,1997,1,0,"UNIVERSITY OF NEW HAVEN",NA,NA,324,130,194,87,46,41,0.315,0.269,0.237,13100,207
"1337",129941,1998,1,0,"UNIVERSITY OF NEW HAVEN",NA,NA,370,141,229,95,51,44,0.312,0.257,0.223,13800,236
"1338",129941,1999,1,0,"UNIVERSITY OF NEW HAVEN",NA,NA,322,117,205,66,32,34,0.291,0.205,0.156,14250,194
"1339",129941,2000,1,0,"UNIVERSITY OF NEW HAVEN",NA,NA,457,195,262,101,48,53,0.272,0.221,0.183,15210,242
"1340",129941,2001,1,0,"UNIVERSITY OF NEW HAVEN",NA,NA,503,202,301,123,54,69,0.342,0.245,0.179,16200,283
"1341",129941,2002,1,0,"UNIVERSITY OF NEW HAVEN",NA,NA,529,240,289,166,67,99,0.413,0.314,0.232,18800,374
"1342",129941,2003,1,0,"UNIVERSITY OF NEW HAVEN",NA,NA,618,301,317,223,85,138,0.458,0.361,0.268,20150,467
"1343",129941,2004,1,0,"UNIVERSITY OF NEW HAVEN",NA,NA,571,264,307,197,111,86,0.326,0.345,0.362,21120,437
"1344",129941,2005,1,0,"University of New Haven",NA,NA,653,322,331,256,117,139,0.432,0.392,0.353,22380,503
"1345",129941,2006,1,0,"University of New Haven",NA,NA,690,325,365,305,157,148,0.455,0.442,0.43,24000,513
"1346",129941,2007,1,0,"University of New Haven",NA,NA,700,331,369,296,138,158,0.477,0.423,0.374,25380,498
"1347",129941,2008,1,0,"University of New Haven",NA,NA,1129,569,560,430,175,255,0.448,0.381,0.312,27000,686
"1348",129941,2009,1,0,"University of New Haven",NA,NA,1252,639,613,553,247,306,0.479,0.442,0.403,28250,486
"1349",129941,2010,1,0,"University of New Haven",NA,NA,1005,534,471,452,198,254,0.476,0.45,0.42,29500,189
"1350",130253,1991,1,0,"SACRED HEART UNIVERSITY",NA,NA,485,196,289,93,41,52,0.265,0.192,0.142,8970,356
"1351",130253,1992,1,0,"SACRED HEART UNIVERSITY",NA,NA,491,240,251,114,52,62,0.258,0.232,0.207,9740,375
"1352",130253,1993,1,0,"SACRED HEART UNIVERSITY",NA,NA,515,274,241,197,72,125,0.456,0.383,0.299,10550,400
"1353",130253,1995,1,0,"SACRED HEART UNIVERSITY",NA,NA,639,357,282,269,107,162,0.454,0.421,0.379,12100,550
"1354",130253,1996,1,0,"SACRED HEART UNIVERSITY",NA,NA,602,361,241,281,81,200,0.554,0.467,0.336,12714,534
"1355",130253,1997,1,0,"SACRED HEART UNIVERSITY",NA,NA,632,377,255,297,113,184,0.488,0.47,0.443,13435,546
"1356",130253,1998,1,0,"SACRED HEART UNIVERSITY",NA,NA,702,409,293,308,112,196,0.479,0.439,0.382,13972,618
"1357",130253,1999,1,0,"SACRED HEART UNIVERSITY",NA,NA,718,416,302,401,141,260,0.625,0.558,0.467,14670,621
"1358",130253,2000,1,0,"SACRED HEART UNIVERSITY",NA,NA,834,498,336,477,168,309,0.62,0.572,0.5,15404,749
"1359",130253,2001,1,0,"SACRED HEART UNIVERSITY",NA,NA,766,465,301,457,172,285,0.613,0.597,0.571,16328,696
"1360",130253,2002,1,0,"SACRED HEART UNIVERSITY",NA,NA,797,457,340,445,171,274,0.6,0.558,0.503,19260,752
"1361",130253,2003,1,0,"SACRED HEART UNIVERSITY",NA,NA,816,497,319,462,144,318,0.64,0.566,0.451,20220,734
"1362",130253,2004,1,0,"SACRED HEART UNIVERSITY",NA,NA,876,521,355,528,196,332,0.637,0.603,0.552,21990,786
"1363",130253,2005,1,0,"Sacred Heart University",NA,NA,886,542,344,544,186,358,0.66,0.614,0.541,23750,821
"1364",130253,2006,1,0,"Sacred Heart University",NA,NA,931,603,328,536,172,364,0.604,0.576,0.524,25300,846
"1365",130253,2007,1,0,"Sacred Heart University",NA,NA,956,580,376,606,220,386,0.665,0.634,0.585,26950,850
"1366",130253,2008,1,0,"Sacred Heart University",NA,NA,981,577,404,583,201,382,0.662,0.594,0.498,28790,788
"1367",130253,2009,1,0,"Sacred Heart University",NA,NA,907,542,365,526,180,346,0.638,0.58,0.493,30090,681
"1368",130253,2010,1,0,"Sacred Heart University",NA,NA,974,610,364,529,167,362,0.593,0.543,0.459,31224,690
"1369",130314,1991,1,0,"SAINT JOSEPH COLLEGE",NA,NA,104,104,0,54,0,54,0.519,0.519,NA,10400,79
"1370",130314,1992,1,0,"SAINT JOSEPH COLLEGE",NA,NA,105,105,0,42,0,42,0.4,0.4,NA,11000,89
"1371",130314,1993,1,0,"SAINT JOSEPH COLLEGE",NA,NA,93,93,0,47,0,47,0.505,0.505,NA,11600,78
"1372",130314,1995,1,0,"SAINT JOSEPH COLLEGE",NA,NA,153,152,1,82,0,82,0.54,0.536,0,13020,134
"1373",130314,1996,1,0,"SAINT JOSEPH COLLEGE",NA,NA,164,164,0,66,0,66,0.402,0.402,NA,13800,125
"1374",130314,1997,1,0,"SAINT JOSEPH COLLEGE",NA,NA,174,174,0,87,0,87,0.5,0.5,NA,14490,131
"1375",130314,1998,1,0,"SAINT JOSEPH COLLEGE",NA,NA,142,142,0,66,0,66,0.465,0.465,NA,15070,117
"1376",130314,1999,1,0,"SAINT JOSEPH COLLEGE",NA,NA,144,144,0,61,0,61,0.424,0.424,NA,15900,101
"1377",130314,2000,1,0,"SAINT JOSEPH COLLEGE",NA,NA,187,187,0,86,0,86,0.46,0.46,NA,16930,137
"1378",130314,2001,1,0,"SAINT JOSEPH COLLEGE",NA,NA,165,165,0,75,0,75,0.454,0.455,NA,17869,95
"1379",130314,2002,1,0,"SAINT JOSEPH COLLEGE",NA,NA,201,201,0,69,0,69,0.343,0.343,NA,19110,124
"1380",130314,2003,1,0,"SAINT JOSEPH COLLEGE",NA,NA,190,190,0,59,0,59,0.31,0.311,NA,20350,127
"1381",130314,2004,1,0,"SAINT JOSEPH COLLEGE",NA,NA,189,189,0,56,0,56,0.296,0.296,NA,21370,116
"1382",130314,2005,1,0,"Saint Joseph College",NA,NA,206,206,0,88,0,88,0.427,0.427,NA,22225,149
"1383",130314,2006,1,0,"Saint Joseph College",NA,NA,133,133,0,50,0,50,0.376,0.376,NA,22890,96
"1384",130314,2007,1,0,"Saint Joseph College",NA,NA,165,165,0,61,0,61,0.37,0.37,NA,24040,34
"1385",130314,2008,1,0,"Saint Joseph College",NA,NA,225,225,0,92,0,92,0.409,0.409,NA,25240,134
"1386",130314,2009,1,0,"Saint Joseph College",NA,NA,184,184,0,82,0,82,0.446,0.446,NA,26502,112
"1387",130314,2010,1,0,"Saint Joseph College",NA,NA,229,229,0,137,0,137,0.598,0.598,NA,27580,141
"1388",130493,1991,1,0,"SOUTHERN CONNECTICUT STATE UNIVERSITY",NA,NA,1002,539,463,188,49,139,0.258,0.188,0.106,2199,806
"1389",130493,1992,1,0,"SOUTHERN CONNECTICUT STATE UNIVERSITY",NA,NA,933,493,440,134,35,99,0.201,0.144,0.08,2646,754
"1390",130493,1993,1,0,"SOUTHERN CONNECTICUT STATE UNIVERSITY",NA,NA,1044,572,472,139,38,101,0.177,0.133,0.081,2838,868
"1391",130493,1995,1,0,"SOUTHERN CONNECTICUT STATE UNIVERSITY",NA,NA,917,526,391,121,36,85,0.162,0.132,0.092,3128,665
"1392",130493,1996,1,0,"SOUTHERN CONNECTICUT STATE UNIVERSITY",NA,NA,1009,587,422,137,39,98,0.167,0.136,0.092,3474,720
"1393",130493,1997,1,0,"SOUTHERN CONNECTICUT STATE UNIVERSITY",NA,NA,1089,624,465,146,39,107,0.171,0.134,0.084,3568,789
"1394",130493,1998,1,0,"SOUTHERN CONNECTICUT STATE UNIVERSITY",NA,NA,1077,647,430,140,24,116,0.179,0.13,0.056,3716,808
"1395",130493,1999,1,0,"SOUTHERN CONNECTICUT STATE UNIVERSITY",NA,NA,1238,702,536,148,50,98,0.14,0.12,0.093,2124,877
"1396",130493,2000,1,0,"SOUTHERN CONNECTICUT STATE UNIVERSITY",NA,NA,1350,775,575,142,38,104,0.134,0.105,0.066,2142,945
"1397",130493,2001,1,0,"SOUTHERN CONNECTICUT STATE UNIVERSITY",NA,NA,1429,858,571,134,37,97,0.113,0.094,0.065,2226,1015
"1398",130493,2002,1,0,"SOUTHERN CONNECTICUT STATE UNIVERSITY",NA,NA,1276,719,557,144,46,98,0.136,0.113,0.083,2314,895
"1399",130493,2003,1,0,"SOUTHERN CONNECTICUT STATE UNIVERSITY",NA,NA,1310,802,508,7,2,5,0.006,0.005,0.004,2648,944
"1400",130493,2004,1,0,"SOUTHERN CONNECTICUT STATE UNIVERSITY",NA,NA,1396,899,497,219,46,173,0.192,0.157,0.093,3010,1035
"1401",130493,2005,1,0,"Southern Connecticut State University",NA,NA,1313,866,447,192,43,149,0.172,0.146,0.096,3034,958
"1402",130493,2006,1,0,"Southern Connecticut State University",NA,NA,1516,987,529,262,54,208,0.211,0.173,0.102,3187,1069
"1403",130493,2007,1,0,"Southern Connecticut State University",NA,NA,1333,884,449,239,56,183,0.207,0.179,0.125,3346,951
"1404",130493,2008,1,0,"Southern Connecticut State University",NA,NA,1288,858,430,293,77,216,0.252,0.227,0.179,3514,928
"1405",130493,2009,1,0,"Southern Connecticut State University",NA,NA,1237,792,445,280,65,215,0.272,0.226,0.146,3742,909
"1406",130493,2010,1,0,"Southern Connecticut State University",NA,NA,1248,792,456,299,58,241,0.304,0.24,0.127,4023,862
"1407",130590,1991,1,0,"TRINITY COLLEGE",NA,NA,481,226,255,387,192,195,0.863,0.805,0.753,16740,401
"1408",130590,1992,1,0,"TRINITY COLLEGE",NA,NA,472,240,232,352,161,191,0.796,0.746,0.694,17620,385
"1409",130590,1993,1,0,"TRINITY COLLEGE",NA,NA,476,242,234,362,173,189,0.781,0.761,0.739,17950,398
"1410",130590,1995,1,0,"TRINITY COLLEGE",NA,NA,507,246,261,388,174,214,0.87,0.765,0.667,19690,411
"1411",130590,1996,1,0,"TRINITY COLLEGE",NA,NA,504,238,266,387,195,192,0.807,0.768,0.733,21410,405
"1412",130590,1997,1,0,"TRINITY COLLEGE",NA,NA,500,220,280,386,205,181,0.823,0.772,0.732,22470,377
"1413",130590,1998,1,0,"TRINITY COLLEGE",NA,NA,509,263,246,390,176,214,0.814,0.766,0.715,23570,362
"1414",130590,1999,1,0,"TRINITY COLLEGE",NA,NA,565,286,279,442,206,236,0.825,0.782,0.738,23730,389
"1415",130590,2000,1,0,"TRINITY COLLEGE",NA,NA,489,253,236,389,181,208,0.822,0.796,0.767,24660,349
"1416",130590,2001,1,0,"TRINITY COLLEGE",NA,NA,491,239,252,388,184,204,0.854,0.79,0.73,25880,344
"1417",130590,2002,1,0,"TRINITY COLLEGE",NA,NA,548,286,262,445,207,238,0.832,0.812,0.79,27170,349
"1418",130590,2003,1,0,"TRINITY COLLEGE",NA,NA,548,257,291,421,212,209,0.813,0.768,0.729,28740,335
"1419",130590,2004,1,0,"TRINITY COLLEGE",NA,NA,569,283,286,442,213,229,0.809,0.777,0.745,30380,302
"1420",130590,2005,1,0,"Trinity College",NA,NA,573,289,284,469,221,248,0.858,0.818,0.778,32000,358
"1421",130590,2006,1,0,"Trinity College",NA,NA,608,294,314,466,229,237,0.806,0.766,0.729,33440,397
"1422",130590,2007,1,0,"Trinity College",NA,NA,576,292,284,469,224,245,0.839,0.814,0.789,35110,382
"1423",130590,2008,1,0,"Trinity College",NA,NA,589,300,289,464,214,250,0.833,0.788,0.74,36864,355
"1424",130590,2009,1,0,"Trinity College",NA,NA,573,272,301,464,232,232,0.853,0.81,0.771,38900,398
"1425",130590,2010,1,0,"Trinity College",NA,NA,591,300,291,473,223,250,0.833,0.8,0.766,40410,387
"1426",130697,1991,1,0,"WESLEYAN UNIVERSITY",NA,NA,663,347,316,501,223,278,0.801,0.756,0.706,16250,435
"1427",130697,1992,1,0,"WESLEYAN UNIVERSITY",NA,NA,704,361,343,553,263,290,0.803,0.786,0.767,17190,449
"1428",130697,1993,1,0,"WESLEYAN UNIVERSITY",NA,NA,703,365,338,547,257,290,0.795,0.778,0.76,18150,474
"1429",130697,1995,1,0,"WESLEYAN UNIVERSITY",NA,NA,710,356,354,584,288,296,0.832,0.823,0.814,20820,484
"1430",130697,1996,1,0,"WESLEYAN UNIVERSITY",NA,NA,738,374,364,633,311,322,0.861,0.858,0.854,21910,503
"1431",130697,1997,1,0,"WESLEYAN UNIVERSITY",NA,NA,700,371,329,583,263,320,0.863,0.833,0.799,22980,463
"1432",130697,1998,1,0,"WESLEYAN UNIVERSITY",NA,NA,716,382,334,593,264,329,0.861,0.828,0.79,24050,463
"1433",130697,1999,1,0,"WESLEYAN UNIVERSITY",NA,NA,732,375,357,609,283,326,0.869,0.832,0.793,24330,499
"1434",130697,2000,1,0,"WESLEYAN UNIVERSITY",NA,NA,720,371,349,607,281,326,0.879,0.843,0.805,25380,447
"1435",130697,2001,1,0,"WESLEYAN UNIVERSITY",NA,NA,722,372,350,606,280,326,0.876,0.839,0.8,26290,465
"1436",130697,2002,1,0,"WESLEYAN UNIVERSITY",NA,NA,716,377,339,634,288,346,0.918,0.885,0.85,27474,444
"1437",130697,2003,1,0,"WESLEYAN UNIVERSITY",NA,NA,713,376,337,631,291,340,0.904,0.885,0.864,29784,431
"1438",130697,2004,1,0,"WESLEYAN UNIVERSITY",NA,NA,728,385,343,649,300,349,0.907,0.891,0.875,31436,428
"1439",130697,2005,1,0,"Wesleyan University",NA,NA,705,360,345,614,305,309,0.858,0.871,0.884,32976,422
"1440",130697,2006,1,0,"Wesleyan University",NA,NA,716,352,364,624,316,308,0.875,0.872,0.868,34630,448
"1441",130697,2007,1,0,"Wesleyan University",NA,NA,733,377,356,632,305,327,0.867,0.862,0.857,36536,451
"1442",130697,2008,1,0,"Wesleyan University",NA,NA,715,355,360,622,300,322,0.907,0.87,0.833,38364,366
"1443",130697,2009,1,0,"Wesleyan University",NA,NA,744,389,355,681,322,359,0.923,0.915,0.907,39822,380
"1444",130697,2010,1,0,"Wesleyan University",NA,NA,748,411,337,652,292,360,0.876,0.872,0.866,41814,446
"1445",130776,1991,1,0,"WESTERN CONNECTICUT STATE UNIVERSITY",NA,NA,349,187,162,96,32,64,0.342,0.275,0.198,2361,288
"1446",130776,1992,1,0,"WESTERN CONNECTICUT STATE UNIVERSITY",NA,NA,372,161,211,88,47,41,0.255,0.237,0.223,2910,275
"1447",130776,1993,1,0,"WESTERN CONNECTICUT STATE UNIVERSITY",NA,NA,526,247,279,115,50,65,0.263,0.219,0.179,2900,417
"1448",130776,1995,1,0,"WESTERN CONNECTICUT STATE UNIVERSITY",NA,NA,460,237,223,79,35,44,0.186,0.172,0.157,3168,336
"1449",130776,1996,1,0,"WESTERN CONNECTICUT STATE UNIVERSITY",NA,NA,496,242,254,60,32,28,0.116,0.121,0.126,3528,383
"1450",130776,1997,1,0,"WESTERN CONNECTICUT STATE UNIVERSITY",NA,NA,668,303,365,90,35,55,0.182,0.135,0.096,3626,495
"1451",130776,1998,1,0,"WESTERN CONNECTICUT STATE UNIVERSITY",NA,NA,655,315,340,91,33,58,0.184,0.139,0.097,3626,479
"1452",130776,1999,1,0,"WESTERN CONNECTICUT STATE UNIVERSITY",NA,NA,697,359,338,70,22,48,0.134,0.1,0.065,2062,525
"1453",130776,2000,1,0,"WESTERN CONNECTICUT STATE UNIVERSITY",NA,NA,822,404,418,104,42,62,0.154,0.127,0.1,2142,591
"1454",130776,2001,1,0,"WESTERN CONNECTICUT STATE UNIVERSITY",NA,NA,841,439,402,111,36,75,0.171,0.132,0.09,2226,617
"1455",130776,2002,1,0,"WESTERN CONNECTICUT STATE UNIVERSITY",NA,NA,794,434,360,113,32,81,0.187,0.142,0.089,2314,582
"1456",130776,2003,1,0,"WESTERN CONNECTICUT STATE UNIVERSITY",NA,NA,808,444,364,105,40,65,0.146,0.13,0.11,2648,630
"1457",130776,2004,1,0,"WESTERN CONNECTICUT STATE UNIVERSITY",NA,NA,755,382,373,120,53,67,0.175,0.159,0.142,3010,624
"1458",130776,2005,1,0,"Western Connecticut State University",NA,NA,773,396,377,124,52,72,0.182,0.16,0.138,3034,617
"1459",130776,2006,1,0,"Western Connecticut State University",NA,NA,843,413,430,167,64,103,0.249,0.198,0.149,3187,655
"1460",130776,2007,1,0,"Western Connecticut State University",NA,NA,913,494,419,190,77,113,0.229,0.208,0.184,3346,701
"1461",130776,2008,1,0,"Western Connecticut State University",NA,NA,928,462,466,180,82,98,0.212,0.194,0.176,3514,700
"1462",130776,2009,1,0,"Western Connecticut State University",NA,NA,1008,549,459,255,99,156,0.284,0.253,0.216,3742,761
"1463",130776,2010,1,0,"Western Connecticut State University",NA,NA,975,524,451,209,85,124,0.237,0.214,0.188,4023,653
"1464",130794,1991,1,0,"YALE UNIVERSITY",NA,NA,1290,592,698,1127,608,519,0.877,0.874,0.871,16300,800
"1465",130794,1992,1,0,"YALE UNIVERSITY",NA,NA,1326,640,686,1139,561,578,0.903,0.859,0.818,17500,805
"1466",130794,1993,1,0,"YALE UNIVERSITY",NA,NA,1317,627,690,1135,582,553,0.882,0.862,0.843,18630,696
"1467",130794,1995,1,0,"YALE UNIVERSITY",NA,NA,1360,692,668,1198,575,623,0.9,0.881,0.861,21000,773
"1468",130794,1996,1,0,"YALE UNIVERSITY",NA,NA,1403,688,715,1235,611,624,0.907,0.88,0.855,22200,767
"1469",130794,1997,1,0,"YALE UNIVERSITY",NA,NA,1307,662,645,1170,552,618,0.933,0.895,0.856,23100,701
"1470",130794,1998,1,0,"YALE UNIVERSITY",NA,NA,1295,646,649,1146,573,573,0.887,0.885,0.883,23780,656
"1471",130794,1999,1,0,"YALE UNIVERSITY",NA,NA,1358,682,676,1219,594,625,0.916,0.898,0.879,24500,736
"1472",130794,2000,1,0,"YALE UNIVERSITY",NA,NA,1349,678,671,1189,582,607,0.895,0.881,0.867,25220,693
"1473",130794,2001,1,0,"YALE UNIVERSITY",NA,NA,1293,648,645,1125,538,587,0.906,0.87,0.834,26100,645
"1474",130794,2002,1,0,"YALE UNIVERSITY",NA,NA,1299,643,656,1164,576,588,0.915,0.896,0.878,27130,661
"1475",130794,2003,1,0,"YALE UNIVERSITY",NA,NA,1350,680,670,1221,582,639,0.94,0.904,0.869,28400,695
"1476",130794,2004,1,0,"YALE UNIVERSITY",NA,NA,1306,632,674,1161,589,572,0.905,0.889,0.874,29820,650
"1477",130794,2005,1,0,"Yale University",NA,NA,1320,651,669,1172,574,598,0.919,0.888,0.858,31460,624
"1478",130794,2006,1,0,"Yale University",NA,NA,1313,654,659,1169,578,591,0.904,0.89,0.877,33030,628
"1479",130794,2007,1,0,"Yale University",NA,NA,1313,661,652,1177,578,599,0.906,0.896,0.887,34530,697
"1480",130794,2008,1,0,"Yale University",NA,NA,1316,664,652,1150,543,607,0.914,0.874,0.833,35300,638
"1481",130794,2009,1,0,"Yale University",NA,NA,1305,651,654,1145,553,592,0.909,0.877,0.846,36500,667
"1482",130794,2010,1,0,"Yale University",NA,NA,1343,696,647,1161,547,614,0.882,0.864,0.845,38300,665
"1483",130934,1991,1,0,"DELAWARE STATE COLLEGE",NA,NA,585,330,255,53,12,41,0.124,0.091,0.047,1546,103
"1484",130934,1992,1,0,"DELAWARE STATE COLLEGE",NA,NA,579,305,274,47,22,25,0.082,0.081,0.08,1788,107
"1485",130934,1993,1,0,"DELAWARE STATE UNIVERSITY",NA,NA,686,386,300,68,11,57,0.148,0.099,0.037,1966,103
"1486",130934,1995,1,0,"DELAWARE STATE UNIVERSITY",NA,NA,563,333,230,76,27,49,0.147,0.135,0.117,2250,53
"1487",130934,1996,1,0,"DELAWARE STATE UNIVERSITY",NA,NA,544,305,239,87,21,66,0.216,0.16,0.088,2636,63
"1488",130934,1997,1,0,"DELAWARE STATE UNIVERSITY",NA,NA,637,359,278,121,35,86,0.24,0.19,0.126,2810,60
"1489",130934,1998,1,0,"DELAWARE STATE UNIVERSITY",NA,NA,578,339,239,118,39,79,0.233,0.204,0.163,2974,48
"1490",130934,1999,1,0,"DELAWARE STATE UNIVERSITY",NA,NA,632,375,257,132,37,95,0.253,0.209,0.144,3096,67
"1491",130934,2000,1,0,"DELAWARE STATE UNIVERSITY",NA,NA,684,405,279,155,36,119,0.294,0.227,0.129,3290,70
"1492",130934,2001,1,0,"DELAWARE STATE UNIVERSITY",NA,NA,686,385,301,107,30,77,0.2,0.156,0.1,3422,55
"1493",130934,2002,1,0,"DELAWARE STATE UNIVERSITY",NA,NA,761,439,322,1,0,1,0.002,0.001,0,3956,64
"1494",130934,2003,1,0,"DELAWARE STATE UNIVERSITY",NA,NA,597,355,242,89,13,76,0.214,0.149,0.054,3996,53
"1495",130934,2004,1,0,"DELAWARE STATE UNIVERSITY",NA,NA,687,400,287,133,23,110,0.275,0.194,0.08,4646,62
"1496",130934,2005,1,0,"Delaware State University",NA,NA,885,514,371,164,40,124,0.241,0.185,0.108,5480,53
"1497",130934,2006,1,0,"Delaware State University",NA,NA,818,463,355,126,37,89,0.192,0.154,0.104,5366,66
"1498",130934,2007,1,0,"Delaware State University",NA,NA,799,495,304,145,37,108,0.218,0.181,0.122,5366,58
"1499",130934,2008,1,0,"Delaware State University",NA,NA,721,455,266,154,36,118,0.259,0.214,0.135,5701,44
"1500",130934,2009,1,0,"Delaware State University",NA,NA,739,463,276,165,42,123,0.266,0.223,0.152,5701,57
"1501",130934,2010,1,0,"Delaware State University",NA,NA,887,556,331,220,58,162,0.291,0.248,0.175,5901,57
"1502",130943,1991,1,0,"UNIVERSITY OF DELAWARE",NA,NA,3170,1871,1299,1592,524,1068,0.571,0.502,0.403,3520,2948
"1503",130943,1992,1,0,"UNIVERSITY OF DELAWARE",NA,NA,2944,1729,1215,1593,590,1003,0.58,0.541,0.486,3722,2695
"1504",130943,1993,1,0,"UNIVERSITY OF DELAWARE",NA,NA,3181,1847,1334,1623,573,1050,0.569,0.51,0.43,3948,2892
"1505",130943,1995,1,0,"UNIVERSITY OF DELAWARE",NA,NA,3155,1883,1272,1719,621,1098,0.583,0.545,0.488,4286,2784
"1506",130943,1996,1,0,"UNIVERSITY OF DELAWARE",NA,NA,3290,1980,1310,1823,623,1200,0.606,0.554,0.476,4430,2881
"1507",130943,1997,1,0,"UNIVERSITY OF DELAWARE",NA,NA,3179,1881,1298,1823,622,1201,0.639,0.573,0.479,4574,2781
"1508",130943,1998,1,0,"UNIVERSITY OF DELAWARE",NA,NA,3545,2149,1396,2078,696,1382,0.643,0.586,0.499,4716,3145
"1509",130943,1999,1,0,"UNIVERSITY OF DELAWARE",NA,NA,3513,2146,1367,2193,764,1429,0.666,0.624,0.559,4380,3123
"1510",130943,2000,1,0,"UNIVERSITY OF DELAWARE",NA,NA,3128,1926,1202,1884,620,1264,0.656,0.602,0.516,4510,2722
"1511",130943,2001,1,0,"UNIVERSITY OF DELAWARE",NA,NA,3362,1944,1418,2147,767,1380,0.71,0.639,0.541,4770,2939
"1512",130943,2002,1,0,"UNIVERSITY OF DELAWARE",NA,NA,3712,2222,1490,2282,777,1505,0.677,0.615,0.521,5070,3256
"1513",130943,2003,1,0,"UNIVERSITY OF DELAWARE",NA,NA,3794,2157,1637,2016,761,1255,0.582,0.531,0.465,5890,3154
"1514",130943,2004,1,0,"UNIVERSITY OF DELAWARE",NA,NA,3769,2173,1596,2131,776,1355,0.624,0.565,0.486,6304,3170
"1515",130943,2005,1,0,"University of Delaware",NA,NA,3830,2252,1578,2250,803,1447,0.642,0.587,0.509,6614,3183
"1516",130943,2006,1,0,"University of Delaware",NA,NA,3563,2127,1436,2175,777,1398,0.657,0.61,0.541,6980,2907
"1517",130943,2007,1,0,"University of Delaware",NA,NA,3912,2305,1607,2445,879,1566,0.679,0.625,0.547,7340,3046
"1518",130943,2008,1,0,"University of Delaware",NA,NA,3834,2211,1623,2378,891,1487,0.672,0.62,0.549,7780,3028
"1519",130943,2009,1,0,"University of Delaware",NA,NA,4211,2424,1787,2486,929,1557,0.642,0.59,0.52,8540,3261
"1520",130943,2010,1,0,"University of Delaware",NA,NA,3719,2116,1603,2399,913,1486,0.702,0.645,0.57,9040,2863
"1521",131159,1991,1,0,"AMERICAN UNIVERSITY",NA,NA,1027,633,394,622,223,399,0.63,0.606,0.566,13716,794
"1522",131159,1992,1,0,"AMERICAN UNIVERSITY",NA,NA,1025,629,396,629,235,394,0.626,0.614,0.593,14594,786
"1523",131159,1993,1,0,"AMERICAN UNIVERSITY",NA,NA,1039,660,379,641,219,422,0.639,0.617,0.578,15386,805
"1524",131159,1995,1,0,"AMERICAN UNIVERSITY",NA,NA,1221,794,427,789,288,501,0.631,0.646,0.674,17115,964
"1525",131159,1996,1,0,"AMERICAN UNIVERSITY",NA,NA,1107,703,404,643,224,419,0.596,0.581,0.554,17744,799
"1526",131159,1997,1,0,"AMERICAN UNIVERSITY",NA,NA,1056,665,391,678,239,439,0.66,0.642,0.611,18555,781
"1527",131159,1998,1,0,"AMERICAN UNIVERSITY",NA,NA,1232,774,458,802,262,540,0.698,0.651,0.572,19433,919
"1528",131159,1999,1,0,"AMERICAN UNIVERSITY",NA,NA,1146,744,402,723,231,492,0.661,0.631,0.575,20118,706
"1529",131159,2000,1,0,"AMERICAN UNIVERSITY",NA,NA,1272,821,451,818,260,558,0.68,0.643,0.576,21144,813
"1530",131159,2001,1,0,"AMERICAN UNIVERSITY",NA,NA,1387,875,512,924,330,594,0.679,0.666,0.645,22116,925
"1531",131159,2002,1,0,"AMERICAN UNIVERSITY",NA,NA,1303,811,492,917,329,588,0.725,0.704,0.669,23068,910
"1532",131159,2003,1,0,"AMERICAN UNIVERSITY",NA,NA,1238,832,406,882,286,596,0.716,0.712,0.704,24452,835
"1533",131159,2004,1,0,"AMERICAN UNIVERSITY",NA,NA,1210,776,434,902,306,596,0.768,0.745,0.705,25920,811
"1534",131159,2005,1,0,"American University",NA,NA,1216,778,438,898,319,579,0.744,0.738,0.728,27552,820
"1535",131159,2006,1,0,"American University",NA,NA,1385,923,462,1007,321,686,0.743,0.727,0.695,29206,966
"1536",131159,2007,1,0,"American University",NA,NA,1288,840,448,975,334,641,0.763,0.757,0.746,30958,850
"1537",131159,2008,1,0,"American University",NA,NA,1570,967,603,1199,442,757,0.783,0.764,0.733,32816,917
"1538",131159,2009,1,0,"American University",NA,NA,1527,917,610,1164,449,715,0.78,0.762,0.736,34456,914
"1539",131159,2010,1,0,"American University",NA,NA,1498,911,587,1145,438,707,0.776,0.764,0.746,36180,935
"1540",131283,1991,1,0,"CATHOLIC UNIVERSITY OF AMERICA",NA,NA,532,308,224,309,124,185,0.601,0.581,0.554,11936,428
"1541",131283,1992,1,0,"CATHOLIC UNIVERSITY OF AMERICA",NA,NA,471,252,219,272,121,151,0.599,0.577,0.553,12986,380
"1542",131283,1993,1,0,"CATHOLIC UNIVERSITY OF AMERICA",NA,NA,505,276,229,306,130,176,0.638,0.606,0.568,13614,418
"1543",131283,1995,1,0,"CATHOLIC UNIVERSITY OF AMERICA",NA,NA,514,265,249,290,125,165,0.623,0.564,0.502,15062,408
"1544",131283,1996,1,0,"CATHOLIC UNIVERSITY OF AMERICA",NA,NA,452,264,188,261,100,161,0.61,0.577,0.532,16152,362
"1545",131283,1997,1,0,"CATHOLIC UNIVERSITY OF AMERICA",NA,NA,567,313,254,337,148,189,0.604,0.594,0.583,17110,472
"1546",131283,1998,1,0,"CATHOLIC UNIVERSITY OF AMERICA",NA,NA,597,338,259,378,149,229,0.677,0.633,0.575,18066,489
"1547",131283,1999,1,0,"CATHOLIC UNIVERSITY OF AMERICA",NA,NA,762,381,381,457,204,253,0.664,0.6,0.535,18200,641
"1548",131283,2000,1,0,"CATHOLIC UNIVERSITY OF AMERICA",NA,NA,530,298,232,315,126,189,0.634,0.594,0.543,19100,406
"1549",131283,2001,1,0,"CATHOLIC UNIVERSITY OF AMERICA",NA,NA,613,342,271,407,170,237,0.693,0.664,0.627,20050,513
"1550",131283,2002,1,0,"CATHOLIC UNIVERSITY OF AMERICA",NA,NA,700,406,294,438,170,268,0.66,0.626,0.578,21050,550
"1551",131283,2003,1,0,"CATHOLIC UNIVERSITY OF AMERICA",NA,NA,646,362,284,423,167,256,0.707,0.655,0.588,22200,506
"1552",131283,2004,1,0,"CATHOLIC UNIVERSITY OF AMERICA",NA,NA,719,387,332,429,182,247,0.638,0.597,0.548,23600,545
"1553",131283,2005,1,0,"Catholic University of America",NA,NA,786,455,331,482,187,295,0.648,0.613,0.565,24800,569
"1554",131283,2006,1,0,"Catholic University of America",NA,NA,856,459,397,527,219,308,0.671,0.616,0.552,26200,608
"1555",131283,2007,1,0,"Catholic University of America",NA,NA,864,451,413,535,233,302,0.67,0.619,0.564,27700,653
"1556",131283,2008,1,0,"Catholic University of America",NA,NA,901,475,426,537,234,303,0.638,0.596,0.549,30520,605
"1557",131283,2009,1,0,"Catholic University of America",NA,NA,813,456,357,501,184,317,0.695,0.616,0.515,31740,542
"1558",131283,2010,1,0,"Catholic University of America",NA,NA,991,576,415,613,240,373,0.648,0.619,0.578,33580,666
"1559",131450,1991,1,0,"GALLAUDET UNIVERSITY",NA,NA,227,129,98,15,2,13,0.101,0.066,0.02,3854,149
"1560",131450,1992,1,0,"GALLAUDET UNIVERSITY",NA,NA,339,177,162,15,6,9,0.051,0.044,0.037,4194,210
"1561",131450,1993,1,0,"GALLAUDET UNIVERSITY",NA,NA,306,164,142,18,6,12,0.073,0.059,0.042,4570,190
"1562",131450,1995,1,0,"GALLAUDET UNIVERSITY",NA,NA,225,120,105,10,2,8,0.067,0.044,0.019,6140,137
"1563",131450,1996,1,0,"GALLAUDET UNIVERSITY",NA,NA,186,105,81,13,6,7,0.067,0.07,0.074,6650,113
"1564",131450,1997,1,0,"GALLAUDET UNIVERSITY",NA,NA,211,116,95,10,3,7,0.06,0.047,0.032,7043,134
"1565",131450,1998,1,0,"GALLAUDET UNIVERSITY",NA,NA,230,112,118,17,7,10,0.089,0.074,0.059,7464,125
"1566",131450,1999,1,0,"GALLAUDET UNIVERSITY",NA,NA,254,135,119,14,6,8,0.059,0.055,0.05,6870,168
"1567",131450,2000,1,0,"GALLAUDET UNIVERSITY",NA,NA,241,123,118,16,3,13,0.106,0.066,0.025,7350,142
"1568",131450,2001,1,0,"GALLAUDET UNIVERSITY",NA,NA,213,113,100,10,3,7,0.062,0.047,0.03,7870,126
"1569",131450,2002,1,0,"GALLAUDET UNIVERSITY",NA,NA,235,122,113,12,6,6,0.049,0.051,0.053,8420,143
"1570",131450,2003,1,0,"GALLAUDET UNIVERSITY",NA,NA,236,124,112,25,8,17,0.137,0.106,0.071,9000,144
"1571",131450,2004,1,0,"GALLAUDET UNIVERSITY",NA,NA,227,121,106,18,8,10,0.083,0.079,0.075,9630,128
"1572",131450,2005,1,0,"Gallaudet University",NA,NA,280,151,129,28,7,21,0.139,0.1,0.054,9920,176
"1573",131450,2006,1,0,"Gallaudet University",NA,NA,209,96,113,15,5,10,0.104,0.072,0.044,10220,146
"1574",131450,2007,1,0,"Gallaudet University",NA,NA,174,97,77,27,9,18,0.186,0.155,0.117,10220,123
"1575",131450,2008,1,0,"Gallaudet University",NA,NA,179,97,82,29,9,20,0.206,0.162,0.11,10850,111
"1576",131450,2009,1,0,"Gallaudet University",NA,NA,211,112,99,51,13,38,0.339,0.242,0.131,10850,141
"1577",131450,2010,1,0,"Gallaudet University",NA,NA,198,107,91,39,10,29,0.271,0.197,0.11,10850,120
"1578",131469,1991,1,0,"GEORGE WASHINGTON UNIVERSITY",NA,NA,1151,622,529,686,282,404,0.65,0.596,0.533,14902,802
"1579",131469,1992,1,0,"GEORGE WASHINGTON UNIVERSITY",NA,NA,1193,642,551,695,291,404,0.629,0.583,0.528,16080,765
"1580",131469,1993,1,0,"GEORGE WASHINGTON UNIVERSITY",NA,NA,1492,801,691,887,373,514,0.642,0.595,0.54,16988,983
"1581",131469,1995,1,0,"GEORGE WASHINGTON UNIVERSITY",NA,NA,1367,803,564,905,346,559,0.696,0.662,0.613,19032,917
"1582",131469,1996,1,0,"GEORGE WASHINGTON UNIVERSITY",NA,NA,1643,973,670,1082,427,655,0.673,0.659,0.637,19980,1081
"1583",131469,1997,1,0,"GEORGE WASHINGTON UNIVERSITY",NA,NA,1716,972,744,1185,485,700,0.72,0.691,0.652,21360,1102
"1584",131469,1998,1,0,"GEORGE WASHINGTON UNIVERSITY",NA,NA,1773,1057,716,1285,471,814,0.77,0.725,0.658,22625,1182
"1585",131469,1999,1,0,"GEORGE WASHINGTON UNIVERSITY",NA,NA,2109,1282,827,1515,556,959,0.748,0.718,0.672,22925,1427
"1586",131469,2000,1,0,"GEORGE WASHINGTON UNIVERSITY",NA,NA,2093,1241,852,1504,574,930,0.749,0.719,0.674,24005,1426
"1587",131469,2001,1,0,"GEORGE WASHINGTON UNIVERSITY",NA,NA,2566,1433,1133,1864,761,1103,0.77,0.726,0.672,24880,1696
"1588",131469,2002,1,0,"GEORGE WASHINGTON UNIVERSITY",NA,NA,2283,1359,924,1735,660,1075,0.791,0.76,0.714,27790,1518
"1589",131469,2003,1,0,"GEORGE WASHINGTON UNIVERSITY",NA,NA,2260,1333,927,1726,683,1043,0.782,0.764,0.737,29320,1550
"1590",131469,2004,1,0,"GEORGE WASHINGTON UNIVERSITY",NA,NA,2623,1441,1182,1957,830,1127,0.782,0.746,0.702,34000,1763
"1591",131469,2005,1,0,"George Washington University",NA,NA,2408,1375,1033,1823,732,1091,0.793,0.757,0.709,33992,1562
"1592",131469,2006,1,0,"George Washington University",NA,NA,2440,1348,1092,1804,756,1048,0.777,0.739,0.692,35604,1544
"1593",131469,2007,1,0,"George Washington University",NA,NA,2123,1198,925,1604,668,936,0.781,0.756,0.722,37000,1275
"1594",131469,2008,1,0,"George Washington University",NA,NA,2449,1408,1041,1755,687,1068,0.758,0.717,0.66,38630,1224
"1595",131469,2009,1,0,"George Washington University",NA,NA,2582,1435,1147,1940,825,1115,0.777,0.751,0.719,39962,1437
"1596",131469,2010,1,0,"George Washington University",NA,NA,2376,1316,1060,1805,761,1044,0.793,0.76,0.718,41182,1535
"1597",131496,1991,1,0,"GEORGETOWN UNIVERSITY",NA,NA,1369,710,659,1133,547,586,0.825,0.828,0.83,15652,964
"1598",131496,1992,1,0,"GEORGETOWN UNIVERSITY",NA,NA,1383,733,650,1179,550,629,0.858,0.852,0.846,16589,945
"1599",131496,1993,1,0,"GEORGETOWN UNIVERSITY",NA,NA,1377,720,657,1155,551,604,0.839,0.839,0.839,17586,940
"1600",131496,1995,1,0,"GEORGETOWN UNIVERSITY",NA,NA,1403,742,661,1207,568,639,0.861,0.86,0.859,19402,973
"1601",131496,1996,1,0,"GEORGETOWN UNIVERSITY",NA,NA,1408,760,648,1256,569,687,0.904,0.892,0.878,20388,1020
"1602",131496,1997,1,0,"GEORGETOWN UNIVERSITY",NA,NA,1394,757,637,1247,561,686,0.906,0.895,0.881,21405,978
"1603",131496,1998,1,0,"GEORGETOWN UNIVERSITY",NA,NA,1470,810,660,1302,581,721,0.89,0.886,0.88,22446,1036
"1604",131496,1999,1,0,"GEORGETOWN UNIVERSITY",NA,NA,1474,802,672,1299,587,712,0.888,0.881,0.874,23088,1028
"1605",131496,2000,1,0,"GEORGETOWN UNIVERSITY",NA,NA,1469,789,680,1327,603,724,0.918,0.903,0.887,23952,1064
"1606",131496,2001,1,0,"GEORGETOWN UNIVERSITY",NA,NA,1482,757,725,1339,648,691,0.913,0.904,0.894,25152,1066
"1607",131496,2002,1,0,"GEORGETOWN UNIVERSITY",NA,NA,1477,795,682,1324,608,716,0.901,0.896,0.891,26544,1042
"1608",131496,2003,1,0,"GEORGETOWN UNIVERSITY",NA,NA,1504,827,677,1321,575,746,0.902,0.878,0.849,27864,970
"1609",131496,2004,1,0,"GEORGETOWN UNIVERSITY",NA,NA,1523,855,668,1358,574,784,0.917,0.892,0.859,29808,1055
"1610",131496,2005,1,0,"Georgetown University",NA,NA,1530,774,756,1378,669,709,0.916,0.901,0.885,31656,1007
"1611",131496,2006,1,0,"Georgetown University",NA,NA,1588,877,711,1419,630,789,0.9,0.894,0.886,33552,1047
"1612",131496,2007,1,0,"Georgetown University",NA,NA,1577,864,713,1387,616,771,0.892,0.88,0.864,35568,1083
"1613",131496,2008,1,0,"Georgetown University",NA,NA,1571,822,749,1430,665,765,0.931,0.91,0.888,37536,1099
"1614",131496,2009,1,0,"Georgetown University",NA,NA,1550,861,689,1389,601,788,0.915,0.896,0.872,38616,1027
"1615",131496,2010,1,0,"Georgetown University",NA,NA,1569,859,710,1414,623,791,0.921,0.901,0.877,39768,1016
"1616",131520,1991,1,0,"HOWARD UNIVERSITY",NA,NA,1089,687,402,261,64,197,0.287,0.24,0.159,6438,3
"1617",131520,1992,1,0,"HOWARD UNIVERSITY",NA,NA,1264,797,467,264,70,194,0.243,0.209,0.15,6981,3
"1618",131520,1993,1,0,"HOWARD UNIVERSITY",NA,NA,1492,951,541,352,88,264,0.278,0.236,0.163,7535,0
"1619",131520,1995,1,0,"HOWARD UNIVERSITY",NA,NA,834,540,294,438,117,321,0.594,0.525,0.398,8105,1
"1620",131520,1996,1,0,"HOWARD UNIVERSITY",NA,NA,1002,648,354,463,126,337,0.52,0.462,0.356,8725,1
"1621",131520,1997,1,0,"HOWARD UNIVERSITY",NA,NA,1098,715,383,402,98,304,0.425,0.366,0.256,8985,3
"1622",131520,1998,1,0,"HOWARD UNIVERSITY",NA,NA,1244,831,413,469,103,366,0.44,0.377,0.249,9155,0
"1623",131520,1999,1,0,"HOWARD UNIVERSITY",NA,NA,937,632,305,405,99,306,0.484,0.432,0.325,8925,2
"1624",131520,2000,1,0,"HOWARD UNIVERSITY",NA,NA,1355,909,446,624,145,479,0.527,0.461,0.325,9190,6
"1625",131520,2001,1,0,"HOWARD UNIVERSITY",NA,NA,1344,900,444,680,185,495,0.55,0.506,0.417,9515,0
"1626",131520,2002,1,0,"HOWARD UNIVERSITY",NA,NA,1366,931,435,621,125,496,0.533,0.455,0.287,9515,2
"1627",131520,2003,1,0,"HOWARD UNIVERSITY",NA,NA,1446,992,454,679,155,524,0.528,0.47,0.341,10130,1
"1628",131520,2004,1,0,"HOWARD UNIVERSITY",NA,NA,1445,987,458,691,151,540,0.547,0.478,0.33,10840,2
"1629",131520,2005,1,0,"Howard University",NA,NA,1410,944,466,635,166,469,0.497,0.45,0.356,11490,3
"1630",131520,2006,1,0,"Howard University",NA,NA,1512,1022,490,629,155,474,0.464,0.416,0.316,12180,0
"1631",131520,2007,1,0,"Howard University",NA,NA,1451,1028,423,574,129,445,0.433,0.396,0.305,13215,0
"1632",131520,2008,1,0,"Howard University",NA,NA,1477,1004,473,629,133,496,0.494,0.426,0.281,14205,0
"1633",131520,2009,1,0,"Howard University",NA,NA,1600,1097,503,633,144,489,0.446,0.396,0.286,15270,0
"1634",131520,2010,1,0,"Howard University",NA,NA,1464,1034,430,571,122,449,0.434,0.39,0.284,17100,0
"1635",132471,1991,1,0,"BARRY UNIVERSITY",NA,NA,301,179,122,85,34,51,0.285,0.282,0.279,9793,122
"1636",132471,1992,1,0,"BARRY UNIVERSITY",NA,NA,265,146,119,80,28,52,0.356,0.302,0.235,10180,129
"1637",132471,1993,1,0,"BARRY UNIVERSITY",NA,NA,232,143,89,77,19,58,0.406,0.332,0.213,11030,111
"1638",132471,1995,1,0,"BARRY UNIVERSITY",NA,NA,177,103,74,46,10,36,0.35,0.26,0.135,12110,71
"1639",132471,1996,1,0,"BARRY UNIVERSITY",NA,NA,177,101,76,40,16,24,0.238,0.226,0.211,12790,70
"1640",132471,1997,1,0,"BARRY UNIVERSITY",NA,NA,176,112,64,58,18,40,0.357,0.33,0.281,13460,64
"1641",132471,1998,1,0,"BARRY UNIVERSITY",NA,NA,393,249,144,82,20,62,0.249,0.209,0.139,14790,133
"1642",132471,1999,1,0,"BARRY UNIVERSITY",NA,NA,398,251,147,9,1,8,0.032,0.023,0.007,15530,123
"1643",132471,2000,1,0,"BARRY UNIVERSITY",NA,NA,401,258,143,70,18,52,0.202,0.175,0.126,15530,120
"1644",132471,2001,1,0,"BARRY UNIVERSITY",NA,NA,431,264,167,101,32,69,0.261,0.234,0.192,17500,148
"1645",132471,2002,1,0,"BARRY UNIVERSITY",NA,NA,446,273,173,110,34,76,0.278,0.247,0.197,18900,162
"1646",132471,2003,1,0,"BARRY UNIVERSITY",NA,NA,517,336,181,91,33,58,0.173,0.176,0.182,20320,190
"1647",132471,2004,1,0,"BARRY UNIVERSITY",NA,NA,553,349,204,101,29,72,0.206,0.183,0.142,21350,160
"1648",132471,2005,1,0,"Barry University",NA,NA,563,356,207,117,35,82,0.23,0.208,0.169,22430,209
"1649",132471,2006,1,0,"Barry University",NA,NA,387,255,132,82,24,58,0.228,0.212,0.182,24000,96
"1650",132471,2007,1,0,"Barry University",NA,NA,472,316,156,102,28,74,0.234,0.216,0.179,24500,117
"1651",132471,2008,1,0,"Barry University",NA,NA,584,400,184,120,34,86,0.215,0.205,0.185,25500,111
"1652",132471,2009,1,0,"Barry University",NA,NA,648,433,215,102,25,77,0.178,0.157,0.116,26400,88
"1653",132471,2010,1,0,"Barry University",NA,NA,625,403,222,98,32,66,0.164,0.157,0.144,27200,73
"1654",132602,1991,1,0,"BETHUNE COOKMAN COLLEGE",NA,NA,619,348,271,134,25,109,0.313,0.216,0.092,4835,4
"1655",132602,1992,1,0,"BETHUNE COOKMAN COLLEGE",NA,NA,597,326,271,99,29,70,0.215,0.166,0.107,4965,4
"1656",132602,1993,1,0,"BETHUNE COOKMAN COLLEGE",NA,NA,543,291,252,100,28,72,0.247,0.184,0.111,5165,4
"1657",132602,1995,1,0,"BETHUNE COOKMAN COLLEGE",NA,NA,729,393,336,106,31,75,0.191,0.145,0.092,6458,1
"1658",132602,1996,1,0,"BETHUNE COOKMAN COLLEGE",NA,NA,575,322,253,93,20,73,0.227,0.162,0.079,6780,0
"1659",132602,1997,1,0,"BETHUNE COOKMAN COLLEGE",NA,NA,749,388,361,77,25,52,0.134,0.103,0.069,7280,1
"1660",132602,1998,1,0,"BETHUNE COOKMAN COLLEGE",NA,NA,623,316,307,97,24,73,0.231,0.156,0.078,8047,10
"1661",132602,1999,1,0,"BETHUNE COOKMAN COLLEGE",NA,NA,677,360,317,134,36,98,0.272,0.198,0.114,8560,5
"1662",132602,2000,1,0,"BETHUNE COOKMAN COLLEGE",NA,NA,833,478,355,105,26,79,0.165,0.126,0.073,8988,7
"1663",132602,2001,1,0,"BETHUNE COOKMAN COLLEGE",NA,NA,720,386,334,91,31,60,0.155,0.126,0.093,9617,13
"1664",132602,2002,1,0,"BETHUNE COOKMAN COLLEGE",NA,NA,607,351,256,161,59,102,0.291,0.265,0.23,9810,10
"1665",132602,2003,1,0,"BETHUNE COOKMAN COLLEGE",NA,NA,827,492,335,112,24,88,0.179,0.135,0.072,10106,7
"1666",132602,2004,1,0,"BETHUNE COOKMAN COLLEGE",NA,NA,818,503,315,118,29,89,0.177,0.144,0.092,10610,5
"1667",132602,2005,1,0,"Bethune Cookman College",NA,NA,913,525,388,140,52,88,0.168,0.153,0.134,11140,9
"1668",132602,2006,1,0,"Bethune Cookman College",NA,NA,901,497,404,142,64,78,0.157,0.158,0.158,11792,12
"1669",132602,2007,1,0,"Bethune-Cookman University",NA,NA,821,511,310,136,44,92,0.18,0.166,0.142,12382,5
"1670",132602,2008,1,0,"Bethune-Cookman University",NA,NA,719,478,241,198,38,160,0.335,0.275,0.158,12876,6
"1671",132602,2009,1,0,"Bethune-Cookman University",NA,NA,917,551,366,233,76,157,0.285,0.254,0.208,12936,6
"1672",132602,2010,1,0,"Bethune-Cookman University",NA,NA,924,579,345,132,32,100,0.173,0.143,0.093,13452,9
"1673",132903,1991,1,0,"UNIVERSITY OF CENTRAL FLORIDA",NA,NA,1577,813,764,332,89,243,0.299,0.211,0.116,1523,1026
"1674",132903,1992,1,0,"UNIVERSITY OF CENTRAL FLORIDA",NA,NA,1405,745,660,330,92,238,0.32,0.235,0.139,1713,995
"1675",132903,1993,1,0,"UNIVERSITY OF CENTRAL FLORIDA",NA,NA,1882,955,927,432,144,288,0.302,0.23,0.155,1756,1365
"1676",132903,1995,1,0,"UNIVERSITY OF CENTRAL FLORIDA",NA,NA,2411,1295,1116,661,217,444,0.343,0.274,0.194,1840,1900
"1677",132903,1996,1,0,"UNIVERSITY OF CENTRAL FLORIDA",NA,NA,2579,1316,1263,672,219,453,0.344,0.261,0.173,1924,1966
"1678",132903,1997,1,0,"UNIVERSITY OF CENTRAL FLORIDA",NA,NA,2839,1510,1329,785,265,520,0.344,0.277,0.199,2024,2171
"1679",132903,1998,1,0,"UNIVERSITY OF CENTRAL FLORIDA",NA,NA,3792,1932,1860,1097,387,710,0.368,0.289,0.208,2121,2959
"1680",132903,1999,1,0,"UNIVERSITY OF CENTRAL FLORIDA",NA,NA,4267,2256,2011,1298,425,873,0.387,0.304,0.211,2296,3177
"1681",132903,2000,1,0,"UNIVERSITY OF CENTRAL FLORIDA",NA,NA,4558,2436,2122,1384,436,948,0.389,0.304,0.205,1554,3329
"1682",132903,2001,1,0,"UNIVERSITY OF CENTRAL FLORIDA",NA,NA,4913,2621,2292,1529,529,1000,0.382,0.311,0.231,1670,3537
"1683",132903,2002,1,0,"UNIVERSITY OF CENTRAL FLORIDA",NA,NA,5330,2851,2479,1736,578,1158,0.406,0.326,0.233,1753,3824
"1684",132903,2003,1,0,"UNIVERSITY OF CENTRAL FLORIDA",NA,NA,5653,2956,2697,1923,673,1250,0.423,0.34,0.25,1902,3910
"1685",132903,2004,1,0,"UNIVERSITY OF CENTRAL FLORIDA",NA,NA,5710,3041,2669,1986,723,1263,0.415,0.348,0.271,2045,4020
"1686",132903,2005,1,0,"University of Central Florida",NA,NA,6041,3216,2825,2025,720,1305,0.406,0.335,0.255,2147,4096
"1687",132903,2006,1,0,"University of Central Florida",NA,NA,6389,3389,3000,2257,754,1503,0.444,0.353,0.251,2211,4542
"1688",132903,2007,1,0,"University of Central Florida",NA,NA,6350,3310,3040,2277,827,1450,0.438,0.359,0.272,2211,4398
"1689",132903,2008,1,0,"University of Central Florida",NA,NA,6139,3283,2856,2464,867,1597,0.486,0.401,0.304,2531,4150
"1690",132903,2009,1,0,"University of Central Florida",NA,NA,6251,3342,2909,2529,868,1661,0.497,0.405,0.298,2910,4258
"1691",132903,2010,1,0,"University of Central Florida",NA,NA,6028,3179,2849,2407,859,1548,0.487,0.399,0.302,3347,3805
"1692",133492,1991,1,0,"ECKERD COLLEGE",NA,NA,336,187,149,186,80,106,0.567,0.554,0.537,12900,278
"1693",133492,1992,1,0,"ECKERD COLLEGE",NA,NA,348,182,166,187,92,95,0.522,0.537,0.554,13725,279
"1694",133492,1993,1,0,"ECKERD COLLEGE",NA,NA,364,185,179,201,103,98,0.53,0.552,0.575,14770,303
"1695",133492,1995,1,0,"ECKERD COLLEGE",NA,NA,334,184,150,199,83,116,0.63,0.596,0.553,15975,278
"1696",133492,1996,1,0,"ECKERD COLLEGE",NA,NA,429,260,169,242,84,158,0.608,0.564,0.497,16625,341
"1697",133492,1997,1,0,"ECKERD COLLEGE",NA,NA,386,230,156,230,88,142,0.617,0.596,0.564,17130,310
"1698",133492,1998,1,0,"ECKERD COLLEGE",NA,NA,407,227,180,234,99,135,0.595,0.575,0.55,17685,330
"1699",133492,1999,1,0,"ECKERD COLLEGE",NA,NA,403,210,193,232,101,131,0.624,0.576,0.523,18025,326
"1700",133492,2000,1,0,"ECKERD COLLEGE",NA,NA,408,223,185,215,95,120,0.538,0.527,0.514,18565,315
"1701",133492,2001,1,0,"ECKERD COLLEGE",NA,NA,424,241,183,225,83,142,0.589,0.531,0.454,19870,345
"1702",133492,2002,1,0,"ECKERD COLLEGE",NA,NA,442,239,203,261,117,144,0.603,0.59,0.576,21262,332
"1703",133492,2003,1,0,"ECKERD COLLEGE",NA,NA,434,248,186,250,101,149,0.601,0.576,0.543,22538,338
"1704",133492,2004,1,0,"ECKERD COLLEGE",NA,NA,471,272,199,297,119,178,0.654,0.631,0.598,24116,372
"1705",133492,2005,1,0,"Eckerd College",NA,NA,501,297,204,275,102,173,0.583,0.549,0.5,25804,408
"1706",133492,2006,1,0,"Eckerd College",NA,NA,544,315,229,308,113,195,0.619,0.566,0.493,27352,447
"1707",133492,2007,1,0,"Eckerd College",NA,NA,535,319,216,315,127,188,0.589,0.589,0.588,28860,432
"1708",133492,2008,1,0,"Eckerd College",NA,NA,487,285,202,283,116,167,0.586,0.581,0.574,30304,385
"1709",133492,2009,1,0,"Eckerd College",NA,NA,504,300,204,301,122,179,0.597,0.597,0.598,31818,413
"1710",133492,2010,1,0,"Eckerd College",NA,NA,496,300,196,304,117,187,0.623,0.613,0.597,32932,384
"1711",133553,1991,1,0,"EMBRY-RIDDLE AERONAUTICAL UNIVERSITY",NA,NA,875,134,741,190,158,32,0.239,0.217,0.213,6310,730
"1712",133553,1992,1,0,"EMBRY-RIDDLE AERONAUTICAL UNIVERSITY",NA,NA,801,132,669,190,149,41,0.311,0.237,0.223,6810,691
"1713",133553,1993,1,0,"EMBRY-RIDDLE AERONAUTICAL UNIVERSITY",NA,NA,799,128,671,154,122,32,0.25,0.193,0.182,7370,688
"1714",133553,1995,1,0,"EMBRY-RIDDLE AERONAUTICAL UNIVERSITY",NA,NA,665,100,565,128,105,23,0.23,0.192,0.186,8280,498
"1715",133553,1996,1,0,"EMBRY-RIDDLE AERONAUTICAL UNIVERSITY",NA,NA,711,95,616,132,119,13,0.137,0.186,0.193,8740,476
"1716",133553,1997,1,0,"EMBRY-RIDDLE AERONAUTICAL UNIVERSITY",NA,NA,1020,136,884,213,184,29,0.213,0.209,0.208,9230,689
"1717",133553,1998,1,0,"EMBRY-RIDDLE AERONAUTICAL UNIVERSITY",NA,NA,934,128,806,279,230,49,0.383,0.299,0.285,9920,644
"1718",133553,1999,1,0,"EMBRY RIDDLE AERONAUTICAL UNIVERSITY",NA,NA,939,151,788,305,245,60,0.397,0.325,0.311,10100,685
"1719",133553,2000,1,0,"EMBRY RIDDLE AERONAUTICAL UNIVERSITY",NA,NA,797,124,673,280,225,55,0.444,0.351,0.334,14500,603
"1720",133553,2001,1,0,"EMBRY RIDDLE AERONAUTICAL UNIVERSITY-DAYTONA BEACH",NA,NA,1013,159,854,338,277,61,0.384,0.334,0.324,15370,753
"1721",133553,2002,1,0,"EMBRY RIDDLE AERONAUTICAL UNIVERSITY-DAYTONA BEACH",NA,NA,872,148,724,315,244,71,0.48,0.361,0.337,17850,633
"1722",133553,2003,1,0,"EMBRY RIDDLE AERONAUTICAL UNIVERSITY-DAYTONA BEACH",NA,NA,1012,164,848,292,238,54,0.329,0.289,0.281,20700,687
"1723",133553,2004,1,0,"EMBRY RIDDLE AERONAUTICAL UNIVERSITY-DAYTONA BEACH",NA,NA,933,139,794,282,231,51,0.367,0.302,0.291,21530,646
"1724",133553,2005,1,0,"Embry Riddle Aeronautical University-Daytona Beach",NA,NA,975,152,823,307,246,61,0.401,0.315,0.299,22820,656
"1725",133553,2006,1,0,"Embry Riddle Aeronautical University-Daytona Beach",NA,NA,1101,161,940,363,290,73,0.453,0.33,0.309,24420,713
"1726",133553,2007,1,0,"Embry Riddle Aeronautical University-Daytona Beach",NA,NA,1014,158,856,341,277,64,0.405,0.336,0.324,25400,650
"1727",133553,2008,1,0,"Embry Riddle Aeronautical University-Daytona Beach",NA,NA,1058,158,900,325,263,62,0.392,0.307,0.292,26420,667
"1728",133553,2009,1,0,"Embry Riddle Aeronautical University-Daytona Beach",NA,NA,853,134,719,265,203,62,0.463,0.311,0.282,27480,476
"1729",133553,2010,1,0,"Embry Riddle Aeronautical University-Daytona Beach",NA,NA,949,120,829,283,239,44,0.367,0.298,0.288,28560,574
"1730",133650,1991,1,0,"FLORIDA AGRICULTURAL AND MECHANICAL UNIVERSITY",NA,NA,1608,945,663,188,36,152,0.161,0.117,0.054,1545,8
"1731",133650,1992,1,0,"FLORIDA AGRICULTURAL AND MECHANICAL UNIVERSITY",NA,NA,1383,815,568,206,60,146,0.179,0.149,0.106,1749,18
"1732",133650,1993,1,0,"FLORIDA AGRICULTURAL AND MECHANICAL UNIVERSITY",NA,NA,1507,908,599,210,46,164,0.181,0.139,0.077,1829,15
"1733",133650,1995,1,0,"FLORIDA AGRICULTURAL AND MECHANICAL UNIVERSITY",NA,NA,1574,952,622,245,63,182,0.191,0.156,0.101,1848,9
"1734",133650,1996,1,0,"FLORIDA AGRICULTURAL AND MECHANICAL UNIVERSITY",NA,NA,1717,1017,700,281,83,198,0.195,0.164,0.119,1863,16
"1735",133650,1997,1,0,"FLORIDA AGRICULTURAL AND MECHANICAL UNIVERSITY",NA,NA,1947,1148,799,328,84,244,0.212,0.168,0.105,1970,15
"1736",133650,1998,1,0,"FLORIDA AGRICULTURAL AND MECHANICAL UNIVERSITY",NA,NA,2213,1294,919,385,120,265,0.205,0.174,0.131,2133,7
"1737",133650,1999,1,0,"FLORIDA AGRICULTURAL AND MECHANICAL UNIVERSITY",NA,NA,2205,1277,928,360,86,274,0.215,0.163,0.093,2325,13
"1738",133650,2000,1,0,"FLORIDA AGRICULTURAL AND MECHANICAL UNIVERSITY",NA,NA,2145,1263,882,415,99,316,0.25,0.193,0.112,1554,17
"1739",133650,2001,1,0,"FLORIDA AGRICULTURAL AND MECHANICAL UNIVERSITY",NA,NA,2243,1300,943,368,88,280,0.215,0.164,0.093,1670,15
"1740",133650,2002,1,0,"FLORIDA AGRICULTURAL AND MECHANICAL UNIVERSITY",NA,NA,2097,1249,848,280,77,203,0.162,0.134,0.091,1754,14
"1741",133650,2003,1,0,"FLORIDA AGRICULTURAL AND MECHANICAL UNIVERSITY",NA,NA,2403,1391,1012,289,79,210,0.151,0.12,0.078,1902,20
"1742",133650,2004,1,0,"FLORIDA AGRICULTURAL AND MECHANICAL UNIVERSITY",NA,NA,2105,1242,863,268,73,195,0.157,0.127,0.085,2045,49
"1743",133650,2005,1,0,"Florida Agricultural and Mechanical University",NA,NA,1636,925,711,183,61,122,0.132,0.112,0.086,2148,19
"1744",133650,2006,1,0,"Florida Agricultural and Mechanical University",NA,NA,1614,925,689,156,36,120,0.13,0.097,0.052,2211,27
"1745",133650,2007,1,0,"Florida Agricultural and Mechanical University",NA,NA,1853,1071,782,217,74,143,0.134,0.117,0.095,2211,21
"1746",133650,2008,1,0,"Florida Agricultural and Mechanical University",NA,NA,2090,1196,894,254,79,175,0.146,0.122,0.088,2461,31
"1747",133650,2009,1,0,"Florida Agricultural and Mechanical University",NA,NA,2348,1421,927,267,88,179,0.126,0.114,0.095,2658,23
"1748",133650,2010,1,0,"Florida Agricultural and Mechanical University",NA,NA,2701,1636,1065,331,94,237,0.145,0.123,0.088,2870,45
"1749",133669,1991,1,0,"FLORIDA ATLANTIC UNIVERSITY",NA,NA,651,358,293,93,29,64,0.179,0.143,0.099,1350,483
"1750",133669,1992,1,0,"FLORIDA ATLANTIC UNIVERSITY",NA,NA,795,417,378,115,43,72,0.173,0.145,0.114,1733,607
"1751",133669,1993,1,0,"FLORIDA ATLANTIC UNIVERSITY",NA,NA,743,412,331,104,34,70,0.17,0.14,0.103,1791,530
"1752",133669,1995,1,0,"FLORIDA ATLANTIC UNIVERSITY",NA,NA,901,504,397,162,51,111,0.22,0.18,0.128,1446,581
"1753",133669,1996,1,0,"FLORIDA ATLANTIC UNIVERSITY",NA,NA,1001,551,450,155,57,98,0.178,0.155,0.127,1512,693
"1754",133669,1997,1,0,"FLORIDA ATLANTIC UNIVERSITY-BOCA RATON",NA,NA,1174,669,505,161,54,107,0.16,0.137,0.107,1618,777
"1755",133669,1998,1,0,"FLORIDA ATLANTIC UNIVERSITY-BOCA RATON",NA,NA,1309,773,536,196,56,140,0.181,0.15,0.104,1695,847
"1756",133669,1999,1,0,"FLORIDA ATLANTIC UNIVERSITY-BOCA RATON",NA,NA,1423,860,563,201,56,145,0.169,0.141,0.099,2253,928
"1757",133669,2000,1,0,"FLORIDA ATLANTIC UNIVERSITY-BOCA RATON",NA,NA,1818,988,830,254,89,165,0.167,0.14,0.107,1554,1179
"1758",133669,2001,1,0,"FLORIDA ATLANTIC UNIVERSITY-BOCA RATON",NA,NA,1937,1120,817,292,85,207,0.185,0.151,0.104,1670,1211
"1759",133669,2002,1,0,"FLORIDA ATLANTIC UNIVERSITY-BOCA RATON",NA,NA,1994,1102,892,323,115,208,0.189,0.162,0.129,1402,1229
"1760",133669,2003,1,0,"FLORIDA ATLANTIC UNIVERSITY-BOCA RATON",NA,NA,2038,1143,895,335,109,226,0.198,0.164,0.122,1522,1268
"1761",133669,2004,1,0,"FLORIDA ATLANTIC UNIVERSITY-BOCA RATON",NA,NA,2278,1231,1047,364,122,242,0.197,0.16,0.117,1636,1397
"1762",133669,2005,1,0,"Florida Atlantic University",NA,NA,2080,1111,969,363,126,237,0.213,0.175,0.13,1717,1324
"1763",133669,2006,1,0,"Florida Atlantic University",NA,NA,2193,1208,985,339,115,224,0.185,0.155,0.117,1769,1328
"1764",133669,2007,1,0,"Florida Atlantic University",NA,NA,2563,1326,1237,388,150,238,0.18,0.151,0.121,1769,1482
"1765",133669,2008,1,0,"Florida Atlantic University",NA,NA,2677,1407,1270,457,149,308,0.219,0.171,0.117,1968,1533
"1766",133669,2009,1,0,"Florida Atlantic University",NA,NA,2447,1314,1133,487,156,331,0.252,0.199,0.138,2126,1418
"1767",133669,2010,1,0,"Florida Atlantic University",NA,NA,2616,1359,1257,501,169,332,0.244,0.192,0.134,2296,1425
"1768",133711,1991,1,0,"FLAGLER COLLEGE",NA,NA,290,169,121,133,50,83,0.491,0.459,0.413,4550,273
"1769",133711,1992,1,0,"FLAGLER COLLEGE",NA,NA,299,169,130,125,43,82,0.485,0.418,0.331,4710,273
"1770",133711,1993,1,0,"FLAGLER COLLEGE",NA,NA,338,193,145,147,59,88,0.456,0.435,0.407,4920,309
"1771",133711,1995,1,0,"FLAGLER COLLEGE",NA,NA,355,217,138,143,45,98,0.452,0.403,0.326,5375,334
"1772",133711,1996,1,0,"FLAGLER COLLEGE",NA,NA,355,217,138,143,45,98,0.452,0.403,0.326,5530,334
"1773",133711,1997,1,0,"FLAGLER COLLEGE",NA,NA,424,272,152,176,55,121,0.445,0.415,0.362,5760,403
"1774",133711,1998,1,0,"FLAGLER COLLEGE",NA,NA,418,285,133,182,58,124,0.435,0.435,0.436,5950,391
"1775",133711,1999,1,0,"FLAGLER COLLEGE",NA,NA,419,267,152,186,61,125,0.468,0.444,0.401,6130,394
"1776",133711,2000,1,0,"FLAGLER COLLEGE",NA,NA,496,315,181,206,72,134,0.425,0.415,0.398,6320,453
"1777",133711,2001,1,0,"FLAGLER COLLEGE",NA,NA,407,253,154,185,59,126,0.498,0.455,0.383,6550,377
"1778",133711,2002,1,0,"FLAGLER COLLEGE",NA,NA,481,308,173,231,70,161,0.523,0.48,0.405,6870,441
"1779",133711,2003,1,0,"FLAGLER COLLEGE",NA,NA,556,318,238,220,84,136,0.428,0.396,0.353,7410,495
"1780",133711,2004,1,0,"FLAGLER COLLEGE",NA,NA,500,296,204,250,98,152,0.514,0.5,0.48,8000,454
"1781",133711,2005,1,0,"Flagler College",NA,NA,459,283,176,216,77,139,0.491,0.471,0.438,8600,426
"1782",133711,2006,1,0,"Flagler College",NA,NA,463,284,179,235,77,158,0.556,0.508,0.43,9450,208
"1783",133711,2007,1,0,"Flagler College",NA,NA,531,333,198,246,85,161,0.484,0.463,0.429,11810,290
"1784",133711,2008,1,0,"Flagler College",NA,NA,645,365,280,312,116,196,0.537,0.484,0.414,12520,550
"1785",133711,2009,1,0,"Flagler College",NA,NA,564,337,227,281,94,187,0.555,0.498,0.414,13300,480
"1786",133711,2010,1,0,"Flagler College-St Augustine",NA,NA,612,347,265,281,98,183,0.527,0.459,0.37,13860,490
"1787",133881,1991,0,1,"FLORIDA INSTITUTE OF TECHNOLOGY",1993,0,350,78,272,98,67,31,0.397,0.28,0.246,10752,256
"1788",133881,1992,0,1,"FLORIDA INSTITUTE OF TECHNOLOGY",1993,0,457,121,336,147,99,48,0.397,0.322,0.295,11817,321
"1789",133881,1993,1,0,"FLORIDA INSTITUTE OF TECHNOLOGY",1993,1,358,109,249,93,65,28,0.257,0.26,0.261,13035,247
"1790",133881,1995,1,0,"FLORIDA INSTITUTE OF TECHNOLOGY",1993,1,370,111,259,113,70,43,0.387,0.305,0.27,14111,237
"1791",133881,1996,1,0,"FLORIDA INSTITUTE OF TECHNOLOGY",1993,1,491,149,342,171,101,70,0.47,0.348,0.295,15060,314
"1792",133881,1997,1,0,"FLORIDA INSTITUTE OF TECHNOLOGY-MELBOURNE",1993,1,367,112,255,128,84,44,0.393,0.349,0.329,15510,216
"1793",133881,1998,1,0,"FLORIDA INSTITUTE OF TECHNOLOGY-MELBOURNE",1993,1,461,145,316,173,108,65,0.448,0.375,0.342,16500,307
"1794",133881,1999,1,0,"FLORIDA INSTITUTE OF TECHNOLOGY-MELBOURNE",1993,1,402,116,286,139,95,44,0.379,0.346,0.332,17300,259
"1795",133881,2000,1,0,"FLORIDA INSTITUTE OF TECHNOLOGY-MELBOURNE",1993,1,531,156,375,214,145,69,0.442,0.403,0.387,18450,355
"1796",133881,2001,1,0,"FLORIDA INSTITUTE OF TECHNOLOGY-MELBOURNE",1993,1,544,153,391,203,128,75,0.49,0.373,0.327,19700,332
"1797",133881,2002,1,0,"FLORIDA INSTITUTE OF TECHNOLOGY-MELBOURNE",1993,1,518,139,379,218,142,76,0.547,0.421,0.375,20900,306
"1798",133881,2003,1,0,"FLORIDA INSTITUTE OF TECHNOLOGY-MELBOURNE",1993,1,549,174,375,219,136,83,0.477,0.399,0.363,22600,326
"1799",133881,2004,1,0,"FLORIDA INSTITUTE OF TECHNOLOGY-MELBOURNE",1993,1,551,181,370,218,132,86,0.475,0.396,0.357,23730,337
"1800",133881,2005,1,0,"Florida Institute of Technology-Melbourne",1993,1,603,154,449,242,172,70,0.454,0.401,0.383,25150,394
"1801",133881,2006,1,0,"Florida Institute of Technology",1993,1,597,160,437,222,144,78,0.488,0.372,0.33,27540,280
"1802",133881,2007,1,0,"Florida Institute of Technology",1993,1,675,186,489,261,170,91,0.489,0.387,0.348,28920,305
"1803",133881,2008,1,0,"Florida Institute of Technology",1993,1,635,194,441,247,152,95,0.49,0.389,0.345,29940,384
"1804",133881,2009,1,0,"Florida Institute of Technology",1993,1,538,145,393,222,144,78,0.538,0.413,0.366,31020,304
"1805",133881,2010,1,0,"Florida Institute of Technology",1993,1,489,138,351,220,142,78,0.565,0.45,0.405,31734,298
"1806",133951,1991,1,0,"FLORIDA INTERNATIONAL UNIVERSITY",NA,NA,1021,600,421,198,62,136,0.227,0.194,0.147,1478,242
"1807",133951,1992,1,0,"FLORIDA INTERNATIONAL UNIVERSITY",NA,NA,1124,625,499,197,64,133,0.213,0.175,0.128,1701,266
"1808",133951,1993,1,0,"FLORIDA INTERNATIONAL UNIVERSITY",NA,NA,1306,751,555,216,65,151,0.201,0.165,0.117,1757,223
"1809",133951,1995,1,0,"FLORIDA INTERNATIONAL UNIVERSITY",NA,NA,1752,1003,749,270,74,196,0.195,0.154,0.099,1791,324
"1810",133951,1996,1,0,"FLORIDA INTERNATIONAL UNIVERSITY",NA,NA,1846,1067,779,314,87,227,0.213,0.17,0.112,1875,298
"1811",133951,1997,1,0,"FLORIDA INTERNATIONAL UNIVERSITY",NA,NA,1987,1144,843,352,91,261,0.228,0.177,0.108,2035,371
"1812",133951,1998,1,0,"FLORIDA INTERNATIONAL UNIVERSITY",NA,NA,2227,1298,929,430,117,313,0.241,0.193,0.126,2154,423
"1813",133951,1999,1,0,"FLORIDA INTERNATIONAL UNIVERSITY",NA,NA,2482,1460,1022,525,141,384,0.263,0.212,0.138,2272,451
"1814",133951,2000,1,0,"FLORIDA INTERNATIONAL UNIVERSITY",NA,NA,2582,1511,1071,507,148,359,0.238,0.196,0.138,1554,523
"1815",133951,2001,1,0,"FLORIDA INTERNATIONAL UNIVERSITY",NA,NA,2457,1364,1093,527,145,382,0.28,0.214,0.133,1670,490
"1816",133951,2002,1,0,"FLORIDA INTERNATIONAL UNIVERSITY",NA,NA,2801,1617,1184,566,176,390,0.241,0.202,0.149,1754,535
"1817",133951,2003,1,0,"FLORIDA INTERNATIONAL UNIVERSITY",NA,NA,3038,1756,1282,597,185,412,0.235,0.197,0.144,1902,570
"1818",133951,2004,1,0,"FLORIDA INTERNATIONAL UNIVERSITY",NA,NA,3370,1906,1464,647,198,449,0.236,0.192,0.135,2045,551
"1819",133951,2005,1,0,"Florida International University",NA,NA,3967,2261,1706,634,188,446,0.197,0.16,0.11,2147,641
"1820",133951,2006,1,0,"Florida International University",NA,NA,3889,2099,1790,736,243,493,0.235,0.189,0.136,2211,626
"1821",133951,2007,1,0,"Florida International University",NA,NA,3230,1707,1523,661,209,452,0.265,0.205,0.137,2211,512
"1822",133951,2008,1,0,"Florida International University",NA,NA,3106,1642,1464,732,234,498,0.303,0.236,0.16,2565,459
"1823",133951,2009,1,0,"Florida International University",NA,NA,2946,1615,1331,828,278,550,0.341,0.281,0.209,2864,403
"1824",133951,2010,1,0,"Florida International University",NA,NA,3752,2079,1673,931,280,651,0.313,0.248,0.167,3200,424
"1825",134079,1991,1,0,"FLORIDA SOUTHERN COLLEGE",NA,NA,378,210,168,147,53,94,0.448,0.389,0.315,6080,346
"1826",134079,1992,1,0,"FLORIDA SOUTHERN COLLEGE",NA,NA,343,200,143,147,45,102,0.51,0.429,0.315,7080,311
"1827",134079,1993,1,0,"FLORIDA SOUTHERN COLLEGE",NA,NA,375,207,168,138,58,80,0.386,0.368,0.345,7660,330
"1828",134079,1995,1,0,"FLORIDA SOUTHERN COLLEGE",NA,NA,527,302,225,230,76,154,0.51,0.436,0.338,8630,438
"1829",134079,1996,1,0,"FLORIDA SOUTHERN COLLEGE",NA,NA,458,287,171,224,67,157,0.547,0.489,0.392,9970,384
"1830",134079,1997,1,0,"FLORIDA SOUTHERN COLLEGE",NA,NA,428,270,158,196,67,129,0.478,0.458,0.424,10604,364
"1831",134079,1998,1,0,"FLORIDA SOUTHERN COLLEGE",NA,NA,440,286,154,199,55,144,0.504,0.452,0.357,11274,380
"1832",134079,1999,1,0,"FLORIDA SOUTHERN COLLEGE",NA,NA,425,267,158,173,55,118,0.442,0.407,0.348,11650,383
"1833",134079,2000,1,0,"FLORIDA SOUTHERN COLLEGE",NA,NA,506,306,200,209,62,147,0.48,0.413,0.31,12750,419
"1834",134079,2001,1,0,"FLORIDA SOUTHERN COLLEGE",NA,NA,515,323,192,205,66,139,0.43,0.398,0.344,13700,434
"1835",134079,2002,1,0,"FLORIDA SOUTHERN COLLEGE",NA,NA,491,322,169,184,41,143,0.444,0.375,0.243,15778,414
"1836",134079,2003,1,0,"FLORIDA SOUTHERN COLLEGE",NA,NA,436,250,186,163,51,112,0.448,0.374,0.274,17192,354
"1837",134079,2004,1,0,"FLORIDA SOUTHERN COLLEGE",NA,NA,553,342,211,227,70,157,0.459,0.41,0.332,17860,468
"1838",134079,2005,1,0,"Florida Southern College",NA,NA,462,274,188,190,60,130,0.475,0.411,0.319,18765,386
"1839",134079,2006,1,0,"Florida Southern College",NA,NA,420,267,153,198,59,139,0.521,0.471,0.386,19700,342
"1840",134079,2007,1,0,"Florida Southern College",NA,NA,423,259,164,199,77,122,0.471,0.47,0.47,20690,333
"1841",134079,2008,1,0,"Florida Southern College",NA,NA,497,304,193,277,102,175,0.576,0.557,0.528,21620,414
"1842",134079,2009,1,0,"Florida Southern College",NA,NA,557,319,238,257,91,166,0.52,0.461,0.382,22270,430
"1843",134079,2010,1,0,"Florida Southern College",NA,NA,602,357,245,314,119,195,0.546,0.522,0.486,23578,452
"1844",134097,1991,1,0,"FLORIDA STATE UNIVERSITY",NA,NA,2899,1702,1197,1131,410,721,0.424,0.39,0.343,1492,2346
"1845",134097,1992,1,0,"FLORIDA STATE UNIVERSITY",NA,NA,3313,1949,1364,1259,378,881,0.452,0.38,0.277,1679,2730
"1846",134097,1993,1,0,"FLORIDA STATE UNIVERSITY",NA,NA,3603,2132,1471,1424,480,944,0.443,0.395,0.326,1780,2914
"1847",134097,1995,1,0,"FLORIDA STATE UNIVERSITY",NA,NA,3826,2210,1616,1534,530,1004,0.454,0.401,0.328,1798,2983
"1848",134097,1996,1,0,"FLORIDA STATE UNIVERSITY",NA,NA,3999,2329,1670,1583,536,1047,0.45,0.396,0.321,1882,3023
"1849",134097,1997,1,0,"FLORIDA STATE UNIVERSITY",NA,NA,4491,2525,1966,1822,606,1216,0.482,0.406,0.308,1988,3408
"1850",134097,1998,1,0,"FLORIDA STATE UNIVERSITY",NA,NA,5066,2932,2134,2143,705,1438,0.49,0.423,0.33,2084,3862
"1851",134097,1999,1,0,"FLORIDA STATE UNIVERSITY",NA,NA,5078,2934,2144,2244,793,1451,0.495,0.442,0.37,2195,3892
"1852",134097,2000,1,0,"FLORIDA STATE UNIVERSITY",NA,NA,5557,3294,2263,2481,811,1670,0.507,0.446,0.358,1554,4188
"1853",134097,2001,1,0,"FLORIDA STATE UNIVERSITY",NA,NA,5681,3318,2363,2702,928,1774,0.535,0.476,0.393,1670,4014
"1854",134097,2002,1,0,"FLORIDA STATE UNIVERSITY",NA,NA,6258,3742,2516,2927,959,1968,0.526,0.468,0.381,1754,4531
"1855",134097,2003,1,0,"FLORIDA STATE UNIVERSITY",NA,NA,6059,3522,2537,2847,987,1860,0.528,0.47,0.389,1902,4543
"1856",134097,2004,1,0,"FLORIDA STATE UNIVERSITY",NA,NA,6198,3727,2471,3112,1029,2083,0.559,0.502,0.416,2045,4545
"1857",134097,2005,1,0,"Florida State University",NA,NA,6052,3554,2498,2995,1066,1929,0.543,0.495,0.427,2147,4419
"1858",134097,2006,1,0,"Florida State University",NA,NA,6191,3597,2594,3310,1201,2109,0.586,0.535,0.463,2211,4564
"1859",134097,2007,1,0,"Florida State University",NA,NA,6104,3436,2668,3458,1266,2192,0.638,0.567,0.475,2211,4426
"1860",134097,2008,1,0,"Florida State University",NA,NA,4993,2928,2065,3066,1093,1973,0.674,0.614,0.529,2461,3523
"1861",134097,2009,1,0,"Florida State University",NA,NA,5925,3476,2449,3650,1245,2405,0.692,0.616,0.508,2658,4079
"1862",134097,2010,1,0,"Florida State University",NA,NA,5957,3515,2442,3620,1249,2371,0.674,0.608,0.511,2870,4073
"1863",134130,1991,1,0,"UNIVERSITY OF FLORIDA",NA,NA,4364,2116,2248,1284,490,794,0.375,0.294,0.218,1420,3388
"1864",134130,1992,1,0,"UNIVERSITY OF FLORIDA",NA,NA,4471,2097,2374,1377,568,809,0.386,0.308,0.239,1650,3308
"1865",134130,1993,1,0,"UNIVERSITY OF FLORIDA",NA,NA,5074,2520,2554,1728,701,1027,0.408,0.341,0.274,1770,3823
"1866",134130,1995,1,0,"UNIVERSITY OF FLORIDA",NA,NA,5655,3023,2632,2443,903,1540,0.509,0.432,0.343,1705,4121
"1867",134130,1996,1,0,"UNIVERSITY OF FLORIDA",NA,NA,5171,2899,2272,2599,929,1670,0.576,0.503,0.409,1793,3823
"1868",134130,1997,1,0,"UNIVERSITY OF FLORIDA",NA,NA,5959,3307,2652,2950,1073,1877,0.568,0.495,0.405,1926,4397
"1869",134130,1998,1,0,"UNIVERSITY OF FLORIDA",NA,NA,5629,3171,2458,2886,1037,1849,0.583,0.513,0.422,2052,4123
"1870",134130,1999,1,0,"UNIVERSITY OF FLORIDA",NA,NA,6065,3388,2677,3191,1111,2080,0.614,0.526,0.415,2141,4292
"1871",134130,2000,1,0,"UNIVERSITY OF FLORIDA",NA,NA,6864,3874,2990,3692,1285,2407,0.621,0.538,0.43,1554,4553
"1872",134130,2001,1,0,"UNIVERSITY OF FLORIDA",NA,NA,6178,3348,2830,3304,1208,2096,0.626,0.535,0.427,1670,4518
"1873",134130,2002,1,0,"UNIVERSITY OF FLORIDA",NA,NA,6406,3674,2732,3586,1215,2371,0.645,0.56,0.445,1754,4405
"1874",134130,2003,1,0,"UNIVERSITY OF FLORIDA",NA,NA,6499,3790,2709,3779,1253,2526,0.667,0.581,0.463,1902,4452
"1875",134130,2004,1,0,"UNIVERSITY OF FLORIDA",NA,NA,6621,3706,2915,3933,1418,2515,0.679,0.594,0.486,2045,4481
"1876",134130,2005,1,0,"University of Florida",NA,NA,7217,4080,3137,4230,1533,2697,0.661,0.586,0.489,2147,4673
"1877",134130,2006,1,0,"University of Florida",NA,NA,6674,3783,2891,4294,1572,2722,0.72,0.643,0.544,2211,3961
"1878",134130,2007,1,0,"University of Florida",NA,NA,6440,3792,2648,4197,1467,2730,0.72,0.652,0.554,2211,3758
"1879",134130,2008,1,0,"University of Florida",NA,NA,6382,3787,2595,4289,1442,2847,0.752,0.672,0.556,2670,3837
"1880",134130,2009,1,0,"University of Florida",NA,NA,6253,3728,2525,4149,1367,2782,0.746,0.664,0.541,3070,3575
"1881",134130,2010,1,0,"University of Florida",NA,NA,6345,3661,2684,4275,1469,2806,0.767,0.674,0.547,3530,3693
"1882",134945,1991,1,0,"JACKSONVILLE UNIVERSITY",NA,NA,388,147,241,102,56,46,0.313,0.263,0.232,8450,307
"1883",134945,1992,1,0,"JACKSONVILLE UNIVERSITY",NA,NA,304,128,176,81,33,48,0.375,0.266,0.188,9320,227
"1884",134945,1993,1,0,"JACKSONVILLE UNIVERSITY",NA,NA,310,139,171,92,47,45,0.324,0.297,0.275,10080,249
"1885",134945,1995,1,0,"JACKSONVILLE UNIVERSITY",NA,NA,356,197,159,129,51,78,0.396,0.362,0.321,10580,267
"1886",134945,1996,1,0,"JACKSONVILLE UNIVERSITY",NA,NA,365,197,168,113,44,69,0.35,0.31,0.262,12510,273
"1887",134945,1997,1,0,"JACKSONVILLE UNIVERSITY",NA,NA,290,125,165,65,19,46,0.368,0.224,0.115,13900,197
"1888",134945,1998,1,0,"JACKSONVILLE UNIVERSITY",NA,NA,307,112,195,75,40,35,0.312,0.244,0.205,14420,192
"1889",134945,1999,1,0,"JACKSONVILLE UNIVERSITY",NA,NA,309,122,187,98,49,49,0.402,0.317,0.262,14390,180
"1890",134945,2000,1,0,"JACKSONVILLE UNIVERSITY",NA,NA,406,163,243,155,80,75,0.46,0.382,0.329,15270,277
"1891",134945,2001,1,0,"JACKSONVILLE UNIVERSITY",NA,NA,428,186,242,219,140,79,0.425,0.512,0.579,15990,289
"1892",134945,2002,1,0,"JACKSONVILLE UNIVERSITY",NA,NA,389,165,224,105,52,53,0.321,0.27,0.232,16540,274
"1893",134945,2003,1,0,"JACKSONVILLE UNIVERSITY",NA,NA,430,192,238,137,57,80,0.417,0.319,0.239,17700,299
"1894",134945,2004,1,0,"JACKSONVILLE UNIVERSITY",NA,NA,462,197,265,118,59,59,0.3,0.255,0.223,18590,283
"1895",134945,2005,1,0,"Jacksonville University",NA,NA,544,252,292,127,59,68,0.27,0.233,0.202,19970,272
"1896",134945,2006,1,0,"Jacksonville University",NA,NA,493,213,280,134,62,72,0.338,0.272,0.221,21200,275
"1897",134945,2007,1,0,"Jacksonville University",NA,NA,581,274,307,141,60,81,0.296,0.243,0.195,22500,326
"1898",134945,2008,1,0,"Jacksonville University",NA,NA,539,249,290,151,67,84,0.337,0.28,0.231,23900,321
"1899",134945,2009,1,0,"Jacksonville University",NA,NA,665,337,328,187,78,109,0.323,0.281,0.238,25300,445
"1900",134945,2010,1,0,"Jacksonville University",NA,NA,624,313,311,197,87,110,0.351,0.316,0.28,26600,324
"1901",135726,1991,1,0,"UNIVERSITY OF MIAMI",NA,NA,1832,826,1006,775,383,392,0.475,0.423,0.381,14080,1074
"1902",135726,1992,1,0,"UNIVERSITY OF MIAMI",NA,NA,1770,841,929,798,395,403,0.479,0.451,0.425,15050,1007
"1903",135726,1993,1,0,"UNIVERSITY OF MIAMI",NA,NA,1612,791,821,741,338,403,0.51,0.46,0.412,15880,836
"1904",135726,1995,1,0,"UNIVERSITY OF MIAMI",NA,NA,1684,913,771,832,348,484,0.53,0.494,0.451,17699,871
"1905",135726,1996,1,0,"UNIVERSITY OF MIAMI",NA,NA,1678,893,785,887,381,506,0.567,0.529,0.485,18582,798
"1906",135726,1997,1,0,"UNIVERSITY OF MIAMI",NA,NA,1814,960,854,962,421,541,0.564,0.53,0.493,19512,921
"1907",135726,1998,1,0,"UNIVERSITY OF MIAMI",NA,NA,1831,980,851,975,389,586,0.598,0.532,0.457,20424,940
"1908",135726,1999,1,0,"UNIVERSITY OF MIAMI",NA,NA,1845,998,847,1031,439,592,0.593,0.559,0.518,20960,982
"1909",135726,2000,1,0,"UNIVERSITY OF MIAMI",NA,NA,1964,1081,883,1140,469,671,0.621,0.58,0.531,22124,1091
"1910",135726,2001,1,0,"UNIVERSITY OF MIAMI",NA,NA,2152,1277,875,1349,503,846,0.662,0.627,0.575,23228,1215
"1911",135726,2002,1,0,"UNIVERSITY OF MIAMI",NA,NA,2046,1197,849,1311,497,814,0.68,0.641,0.585,24378,1177
"1912",135726,2003,1,0,"UNIVERSITY OF MIAMI",NA,NA,2066,1142,924,1374,582,792,0.694,0.665,0.63,25838,1192
"1913",135726,2004,1,0,"UNIVERSITY OF MIAMI",NA,NA,2025,1157,868,1381,551,830,0.717,0.682,0.635,27384,1163
"1914",135726,2005,1,0,"University of Miami",NA,NA,2258,1168,1090,1480,670,810,0.694,0.655,0.615,29020,1249
"1915",135726,2006,1,0,"University of Miami",NA,NA,2046,1055,991,1421,644,777,0.737,0.695,0.65,30732,1087
"1916",135726,2007,1,0,"University of Miami",NA,NA,1977,1049,928,1400,606,794,0.757,0.708,0.653,32422,968
"1917",135726,2008,1,0,"University of Miami",NA,NA,1983,987,996,1358,647,711,0.72,0.685,0.65,34206,932
"1918",135726,2009,1,0,"University of Miami",NA,NA,1903,924,979,1297,599,698,0.755,0.682,0.612,35540,948
"1919",135726,2010,1,0,"University of Miami",NA,NA,2105,1072,1033,1465,646,819,0.764,0.696,0.625,36962,1104
"1920",136172,1991,1,0,"UNIVERSITY OF NORTH FLORIDA",NA,NA,406,240,166,71,24,47,0.196,0.175,0.145,1413,315
"1921",136172,1992,1,0,"UNIVERSITY OF NORTH FLORIDA",NA,NA,487,277,210,68,27,41,0.148,0.14,0.129,1534,366
"1922",136172,1993,1,0,"UNIVERSITY OF NORTH FLORIDA",NA,NA,545,289,256,94,25,69,0.239,0.172,0.098,1732,432
"1923",136172,1995,1,0,"UNIVERSITY OF NORTH FLORIDA",NA,NA,762,463,299,145,26,119,0.257,0.19,0.087,1747,592
"1924",136172,1996,1,0,"UNIVERSITY OF NORTH FLORIDA",NA,NA,987,583,404,213,62,151,0.259,0.216,0.153,1884,766
"1925",136172,1997,1,0,"UNIVERSITY OF NORTH FLORIDA",NA,NA,1105,646,459,269,77,192,0.297,0.243,0.168,2006,861
"1926",136172,1998,1,0,"UNIVERSITY OF NORTH FLORIDA",NA,NA,1371,842,529,353,105,248,0.294,0.257,0.198,2157,1127
"1927",136172,1999,1,0,"UNIVERSITY OF NORTH FLORIDA",NA,NA,1501,886,615,375,97,278,0.314,0.25,0.158,2274,1228
"1928",136172,2000,1,0,"UNIVERSITY OF NORTH FLORIDA",NA,NA,1664,963,701,335,100,235,0.244,0.201,0.143,1554,1321
"1929",136172,2001,1,0,"UNIVERSITY OF NORTH FLORIDA",NA,NA,1672,979,693,392,126,266,0.272,0.234,0.182,1670,1303
"1930",136172,2002,1,0,"UNIVERSITY OF NORTH FLORIDA",NA,NA,1865,1067,798,395,129,266,0.249,0.212,0.162,1754,1508
"1931",136172,2003,1,0,"UNIVERSITY OF NORTH FLORIDA",NA,NA,1919,1115,804,444,120,324,0.291,0.231,0.149,1902,1566
"1932",136172,2004,1,0,"UNIVERSITY OF NORTH FLORIDA",NA,NA,2199,1252,947,447,116,331,0.264,0.203,0.122,2045,1714
"1933",136172,2005,1,0,"University of North Florida",NA,NA,2288,1296,992,518,179,339,0.262,0.226,0.18,2147,1742
"1934",136172,2006,1,0,"University of North Florida",NA,NA,2304,1301,1003,462,131,331,0.254,0.201,0.131,2211,1756
"1935",136172,2007,1,0,"University of North Florida",NA,NA,2048,1185,863,435,151,284,0.24,0.212,0.175,2211,1539
"1936",136172,2008,1,0,"University of North Florida",NA,NA,1694,1013,681,444,115,329,0.325,0.262,0.169,2461,1273
"1937",136172,2009,1,0,"University of North Florida",NA,NA,2025,1129,896,536,155,381,0.338,0.265,0.173,2547,1506
"1938",136172,2010,1,0,"University of North Florida",NA,NA,1926,1078,848,504,137,367,0.34,0.262,0.162,2930,1480
"1939",136950,1991,1,0,"ROLLINS COLLEGE",NA,NA,401,227,174,233,92,141,0.621,0.581,0.529,13900,328
"1940",136950,1992,1,0,"ROLLINS COLLEGE",NA,NA,394,215,179,194,71,123,0.572,0.492,0.397,14974,327
"1941",136950,1993,1,0,"ROLLINS COLLEGE",NA,NA,377,210,167,195,82,113,0.538,0.517,0.491,15950,315
"1942",136950,1995,1,0,"ROLLINS COLLEGE",NA,NA,412,248,164,250,88,162,0.653,0.607,0.537,17995,331
"1943",136950,1996,1,0,"ROLLINS COLLEGE",NA,NA,418,240,178,194,69,125,0.521,0.464,0.388,19075,292
"1944",136950,1997,1,0,"ROLLINS COLLEGE",NA,NA,415,253,162,192,65,127,0.502,0.463,0.401,20010,287
"1945",136950,1998,1,0,"ROLLINS COLLEGE",NA,NA,458,278,180,232,80,152,0.547,0.507,0.444,20915,364
"1946",136950,1999,1,0,"ROLLINS COLLEGE",NA,NA,448,267,181,220,87,133,0.498,0.491,0.481,21250,338
"1947",136950,2000,1,0,"ROLLINS COLLEGE",NA,NA,425,256,169,252,87,165,0.645,0.593,0.515,22206,300
"1948",136950,2001,1,0,"ROLLINS COLLEGE",NA,NA,473,300,173,278,90,188,0.627,0.588,0.52,23205,360
"1949",136950,2002,1,0,"ROLLINS COLLEGE",NA,NA,466,280,186,278,97,181,0.646,0.597,0.522,24250,369
"1950",136950,2003,1,0,"ROLLINS COLLEGE",NA,NA,496,298,198,291,102,189,0.634,0.587,0.515,25500,368
"1951",136950,2004,1,0,"ROLLINS COLLEGE",NA,NA,486,284,202,285,116,169,0.595,0.586,0.574,26910,341
"1952",136950,2005,1,0,"Rollins College",NA,NA,463,275,188,284,105,179,0.651,0.613,0.559,28390,346
"1953",136950,2006,1,0,"Rollins College",NA,NA,501,287,214,312,119,193,0.672,0.623,0.556,30420,367
"1954",136950,2007,1,0,"Rollins College",NA,NA,525,305,220,319,124,195,0.639,0.608,0.564,32640,407
"1955",136950,2008,1,0,"Rollins College",NA,NA,464,262,202,293,118,175,0.668,0.631,0.584,34520,332
"1956",136950,2009,1,0,"Rollins College",NA,NA,464,287,177,299,103,196,0.683,0.644,0.582,36220,328
"1957",136950,2010,1,0,"Rollins College",NA,NA,465,286,179,298,100,198,0.692,0.641,0.559,37640,308
"1958",137546,1991,1,0,"STETSON UNIVERSITY",NA,NA,460,256,204,237,89,148,0.578,0.515,0.436,10020,410
"1959",137546,1992,1,0,"STETSON UNIVERSITY",NA,NA,501,282,219,232,87,145,0.514,0.463,0.397,11110,419
"1960",137546,1993,1,0,"STETSON UNIVERSITY",NA,NA,481,292,189,238,87,151,0.517,0.495,0.46,11995,403
"1961",137546,1995,1,0,"STETSON UNIVERSITY",NA,NA,464,253,211,228,89,139,0.549,0.491,0.422,13700,397
"1962",137546,1996,1,0,"STETSON UNIVERSITY",NA,NA,416,229,187,211,83,128,0.559,0.507,0.444,14735,351
"1963",137546,1997,1,0,"STETSON UNIVERSITY",NA,NA,504,289,215,283,104,179,0.619,0.562,0.484,15765,442
"1964",137546,1998,1,0,"STETSON UNIVERSITY",NA,NA,539,311,228,279,113,166,0.534,0.518,0.496,16650,461
"1965",137546,1999,1,0,"STETSON UNIVERSITY",NA,NA,548,325,223,312,119,193,0.594,0.569,0.534,16640,461
"1966",137546,2000,1,0,"STETSON UNIVERSITY",NA,NA,502,262,240,265,108,157,0.599,0.528,0.45,17475,424
"1967",137546,2001,1,0,"STETSON UNIVERSITY",NA,NA,527,298,229,289,117,172,0.577,0.548,0.511,18350,421
"1968",137546,2002,1,0,"STETSON UNIVERSITY",NA,NA,542,325,217,299,104,195,0.6,0.552,0.479,19450,448
"1969",137546,2003,1,0,"STETSON UNIVERSITY",NA,NA,523,284,239,260,109,151,0.532,0.497,0.456,20425,456
"1970",137546,2004,1,0,"STETSON UNIVERSITY",NA,NA,598,354,244,303,100,203,0.573,0.507,0.41,22350,474
"1971",137546,2005,1,0,"Stetson University",NA,NA,547,312,235,308,135,173,0.554,0.563,0.574,23750,396
"1972",137546,2006,1,0,"Stetson University",NA,NA,565,338,227,317,113,204,0.604,0.561,0.498,25350,402
"1973",137546,2007,1,0,"Stetson University",NA,NA,557,322,235,314,121,193,0.599,0.564,0.515,27100,430
"1974",137546,2008,1,0,"Stetson University",NA,NA,617,360,257,344,133,211,0.586,0.558,0.518,28456,440
"1975",137546,2009,1,0,"Stetson University",NA,NA,502,273,229,287,124,163,0.597,0.572,0.541,29880,350
"1976",137546,2010,1,0,"Stetson University",NA,NA,545,331,214,305,109,196,0.592,0.56,0.509,31374,375
"1977",138354,1991,1,0,"THE UNIVERSITY OF WEST FLORIDA",NA,NA,380,215,165,40,16,24,0.112,0.105,0.097,1463,315
"1978",138354,1992,1,0,"THE UNIVERSITY OF WEST FLORIDA",NA,NA,396,208,188,70,28,42,0.202,0.177,0.149,1654,335
"1979",138354,1993,1,0,"THE UNIVERSITY OF WEST FLORIDA",NA,NA,438,252,186,68,17,51,0.202,0.155,0.091,1702,347
"1980",138354,1995,1,0,"THE UNIVERSITY OF WEST FLORIDA",NA,NA,509,279,230,101,30,71,0.254,0.198,0.13,1723,393
"1981",138354,1996,1,0,"THE UNIVERSITY OF WEST FLORIDA",NA,NA,459,261,198,107,39,68,0.26,0.233,0.197,1819,369
"1982",138354,1997,1,0,"THE UNIVERSITY OF WEST FLORIDA",NA,NA,620,372,248,101,28,73,0.196,0.163,0.113,1985,500
"1983",138354,1998,1,0,"THE UNIVERSITY OF WEST FLORIDA",NA,NA,647,365,282,136,40,96,0.263,0.21,0.142,2143,515
"1984",138354,1999,1,0,"THE UNIVERSITY OF WEST FLORIDA",NA,NA,637,335,302,132,54,78,0.233,0.207,0.179,2293,515
"1985",138354,2000,1,0,"THE UNIVERSITY OF WEST FLORIDA",NA,NA,629,355,274,117,30,87,0.245,0.186,0.109,1554,513
"1986",138354,2001,1,0,"THE UNIVERSITY OF WEST FLORIDA",NA,NA,695,406,289,167,59,108,0.266,0.24,0.204,1670,543
"1987",138354,2002,1,0,"THE UNIVERSITY OF WEST FLORIDA",NA,NA,760,443,317,172,52,120,0.271,0.226,0.164,1754,614
"1988",138354,2003,1,0,"THE UNIVERSITY OF WEST FLORIDA",NA,NA,816,469,347,169,48,121,0.258,0.207,0.138,1902,652
"1989",138354,2004,1,0,"THE UNIVERSITY OF WEST FLORIDA",NA,NA,859,475,384,168,57,111,0.234,0.196,0.148,2045,690
"1990",138354,2005,1,0,"The University of West Florida",NA,NA,830,490,340,194,65,129,0.263,0.234,0.191,2147,676
"1991",138354,2006,1,0,"The University of West Florida",NA,NA,861,495,366,209,65,144,0.291,0.243,0.178,2211,648
"1992",138354,2007,1,0,"The University of West Florida",NA,NA,912,511,401,184,57,127,0.249,0.202,0.142,2211,699
"1993",138354,2008,1,0,"The University of West Florida",NA,NA,1030,605,425,277,94,183,0.302,0.269,0.221,2460,764
"1994",138354,2009,1,0,"The University of West Florida",NA,NA,1154,643,511,313,91,222,0.345,0.271,0.178,2743,852
"1995",138354,2010,1,0,"The University of West Florida",NA,NA,1211,661,550,325,118,207,0.313,0.268,0.215,3062,878
"1996",138716,1991,0,1,"ALBANY STATE COLLEGE",1998,0,541,292,249,39,7,32,0.11,0.072,0.028,1794,8
"1997",138716,1992,0,1,"ALBANY STATE COLLEGE",1998,0,645,364,281,50,14,36,0.099,0.078,0.05,1731,11
"1998",138716,1993,0,1,"ALBANY STATE COLLEGE",1998,0,649,367,282,47,8,39,0.106,0.072,0.028,1771,7
"1999",138716,1995,0,1,"ALBANY STATE COLLEGE",1998,0,530,291,239,37,10,27,0.093,0.07,0.042,2034,7
"2000",138716,1996,0,1,"ALBANY STATE UNIVERSITY",1998,0,503,281,222,34,10,24,0.085,0.068,0.045,2139,4
"2001",138716,1997,0,1,"ALBANY STATE UNIVERSITY",1998,0,575,359,216,35,9,26,0.072,0.061,0.042,2244,4
"2002",138716,1998,1,0,"ALBANY STATE UNIVERSITY",1998,1,493,313,180,30,10,20,0.064,0.061,0.056,2176,4
"2003",138716,1999,1,0,"ALBANY STATE UNIVERSITY",1998,1,648,424,224,92,23,69,0.163,0.142,0.103,1808,9
"2004",138716,2000,1,0,"ALBANY STATE UNIVERSITY",1998,1,643,431,212,79,14,65,0.151,0.123,0.066,1876,1
"2005",138716,2001,1,0,"ALBANY STATE UNIVERSITY",1998,1,420,266,154,79,17,62,0.233,0.188,0.11,1932,9
"2006",138716,2002,1,0,"ALBANY STATE UNIVERSITY",1998,1,470,300,170,88,22,66,0.22,0.187,0.129,2010,9
"2007",138716,2003,1,0,"ALBANY STATE UNIVERSITY",1998,1,537,322,215,78,21,57,0.177,0.145,0.098,2212,9
"2008",138716,2004,1,0,"ALBANY STATE UNIVERSITY",1998,1,602,399,203,98,22,76,0.19,0.163,0.108,2322,4
"2009",138716,2005,1,0,"Albany State University",1998,1,596,388,208,93,16,77,0.198,0.156,0.077,2438,3
"2010",138716,2006,1,0,"Albany State University",1998,1,702,467,235,74,14,60,0.128,0.105,0.06,2548,5
"2011",138716,2007,1,0,"Albany State University",1998,1,626,401,225,100,17,83,0.207,0.16,0.076,2706,9
"2012",138716,2008,1,0,"Albany State University",1998,1,626,392,234,65,9,56,0.143,0.104,0.038,2838,7
"2013",138716,2009,1,0,"Albany State University",1998,1,745,468,277,66,15,51,0.109,0.089,0.054,3100,6
"2014",138716,2010,1,0,"Albany State University",1998,1,883,542,341,47,13,34,0.063,0.053,0.038,3132,6
"2015",138789,1991,0,1,"ARMSTRONG STATE COLLEGE",1998,0,567,340,227,50,14,36,0.106,0.088,0.062,1467,450
"2016",138789,1992,0,1,"ARMSTRONG STATE COLLEGE",1998,0,496,292,204,25,10,15,0.051,0.05,0.049,1521,381
"2017",138789,1993,0,1,"ARMSTRONG STATE COLLEGE",1998,0,577,353,224,39,7,32,0.091,0.068,0.031,1568,448
"2018",138789,1995,0,1,"ARMSTRONG STATE COLLEGE",1998,0,773,497,276,50,13,37,0.074,0.065,0.047,1719,582
"2019",138789,1996,0,1,"ARMSTRONG ATLANTIC STATE UNIVERSITY",1998,0,805,519,286,60,14,46,0.089,0.075,0.049,1836,575
"2020",138789,1997,0,1,"ARMSTRONG ATLANTIC STATE UNIVERSITY",1998,0,690,470,220,50,7,43,0.092,0.072,0.032,1962,517
"2021",138789,1998,1,0,"ARMSTRONG ATLANTIC STATE UNIVERSITY",1998,1,550,378,172,26,8,18,0.048,0.047,0.047,2020,389
"2022",138789,1999,1,0,"ARMSTRONG ATLANTIC STATE UNIVERSITY",1998,1,602,386,216,35,10,25,0.065,0.058,0.046,1808,449
"2023",138789,2000,1,0,"ARMSTRONG ATLANTIC STATE UNIVERSITY",1998,1,568,327,241,27,9,18,0.055,0.048,0.037,1876,440
"2024",138789,2001,1,0,"ARMSTRONG ATLANTIC STATE UNIVERSITY",1998,1,551,328,223,39,7,32,0.098,0.071,0.031,1932,424
"2025",138789,2002,1,0,"ARMSTRONG ATLANTIC STATE UNIVERSITY",1998,1,581,350,231,48,13,35,0.1,0.083,0.056,2010,422
"2026",138789,2003,1,0,"ARMSTRONG ATLANTIC STATE UNIVERSITY",1998,1,719,433,286,47,8,39,0.09,0.065,0.028,2212,556
"2027",138789,2004,1,0,"ARMSTRONG ATLANTIC STATE UNIVERSITY",1998,1,776,449,327,70,21,49,0.109,0.09,0.064,2212,577
"2028",138789,2005,1,0,"Armstrong Atlantic State University",1998,1,700,453,247,70,14,56,0.124,0.1,0.057,2438,465
"2029",138789,2006,1,0,"Armstrong Atlantic State University",1998,1,757,472,285,63,14,49,0.104,0.083,0.049,2548,490
"2030",138789,2007,1,0,"Armstrong Atlantic State University",1998,1,793,477,316,77,16,61,0.128,0.097,0.051,2706,501
"2031",138789,2008,1,0,"Armstrong Atlantic State University",1998,1,864,511,353,87,23,64,0.125,0.101,0.065,2838,543
"2032",138789,2009,1,0,"Armstrong Atlantic State University",1998,1,1063,611,452,110,20,90,0.147,0.103,0.044,3120,699
"2033",138789,2010,1,0,"Armstrong Atlantic State University",1998,1,1161,685,476,141,41,100,0.146,0.121,0.086,3432,678
"2034",139144,1991,1,0,"BERRY COLLEGE",NA,NA,429,253,176,220,85,135,0.534,0.513,0.483,6990,409
"2035",139144,1992,1,0,"BERRY COLLEGE",NA,NA,425,286,139,191,64,127,0.444,0.449,0.46,7500,402
"2036",139144,1993,1,0,"BERRY COLLEGE",NA,NA,484,306,178,183,57,126,0.412,0.378,0.32,8050,453
"2037",139144,1995,1,0,"BERRY COLLEGE",NA,NA,522,316,206,184,68,116,0.367,0.352,0.33,9216,479
"2038",139144,1996,1,0,"BERRY COLLEGE",NA,NA,539,339,200,252,79,173,0.51,0.468,0.395,9678,510
"2039",139144,1997,1,0,"BERRY COLLEGE",NA,NA,504,332,172,295,99,196,0.59,0.585,0.576,10210,472
"2040",139144,1998,1,0,"BERRY COLLEGE",NA,NA,525,336,189,297,106,191,0.569,0.566,0.561,10900,492
"2041",139144,1999,1,0,"BERRY COLLEGE",NA,NA,401,243,158,197,69,128,0.527,0.491,0.437,11550,385
"2042",139144,2000,1,0,"BERRY COLLEGE",NA,NA,486,321,165,258,84,174,0.542,0.531,0.509,12500,457
"2043",139144,2001,1,0,"BERRY COLLEGE",NA,NA,536,357,179,262,74,188,0.527,0.489,0.413,13450,497
"2044",139144,2002,1,0,"BERRY COLLEGE",NA,NA,565,353,212,276,94,182,0.516,0.488,0.443,14260,516
"2045",139144,2003,1,0,"BERRY COLLEGE",NA,NA,504,321,183,240,76,164,0.511,0.476,0.415,15220,455
"2046",139144,2004,1,0,"BERRY COLLEGE",NA,NA,514,349,165,261,76,185,0.53,0.508,0.461,16240,462
"2047",139144,2005,1,0,"Berry College",NA,NA,513,316,197,226,65,161,0.51,0.441,0.33,17570,456
"2048",139144,2006,1,0,"Berry College",NA,NA,427,302,125,221,56,165,0.546,0.518,0.448,18950,385
"2049",139144,2007,1,0,"Berry College",NA,NA,537,373,164,269,75,194,0.52,0.501,0.457,20570,469
"2050",139144,2008,1,0,"Berry College",NA,NA,448,311,137,243,70,173,0.556,0.542,0.511,22170,371
"2051",139144,2009,1,0,"Berry College",NA,NA,569,402,167,315,85,230,0.572,0.554,0.509,23160,455
"2052",139144,2010,1,0,"Berry College",NA,NA,653,431,222,386,126,260,0.603,0.591,0.568,24420,562
"2053",139366,1991,0,1,"COLUMBUS COLLEGE",1998,0,509,312,197,30,9,21,0.067,0.059,0.046,1482,352
"2054",139366,1992,0,1,"COLUMBUS COLLEGE",1998,0,589,365,224,42,14,28,0.077,0.071,0.062,1545,407
"2055",139366,1993,0,1,"COLUMBUS COLLEGE",1998,0,650,401,249,59,20,39,0.097,0.091,0.08,1600,416
"2056",139366,1995,0,1,"COLUMBUS STATE UNIVERSITY",1998,0,633,390,243,54,17,37,0.095,0.085,0.07,1740,435
"2057",139366,1996,0,1,"COLUMBUS STATE UNIVERSITY",1998,0,616,383,233,43,10,33,0.086,0.07,0.043,1845,386
"2058",139366,1997,0,1,"COLUMBUS STATE UNIVERSITY",1998,0,612,354,258,53,14,39,0.11,0.087,0.054,1941,420
"2059",139366,1998,1,0,"COLUMBUS STATE UNIVERSITY",1998,1,723,450,273,63,17,46,0.102,0.087,0.062,2020,493
"2060",139366,1999,1,0,"COLUMBUS STATE UNIVERSITY",1998,1,672,412,260,54,13,41,0.099,0.08,0.05,1808,495
"2061",139366,2000,1,0,"COLUMBUS STATE UNIVERSITY",1998,1,759,468,291,87,24,63,0.135,0.115,0.082,1876,492
"2062",139366,2001,1,0,"COLUMBUS STATE UNIVERSITY",1998,1,761,468,293,84,20,64,0.137,0.11,0.068,1932,518
"2063",139366,2002,1,0,"COLUMBUS STATE UNIVERSITY",1998,1,943,548,395,91,18,73,0.133,0.097,0.046,2010,611
"2064",139366,2003,1,0,"COLUMBUS STATE UNIVERSITY",1998,1,1037,619,418,114,32,82,0.132,0.11,0.077,2212,631
"2065",139366,2004,1,0,"COLUMBUS STATE UNIVERSITY",1998,1,972,584,388,116,31,85,0.146,0.119,0.08,2322,606
"2066",139366,2005,1,0,"Columbus State University",1998,1,1067,641,426,129,33,96,0.15,0.121,0.077,2438,657
"2067",139366,2006,1,0,"Columbus State University",1998,1,1054,640,414,139,37,102,0.159,0.132,0.089,2548,611
"2068",139366,2007,1,0,"Columbus State University",1998,1,996,568,428,117,29,88,0.155,0.117,0.068,2706,599
"2069",139366,2008,1,0,"Columbus State University",1998,1,1114,642,472,131,38,93,0.145,0.118,0.081,2838,627
"2070",139366,2009,1,0,"Columbus State University",1998,1,1231,734,497,138,43,95,0.129,0.112,0.087,3100,653
"2071",139366,2010,1,0,"Columbus State University",1998,1,1154,718,436,130,43,87,0.121,0.113,0.099,3281,606
"2072",139393,1991,1,0,"COVENANT COLLEGE",NA,NA,136,73,63,56,21,35,0.48,0.412,0.333,7900,133
"2073",139393,1992,1,0,"COVENANT COLLEGE",NA,NA,155,98,57,56,18,38,0.388,0.361,0.316,8550,147
"2074",139393,1993,1,0,"COVENANT COLLEGE",NA,NA,168,93,75,75,31,44,0.473,0.446,0.413,9200,159
"2075",139393,1995,1,0,"COVENANT COLLEGE",NA,NA,155,90,65,75,33,42,0.467,0.484,0.508,10920,142
"2076",139393,1996,1,0,"COVENANT COLLEGE",NA,NA,206,119,87,109,43,66,0.555,0.529,0.494,11780,192
"2077",139393,1997,1,0,"COVENANT COLLEGE",NA,NA,197,112,85,89,31,58,0.518,0.452,0.365,12900,183
"2078",139393,1998,1,0,"COVENANT COLLEGE",NA,NA,211,134,77,112,36,76,0.567,0.531,0.468,13750,196
"2079",139393,1999,1,0,"COVENANT COLLEGE",NA,NA,228,144,84,124,45,79,0.549,0.544,0.536,14400,208
"2080",139393,2000,1,0,"COVENANT COLLEGE",NA,NA,206,117,89,107,47,60,0.513,0.519,0.528,15600,191
"2081",139393,2001,1,0,"COVENANT COLLEGE",NA,NA,238,151,87,120,41,79,0.523,0.504,0.471,16590,216
"2082",139393,2002,1,0,"COVENANT COLLEGE",NA,NA,231,141,90,129,44,85,0.603,0.558,0.489,17750,209
"2083",139393,2003,1,0,"COVENANT COLLEGE",NA,NA,236,146,90,108,32,76,0.52,0.458,0.356,17750,214
"2084",139393,2004,1,0,"COVENANT COLLEGE",NA,NA,260,156,104,123,41,82,0.526,0.473,0.394,18750,243
"2085",139393,2005,1,0,"Covenant College",NA,NA,270,138,132,122,48,74,0.536,0.452,0.364,20100,241
"2086",139393,2006,1,0,"Covenant College",NA,NA,297,166,131,163,62,101,0.608,0.549,0.473,21100,265
"2087",139393,2007,1,0,"Covenant College",NA,NA,291,163,128,139,51,88,0.54,0.478,0.398,22160,258
"2088",139393,2008,1,0,"Covenant College",NA,NA,267,149,118,129,51,78,0.524,0.483,0.432,23600,240
"2089",139393,2009,1,0,"Covenant College",NA,NA,277,158,119,139,48,91,0.576,0.502,0.403,24520,252
"2090",139393,2010,1,0,"Covenant College",NA,NA,269,131,138,160,66,94,0.718,0.595,0.478,25476,233
"2091",139658,1991,1,0,"EMORY UNIVERSITY",NA,NA,1415,772,643,950,430,520,0.674,0.671,0.669,14580,1110
"2092",139658,1992,1,0,"EMORY UNIVERSITY",NA,NA,1478,872,606,1010,406,604,0.693,0.683,0.67,15600,1078
"2093",139658,1993,1,0,"EMORY UNIVERSITY",NA,NA,1406,762,644,999,458,541,0.71,0.711,0.711,16820,1037
"2094",139658,1995,1,0,"EMORY UNIVERSITY",NA,NA,1587,896,691,1093,441,652,0.728,0.689,0.638,19000,1146
"2095",139658,1996,1,0,"EMORY UNIVERSITY",NA,NA,1508,867,641,1076,438,638,0.736,0.714,0.683,19870,1058
"2096",139658,1997,1,0,"EMORY UNIVERSITY",NA,NA,1477,762,715,1120,525,595,0.781,0.758,0.734,21110,1011
"2097",139658,1998,1,0,"EMORY UNIVERSITY",NA,NA,1692,908,784,1227,548,679,0.748,0.725,0.699,21870,1152
"2098",139658,1999,1,0,"EMORY UNIVERSITY",NA,NA,1515,870,645,1148,486,662,0.761,0.758,0.753,22870,1018
"2099",139658,2000,1,0,"EMORY UNIVERSITY",NA,NA,1532,831,701,936,420,516,0.621,0.611,0.599,24240,1021
"2100",139658,2001,1,0,"EMORY UNIVERSITY",NA,NA,1547,817,730,1013,486,527,0.645,0.655,0.666,25240,979
"2101",139658,2002,1,0,"EMORY UNIVERSITY",NA,NA,1558,903,655,1061,444,617,0.683,0.681,0.678,26600,995
"2102",139658,2003,1,0,"EMORY UNIVERSITY",NA,NA,1595,895,700,1060,453,607,0.678,0.665,0.647,27600,950
"2103",139658,2004,1,0,"EMORY UNIVERSITY",NA,NA,1587,911,676,1044,436,608,0.667,0.658,0.645,28940,959
"2104",139658,2005,1,0,"Emory University",NA,NA,1631,933,698,1032,450,582,0.624,0.633,0.645,30400,931
"2105",139658,2006,1,0,"Emory University",NA,NA,1648,938,710,1108,477,631,0.673,0.672,0.672,32100,882
"2106",139658,2007,1,0,"Emory University",NA,NA,1597,863,734,1027,477,550,0.637,0.643,0.65,33900,791
"2107",139658,2008,1,0,"Emory University",NA,NA,1661,893,768,1064,501,563,0.63,0.641,0.652,35800,785
"2108",139658,2009,1,0,"Emory University",NA,NA,1287,712,575,1067,448,619,0.869,0.829,0.779,37500,537
"2109",139658,2010,1,0,"Emory University",NA,NA,1321,748,573,1125,462,663,0.886,0.852,0.806,38600,593
"2110",139719,1991,0,1,"FORT VALLEY STATE COLLEGE",1998,0,464,276,188,48,22,26,0.094,0.103,0.117,1650,7
"2111",139719,1992,0,1,"FORT VALLEY STATE COLLEGE",1998,0,497,264,233,52,18,34,0.129,0.105,0.077,1650,1
"2112",139719,1993,0,1,"FORT VALLEY STATE COLLEGE",1998,0,539,290,249,27,3,24,0.083,0.05,0.012,1775,7
"2113",139719,1995,0,1,"FORT VALLEY STATE UNIVERSITY",1998,0,522,261,261,38,8,30,0.115,0.073,0.031,1920,5
"2114",139719,1996,0,1,"FORT VALLEY STATE UNIVERSITY",1998,0,573,307,266,48,6,42,0.137,0.084,0.023,2040,4
"2115",139719,1997,0,1,"FORT VALLEY STATE UNIVERSITY",1998,0,502,270,232,75,19,56,0.207,0.149,0.082,2157,5
"2116",139719,1998,1,0,"FORT VALLEY STATE UNIVERSITY",1998,1,432,240,192,40,11,29,0.121,0.093,0.057,2216,4
"2117",139719,1999,1,0,"FORT VALLEY STATE UNIVERSITY",1998,1,406,206,200,36,9,27,0.131,0.089,0.045,1808,2
"2118",139719,2000,1,0,"FORT VALLEY STATE UNIVERSITY",1998,1,360,195,165,48,14,34,0.174,0.133,0.085,1876,7
"2119",139719,2001,1,0,"FORT VALLEY STATE UNIVERSITY",1998,1,425,225,200,60,16,44,0.196,0.141,0.08,1932,3
"2120",139719,2002,1,0,"FORT VALLEY STATE UNIVERSITY",1998,1,386,192,194,59,12,47,0.245,0.153,0.062,2580,3
"2121",139719,2003,1,0,"FORT VALLEY STATE UNIVERSITY",1998,1,496,260,236,64,17,47,0.181,0.129,0.072,2212,2
"2122",139719,2004,1,0,"FORT VALLEY STATE UNIVERSITY",1998,1,456,227,229,66,18,48,0.212,0.145,0.079,2322,7
"2123",139719,2005,1,0,"Fort Valley State University",1998,1,317,169,148,48,11,37,0.219,0.151,0.074,2438,2
"2124",139719,2006,1,0,"Fort Valley State University",1998,1,486,253,233,51,9,42,0.166,0.105,0.039,2548,2
"2125",139719,2007,1,0,"Fort Valley State University",1998,1,716,386,330,56,12,44,0.114,0.078,0.036,2706,2
"2126",139719,2008,1,0,"Fort Valley State University",1998,1,1074,568,506,117,32,85,0.15,0.109,0.063,2868,9
"2127",139719,2009,1,0,"Fort Valley State University",1998,1,984,550,434,118,26,92,0.167,0.12,0.06,3874,7
"2128",139719,2010,1,0,"Fort Valley State University",1998,1,840,487,353,69,26,43,0.088,0.082,0.074,4274,6
"2129",139755,1991,0,1,"GEORGIA INSTITUTE OF TECHNOLOGY MAIN CAMPUS",1999,0,1750,415,1335,484,335,149,0.359,0.277,0.251,2118,1383
"2130",139755,1992,0,1,"GEORGIA INSTITUTE OF TECHNOLOGY MAIN CAMPUS",1999,0,1691,467,1224,472,298,174,0.373,0.279,0.243,2205,1363
"2131",139755,1993,0,1,"GEORGIA INSTITUTE OF TECHNOLOGY MAIN CAMPUS",1999,0,1963,484,1479,398,252,146,0.302,0.203,0.17,2277,1529
"2132",139755,1995,0,1,"GEORGIA INSTITUTE OF TECHNOLOGY MAIN CAMPUS",1999,0,2120,600,1520,451,271,180,0.3,0.213,0.178,2457,1612
"2133",139755,1996,0,1,"GEORGIA INSTITUTE OF TECHNOLOGY MAIN CAMPUS",1999,0,2120,596,1524,484,288,196,0.329,0.228,0.189,2685,1667
"2134",139755,1997,0,1,"GEORGIA INSTITUTE OF TECHNOLOGY-MAIN CAMPUS",1999,0,2069,565,1504,487,305,182,0.322,0.235,0.203,2901,1600
"2135",139755,1998,0,1,"GEORGIA INSTITUTE OF TECHNOLOGY-MAIN CAMPUS",1999,0,2487,721,1766,644,371,273,0.379,0.259,0.21,2991,1799
"2136",139755,1999,1,0,"GEORGIA INSTITUTE OF TECHNOLOGY-MAIN CAMPUS",1999,1,2293,654,1639,657,431,226,0.346,0.287,0.263,2414,1683
"2137",139755,2000,1,0,"GEORGIA INSTITUTE OF TECHNOLOGY-MAIN CAMPUS",1999,1,2242,640,1602,760,470,290,0.453,0.339,0.293,2506,1633
"2138",139755,2001,1,0,"GEORGIA INSTITUTE OF TECHNOLOGY-MAIN CAMPUS",1999,1,2223,634,1589,736,441,295,0.465,0.331,0.278,2632,1625
"2139",139755,2002,1,0,"GEORGIA INSTITUTE OF TECHNOLOGY-MAIN CAMPUS",1999,1,2275,636,1639,711,445,266,0.418,0.313,0.272,2790,1662
"2140",139755,2003,1,0,"GEORGIA INSTITUTE OF TECHNOLOGY-MAIN CAMPUS",1999,1,2224,607,1617,683,427,256,0.422,0.307,0.264,3208,1579
"2141",139755,2004,1,0,"GEORGIA INSTITUTE OF TECHNOLOGY-MAIN CAMPUS",1999,1,2572,766,1806,845,514,331,0.432,0.329,0.285,3368,1812
"2142",139755,2005,1,0,"Georgia Institute of Technology-Main Campus",1999,1,2415,714,1701,756,431,325,0.455,0.313,0.253,3638,1716
"2143",139755,2006,1,0,"Georgia Institute of Technology-Main Campus",1999,1,2838,890,1948,953,548,405,0.455,0.336,0.281,3892,1912
"2144",139755,2007,1,0,"Georgia Institute of Technology-Main Campus",1999,1,2622,854,1768,1072,645,427,0.5,0.409,0.365,4159,1702
"2145",139755,2008,1,0,"Georgia Institute of Technology-Main Campus",1999,1,2633,838,1795,974,604,370,0.442,0.37,0.336,4395,1674
"2146",139755,2009,1,0,"Georgia Institute of Technology-Main Campus",1999,1,2654,887,1767,1064,638,426,0.48,0.401,0.361,4829,1558
"2147",139755,2010,1,0,"Georgia Institute of Technology-Main Campus",1999,1,2706,976,1730,1111,648,463,0.474,0.411,0.375,5873,1625
"2148",139764,1991,0,1,"GEORGIA SOUTHWESTERN COLLEGE",1998,0,322,190,132,70,35,35,0.184,0.217,0.265,1578,241
"2149",139764,1992,0,1,"GEORGIA SOUTHWESTERN COLLEGE",1998,0,375,243,132,75,28,47,0.193,0.2,0.212,1650,283
"2150",139764,1993,0,1,"GEORGIA SOUTHWESTERN COLLEGE",1998,0,349,226,123,38,6,32,0.142,0.109,0.049,1680,271
"2151",139764,1995,0,1,"GEORGIA SOUTHWESTERN STATE UNIVERSITY",1998,0,328,211,117,26,3,23,0.109,0.079,0.026,1898,200
"2152",139764,1996,0,1,"GEORGIA SOUTHWESTERN STATE UNIVERSITY",1998,0,315,199,116,43,10,33,0.166,0.137,0.086,2067,206
"2153",139764,1997,0,1,"GEORGIA SOUTHWESTERN STATE UNIVERSITY",1998,0,449,283,166,85,29,56,0.198,0.189,0.175,2145,306
"2154",139764,1998,1,0,"GEORGIA SOUTHWESTERN STATE UNIVERSITY",1998,1,335,215,120,41,5,36,0.167,0.122,0.042,2199,242
"2155",139764,1999,1,0,"GEORGIA SOUTHWESTERN STATE UNIVERSITY",1998,1,259,161,98,42,14,28,0.174,0.162,0.143,1808,175
"2156",139764,2000,1,0,"GEORGIA SOUTHWESTERN STATE UNIVERSITY",1998,1,308,202,106,44,15,29,0.144,0.143,0.142,1876,228
"2157",139764,2001,1,0,"GEORGIA SOUTHWESTERN STATE UNIVERSITY",1998,1,266,173,93,31,8,23,0.133,0.117,0.086,1932,193
"2158",139764,2002,1,0,"GEORGIA SOUTHWESTERN STATE UNIVERSITY",1998,1,331,216,115,46,15,31,0.144,0.139,0.13,2010,215
"2159",139764,2003,1,0,"GEORGIA SOUTHWESTERN STATE UNIVERSITY",1998,1,326,222,104,48,13,35,0.158,0.147,0.125,2212,166
"2160",139764,2004,1,0,"GEORGIA SOUTHWESTERN STATE UNIVERSITY",1998,1,359,247,112,40,6,34,0.138,0.111,0.054,2322,210
"2161",139764,2005,1,0,"Georgia Southwestern State University",1998,1,358,200,158,36,9,27,0.135,0.101,0.057,2438,213
"2162",139764,2006,1,0,"Georgia Southwestern State University",1998,1,399,236,163,52,11,41,0.174,0.13,0.067,2548,222
"2163",139764,2007,1,0,"Georgia Southwestern State University",1998,1,388,252,136,59,16,43,0.171,0.152,0.118,2706,244
"2164",139764,2008,1,0,"Georgia Southwestern State University",1998,1,418,240,178,42,16,26,0.108,0.1,0.09,2838,237
"2165",139764,2009,1,0,"Georgia Southwestern State University",1998,1,435,251,184,49,16,33,0.132,0.113,0.087,2907,257
"2166",139764,2010,1,0,"Georgia Southwestern State University",1998,1,473,284,189,64,13,51,0.18,0.135,0.069,3133,298
"2167",139861,1991,0,1,"GEORGIA COLLEGE",1998,0,770,476,294,126,35,91,0.191,0.164,0.119,1563,605
"2168",139861,1992,0,1,"GEORGIA COLLEGE",1998,0,754,451,303,112,23,89,0.197,0.149,0.076,1632,582
"2169",139861,1993,0,1,"GEORGIA COLLEGE",1998,0,809,520,289,122,18,104,0.2,0.151,0.062,1693,589
"2170",139861,1995,0,1,"GEORGIA COLLEGE",1998,0,754,467,287,123,28,95,0.203,0.163,0.098,1820,624
"2171",139861,1996,0,1,"GEORGIA COLLEGE AND STATE UNIVERSITY",1998,0,715,483,232,119,23,96,0.199,0.166,0.099,1923,603
"2172",139861,1997,0,1,"GEORGIA COLLEGE AND STATE UNIVERSITY",1998,0,818,528,290,130,31,99,0.188,0.159,0.107,2064,702
"2173",139861,1998,1,0,"GEORGIA COLLEGE AND STATE UNIVERSITY",1998,1,750,470,280,127,22,105,0.223,0.169,0.079,2136,654
"2174",139861,1999,1,0,"GEORGIA COLLEGE AND STATE UNIVERSITY",1998,1,786,486,300,164,36,128,0.263,0.209,0.12,1808,709
"2175",139861,2000,1,0,"GEORGIA COLLEGE AND STATE UNIVERSITY",1998,1,820,506,314,189,41,148,0.292,0.23,0.131,1876,707
"2176",139861,2001,1,0,"GEORGIA COLLEGE AND STATE UNIVERSITY",1998,1,879,556,323,203,52,151,0.272,0.231,0.161,2532,791
"2177",139861,2002,1,0,"GEORGIA COLLEGE AND STATE UNIVERSITY",1998,1,984,612,372,199,45,154,0.252,0.202,0.121,2610,903
"2178",139861,2003,1,0,"GEORGIA COLLEGE AND STATE UNIVERSITY",1998,1,1027,611,416,254,69,185,0.303,0.247,0.166,3002,944
"2179",139861,2004,1,0,"GEORGIA COLLEGE AND STATE UNIVERSITY",1998,1,918,582,336,322,90,232,0.399,0.351,0.268,3152,841
"2180",139861,2005,1,0,"Georgia College and State University",1998,1,1032,631,401,342,101,241,0.382,0.331,0.252,3404,941
"2181",139861,2006,1,0,"Georgia College & State University",1998,1,1137,707,430,403,101,302,0.427,0.354,0.235,3608,1009
"2182",139861,2007,1,0,"Georgia College & State University",1998,1,1197,778,419,464,124,340,0.437,0.388,0.296,3892,1077
"2183",139861,2008,1,0,"Georgia College & State University",1998,1,1177,751,426,470,136,334,0.445,0.399,0.319,4113,1015
"2184",139861,2009,1,0,"Georgia College & State University",1998,1,1206,741,465,476,138,338,0.456,0.395,0.297,4520,1047
"2185",139861,2010,1,0,"Georgia College & State University",1998,1,1202,767,435,505,138,367,0.479,0.42,0.317,5013,1001
"2186",139931,1991,0,1,"GEORGIA SOUTHERN UNIVERSITY",1998,0,2737,1457,1280,508,172,336,0.231,0.186,0.134,1620,2145
"2187",139931,1992,0,1,"GEORGIA SOUTHERN UNIVERSITY",1998,0,2828,1530,1298,506,174,332,0.217,0.179,0.134,1638,2046
"2188",139931,1993,0,1,"GEORGIA SOUTHERN UNIVERSITY",1998,0,2955,1602,1353,540,158,382,0.239,0.183,0.117,1807,2032
"2189",139931,1995,0,1,"GEORGIA SOUTHERN UNIVERSITY",1998,0,3193,1825,1368,407,112,295,0.162,0.127,0.082,1965,2175
"2190",139931,1996,0,1,"GEORGIA SOUTHERN UNIVERSITY",1998,0,3159,1699,1460,385,115,270,0.159,0.122,0.079,2055,2196
"2191",139931,1997,0,1,"GEORGIA SOUTHERN UNIVERSITY",1998,0,2596,1387,1209,306,81,225,0.162,0.118,0.067,2256,1883
"2192",139931,1998,1,0,"GEORGIA SOUTHERN UNIVERSITY",1998,1,2897,1549,1348,335,87,248,0.16,0.116,0.065,2349,1973
"2193",139931,1999,1,0,"GEORGIA SOUTHERN UNIVERSITY",1998,1,3266,1729,1537,384,98,286,0.165,0.118,0.064,1808,2218
"2194",139931,2000,1,0,"GEORGIA SOUTHERN UNIVERSITY",1998,1,2859,1481,1378,379,105,274,0.185,0.133,0.076,1876,2004
"2195",139931,2001,1,0,"GEORGIA SOUTHERN UNIVERSITY",1998,1,2632,1278,1354,435,110,325,0.254,0.165,0.081,1932,1939
"2196",139931,2002,1,0,"GEORGIA SOUTHERN UNIVERSITY",1998,1,2597,1232,1365,434,138,296,0.24,0.167,0.101,2010,1976
"2197",139931,2003,1,0,"GEORGIA SOUTHERN UNIVERSITY",1998,1,2735,1305,1430,466,145,321,0.246,0.17,0.101,2212,2090
"2198",139931,2004,1,0,"GEORGIA SOUTHERN UNIVERSITY",1998,1,2982,1393,1589,546,158,388,0.278,0.183,0.099,2322,2248
"2199",139931,2005,1,0,"Georgia Southern University",1998,1,3123,1472,1651,623,195,428,0.291,0.199,0.118,2438,2303
"2200",139931,2006,1,0,"Georgia Southern University",1998,1,2731,1294,1437,617,214,403,0.311,0.226,0.149,2548,2084
"2201",139931,2007,1,0,"Georgia Southern University",1998,1,3028,1402,1626,773,287,486,0.347,0.255,0.177,2744,1317
"2202",139931,2008,1,0,"Georgia Southern University",1998,1,3106,1453,1653,828,300,528,0.363,0.267,0.181,2898,2175
"2203",139931,2009,1,0,"Georgia Southern University",1998,1,3490,1683,1807,854,292,562,0.334,0.245,0.162,3178,2416
"2204",139931,2010,1,0,"Georgia Southern University",1998,1,3597,1785,1812,950,305,645,0.361,0.264,0.168,3283,2339
"2205",139940,1991,0,1,"GEORGIA STATE UNIVERSITY",1998,0,1007,598,409,103,34,69,0.115,0.102,0.083,1884,652
"2206",139940,1992,0,1,"GEORGIA STATE UNIVERSITY",1998,0,998,574,424,96,36,60,0.104,0.096,0.085,1952,639
"2207",139940,1993,0,1,"GEORGIA STATE UNIVERSITY",1998,0,1072,613,459,119,33,86,0.14,0.111,0.072,2019,622
"2208",139940,1995,0,1,"GEORGIA STATE UNIVERSITY",1998,0,1276,750,526,127,51,76,0.101,0.1,0.097,2249,626
"2209",139940,1996,0,1,"GEORGIA STATE UNIVERSITY",1998,0,1551,985,566,211,58,153,0.155,0.136,0.102,2385,779
"2210",139940,1997,0,1,"GEORGIA STATE UNIVERSITY",1998,0,1906,1172,734,211,60,151,0.129,0.111,0.082,2673,979
"2211",139940,1998,1,0,"GEORGIA STATE UNIVERSITY",1998,1,1491,924,567,208,63,145,0.157,0.14,0.111,2778,831
"2212",139940,1999,1,0,"GEORGIA STATE UNIVERSITY",1998,1,1772,1082,690,242,69,173,0.16,0.137,0.1,2414,1002
"2213",139940,2000,1,0,"GEORGIA STATE UNIVERSITY",1998,1,2061,1233,828,303,85,218,0.177,0.147,0.103,2506,1048
"2214",139940,2001,1,0,"GEORGIA STATE UNIVERSITY",1998,1,2136,1305,831,357,99,258,0.198,0.167,0.119,2632,1006
"2215",139940,2002,1,0,"GEORGIA STATE UNIVERSITY",1998,1,2469,1419,1050,423,107,316,0.223,0.171,0.102,2790,1208
"2216",139940,2003,1,0,"GEORGIA STATE UNIVERSITY",1998,1,1920,1159,761,349,114,235,0.203,0.182,0.15,3208,956
"2217",139940,2004,1,0,"GEORGIA STATE UNIVERSITY",1998,1,2272,1338,934,389,132,257,0.192,0.171,0.141,3368,1111
"2218",139940,2005,1,0,"Georgia State University",1998,1,2325,1322,1003,408,164,244,0.185,0.175,0.164,3638,1018
"2219",139940,2006,1,0,"Georgia State University",1998,1,2174,1313,861,439,135,304,0.231,0.202,0.157,3856,940
"2220",139940,2007,1,0,"Georgia State University",1998,1,2521,1486,1035,540,154,386,0.26,0.214,0.149,4159,1005
"2221",139940,2008,1,0,"Georgia State University",1998,1,2743,1609,1134,614,206,408,0.254,0.224,0.182,4856,732
"2222",139940,2009,1,0,"Georgia State University",1998,1,2937,1745,1192,702,233,469,0.269,0.239,0.195,6070,1095
"2223",139940,2010,1,0,"Georgia State University",1998,1,2853,1540,1313,669,240,429,0.279,0.234,0.183,7070,998
"2224",139959,1991,0,1,"UNIVERSITY OF GEORGIA",1998,0,3408,1927,1481,1191,429,762,0.395,0.349,0.29,2076,2931
"2225",139959,1992,0,1,"UNIVERSITY OF GEORGIA",1998,0,3147,1823,1324,1456,521,935,0.513,0.463,0.394,2175,2697
"2226",139959,1993,0,1,"UNIVERSITY OF GEORGIA",1998,0,3808,2115,1693,1617,630,987,0.467,0.425,0.372,2250,3324
"2227",139959,1995,0,1,"UNIVERSITY OF GEORGIA",1998,0,3996,2376,1620,1702,570,1132,0.476,0.426,0.352,2542,3379
"2228",139959,1996,0,1,"UNIVERSITY OF GEORGIA",1998,0,3671,2184,1487,1546,494,1052,0.482,0.421,0.332,2694,3239
"2229",139959,1997,0,1,"UNIVERSITY OF GEORGIA",1998,0,4348,2544,1804,1729,569,1160,0.456,0.398,0.315,2838,3856
"2230",139959,1998,1,0,"UNIVERSITY OF GEORGIA",1998,1,4384,2588,1796,1771,535,1236,0.478,0.404,0.298,2930,3855
"2231",139959,1999,1,0,"UNIVERSITY OF GEORGIA",1998,1,4375,2586,1789,1860,592,1268,0.49,0.425,0.331,2414,3842
"2232",139959,2000,1,0,"UNIVERSITY OF GEORGIA",1998,1,4207,2556,1651,1911,584,1327,0.519,0.454,0.354,2506,3669
"2233",139959,2001,1,0,"UNIVERSITY OF GEORGIA",1998,1,4459,2646,1813,2137,677,1460,0.552,0.479,0.373,2632,3950
"2234",139959,2002,1,0,"UNIVERSITY OF GEORGIA",1998,1,4282,2570,1712,2155,713,1442,0.561,0.503,0.416,2790,3752
"2235",139959,2003,1,0,"UNIVERSITY OF GEORGIA",1998,1,5157,3146,2011,2535,807,1728,0.549,0.492,0.401,3208,4469
"2236",139959,2004,1,0,"UNIVERSITY OF GEORGIA",1998,1,4500,2724,1776,2335,774,1561,0.573,0.519,0.436,3368,3918
"2237",139959,2005,1,0,"University of Georgia",1998,1,4654,2812,1842,2505,845,1660,0.59,0.538,0.459,3638,3697
"2238",139959,2006,1,0,"University of Georgia",1998,1,5059,3161,1898,2732,900,1832,0.58,0.54,0.474,3856,4018
"2239",139959,2007,1,0,"University of Georgia",1998,1,4675,2942,1733,2655,853,1802,0.613,0.568,0.492,4159,3741
"2240",139959,2008,1,0,"University of Georgia",1998,1,4778,3013,1765,2853,924,1929,0.64,0.597,0.524,4395,3759
"2241",139959,2009,1,0,"University of Georgia",1998,1,4675,2862,1813,2881,951,1930,0.674,0.616,0.525,4828,3610
"2242",139959,2010,1,0,"University of Georgia",1998,1,4667,2886,1781,2903,961,1942,0.673,0.622,0.54,5873,3345
"2243",140447,1991,0,1,"MERCER UNIVERSITY",1998,0,670,347,323,230,100,130,0.375,0.343,0.31,9450,544
"2244",140447,1992,0,1,"MERCER UNIVERSITY",1998,0,579,349,230,158,45,113,0.324,0.273,0.196,10287,428
"2245",140447,1993,0,1,"MERCER UNIVERSITY",1998,0,639,378,261,243,85,158,0.418,0.38,0.326,11160,480
"2246",140447,1995,0,1,"MERCER UNIVERSITY",1998,0,630,381,249,199,65,134,0.352,0.316,0.261,12987,439
"2247",140447,1996,0,1,"MERCER UNIVERSITY",1998,0,681,432,249,228,63,165,0.382,0.335,0.253,13896,487
"2248",140447,1997,0,1,"MERCER UNIVERSITY",1998,0,679,428,251,215,70,145,0.339,0.317,0.279,14656,456
"2249",140447,1998,1,0,"MERCER UNIVERSITY",1998,1,706,428,278,221,74,147,0.344,0.313,0.266,15465,490
"2250",140447,1999,1,0,"MERCER UNIVERSITY",1998,1,730,449,281,254,79,175,0.39,0.348,0.281,16290,457
"2251",140447,2000,1,0,"MERCER UNIVERSITY",1998,1,733,438,295,223,71,152,0.347,0.304,0.241,17028,444
"2252",140447,2001,1,0,"MERCER UNIVERSITY",1998,1,767,472,295,257,73,184,0.39,0.335,0.247,18290,567
"2253",140447,2002,1,0,"MERCER UNIVERSITY",1998,1,687,387,300,275,93,182,0.47,0.4,0.31,19728,500
"2254",140447,2003,1,0,"MERCER UNIVERSITY",1998,1,663,381,282,292,88,204,0.535,0.44,0.312,20796,478
"2255",140447,2004,1,0,"MERCER UNIVERSITY",1998,1,632,373,259,270,90,180,0.483,0.427,0.347,22050,447
"2256",140447,2005,1,0,"Mercer University",1998,1,666,408,258,267,86,181,0.444,0.401,0.333,23460,461
"2257",140447,2006,1,0,"Mercer University",1998,1,582,300,282,253,98,155,0.517,0.435,0.348,25056,391
"2258",140447,2007,1,0,"Mercer University",1998,1,602,337,265,265,87,178,0.528,0.44,0.328,26760,352
"2259",140447,2008,1,0,"Mercer University",1998,1,615,365,250,298,94,204,0.559,0.485,0.376,28500,387
"2260",140447,2009,1,0,"Mercer University",1998,1,628,349,279,294,108,186,0.533,0.468,0.387,29340,374
"2261",140447,2010,1,0,"Mercer University",1998,1,596,301,295,293,116,177,0.588,0.492,0.393,30360,368
"2262",140960,1991,0,1,"SAVANNAH STATE COLLEGE",1998,0,737,394,343,75,28,47,0.119,0.102,0.082,1635,7
"2263",140960,1992,0,1,"SAVANNAH STATE COLLEGE",1998,0,636,346,290,50,15,35,0.101,0.079,0.052,1686,10
"2264",140960,1993,0,1,"SAVANNAH STATE COLLEGE",1998,0,760,391,369,48,15,33,0.084,0.063,0.041,1741,9
"2265",140960,1995,0,1,"SAVANNAH STATE UNIVERSITY",1998,0,676,358,318,25,2,23,0.064,0.037,0.006,1965,13
"2266",140960,1996,0,1,"SAVANNAH STATE UNIVERSITY",1998,0,483,268,215,13,3,10,0.037,0.027,0.014,2130,6
"2267",140960,1997,0,1,"SAVANNAH STATE UNIVERSITY",1998,0,455,240,215,19,4,15,0.062,0.042,0.019,2226,8
"2268",140960,1998,1,0,"SAVANNAH STATE UNIVERSITY",1998,1,321,179,142,23,5,18,0.101,0.072,0.035,2278,6
"2269",140960,1999,1,0,"SAVANNAH STATE UNIVERSITY",1998,1,281,150,131,18,4,14,0.093,0.064,0.031,1808,10
"2270",140960,2000,1,0,"SAVANNAH STATE UNIVERSITY",1998,1,370,195,175,35,7,28,0.144,0.095,0.04,1826,16
"2271",140960,2001,1,0,"SAVANNAH STATE UNIVERSITY",1998,1,440,238,202,58,13,45,0.189,0.132,0.064,1932,10
"2272",140960,2002,1,0,"SAVANNAH STATE UNIVERSITY",1998,1,496,269,227,52,7,45,0.167,0.105,0.031,2010,3
"2273",140960,2003,1,0,"SAVANNAH STATE UNIVERSITY",1998,1,607,354,253,76,12,64,0.181,0.125,0.047,2212,7
"2274",140960,2004,1,0,"SAVANNAH STATE UNIVERSITY",1998,1,568,316,252,73,22,51,0.161,0.129,0.087,2322,12
"2275",140960,2005,1,0,"Savannah State University",1998,1,806,427,379,73,16,57,0.134,0.091,0.042,2438,14
"2276",140960,2006,1,0,"Savannah State University",1998,1,697,377,320,60,12,48,0.127,0.086,0.038,2548,9
"2277",140960,2007,1,0,"Savannah State University",1998,1,612,343,269,51,10,41,0.12,0.083,0.037,2706,8
"2278",140960,2008,1,0,"Savannah State University",1998,1,905,490,415,71,22,49,0.1,0.078,0.053,3098,8
"2279",140960,2009,1,0,"Savannah State University",1998,1,866,448,418,68,18,50,0.112,0.079,0.043,3100,16
"2280",140960,2010,1,0,"Savannah State University",1998,1,953,504,449,81,19,62,0.123,0.085,0.042,4274,35
"2281",140988,1991,1,0,"SHORTER COLLEGE",NA,NA,139,96,43,59,18,41,0.427,0.424,0.419,5810,130
"2282",140988,1992,1,0,"SHORTER COLLEGE",NA,NA,175,118,57,65,20,45,0.381,0.371,0.351,6220,157
"2283",140988,1993,1,0,"SHORTER COLLEGE",NA,NA,165,112,53,60,15,45,0.402,0.364,0.283,6670,156
"2284",140988,1995,1,0,"SHORTER COLLEGE",NA,NA,167,118,49,76,24,52,0.441,0.455,0.49,7610,150
"2285",140988,1996,1,0,"SHORTER COLLEGE",NA,NA,204,134,70,75,22,53,0.395,0.368,0.314,7860,181
"2286",140988,1997,1,0,"SHORTER COLLEGE",NA,NA,242,162,80,90,26,64,0.395,0.372,0.325,8260,222
"2287",140988,1998,1,0,"SHORTER COLLEGE",NA,NA,247,167,80,86,22,64,0.383,0.348,0.275,8770,221
"2288",140988,1999,1,0,"SHORTER COLLEGE",NA,NA,259,171,88,103,32,71,0.415,0.398,0.364,9050,227
"2289",140988,2000,1,0,"SHORTER COLLEGE",NA,NA,299,205,94,105,23,82,0.4,0.351,0.245,9350,268
"2290",140988,2001,1,0,"SHORTER COLLEGE",NA,NA,258,186,72,92,20,72,0.387,0.357,0.278,9800,228
"2291",140988,2002,1,0,"SHORTER COLLEGE",NA,NA,218,144,74,80,23,57,0.396,0.367,0.311,10400,191
"2292",140988,2003,1,0,"SHORTER COLLEGE",NA,NA,184,96,88,80,33,47,0.49,0.435,0.375,11440,155
"2293",140988,2004,1,0,"SHORTER COLLEGE",NA,NA,226,128,98,95,31,64,0.5,0.42,0.316,12500,194
"2294",140988,2005,1,0,"Shorter College",NA,NA,291,133,158,101,40,61,0.459,0.347,0.253,13200,222
"2295",140988,2006,1,0,"Shorter College",NA,NA,311,138,173,104,42,62,0.449,0.334,0.243,14000,237
"2296",140988,2007,1,0,"Shorter College",NA,NA,276,131,145,91,35,56,0.428,0.33,0.241,14850,215
"2297",140988,2008,1,0,"Shorter College",NA,NA,330,163,167,117,46,71,0.436,0.355,0.275,15440,247
"2298",140988,2009,1,0,"Shorter College",NA,NA,333,175,158,105,32,73,0.417,0.315,0.203,15950,253
"2299",140988,2010,1,0,"Shorter University",NA,NA,446,216,230,121,48,73,0.338,0.271,0.209,16700,311
"2300",141185,1991,1,0,"TOCCOA FALLS COLLEGE",NA,NA,218,113,105,51,25,26,0.23,0.234,0.238,5208,201
"2301",141185,1992,1,0,"TOCCOA FALLS COLLEGE",NA,NA,201,114,87,53,19,34,0.298,0.264,0.218,5486,186
"2302",141185,1993,1,0,"TOCCOA FALLS COLLEGE",NA,NA,165,105,60,47,15,32,0.305,0.285,0.25,6104,161
"2303",141185,1995,1,0,"TOCCOA FALLS COLLEGE",NA,NA,210,124,86,8,2,6,0.048,0.038,0.023,6628,188
"2304",141185,1996,1,0,"TOCCOA FALLS COLLEGE",NA,NA,187,120,67,66,22,44,0.367,0.353,0.328,7005,171
"2305",141185,1997,1,0,"TOCCOA FALLS COLLEGE",NA,NA,263,157,106,79,29,50,0.318,0.3,0.274,7395,244
"2306",141185,1998,1,0,"TOCCOA FALLS COLLEGE",NA,NA,229,141,88,76,24,52,0.369,0.332,0.273,7763,204
"2307",141185,1999,1,0,"TOCCOA FALLS COLLEGE",NA,NA,216,135,81,65,19,46,0.341,0.301,0.235,8384,201
"2308",141185,2000,1,0,"TOCCOA FALLS COLLEGE",NA,NA,192,105,87,51,13,38,0.362,0.266,0.149,8888,173
"2309",141185,2001,1,0,"TOCCOA FALLS COLLEGE",NA,NA,198,124,74,71,25,46,0.371,0.359,0.338,9600,171
"2310",141185,2002,1,0,"TOCCOA FALLS COLLEGE",NA,NA,175,106,69,88,37,51,0.481,0.503,0.536,9900,157
"2311",141185,2003,1,0,"TOCCOA FALLS COLLEGE",NA,NA,165,107,58,83,22,61,0.57,0.503,0.379,10850,149
"2312",141185,2004,1,0,"TOCCOA FALLS COLLEGE",NA,NA,161,98,63,67,20,47,0.48,0.416,0.317,11450,140
"2313",141185,2005,1,0,"Toccoa Falls College",NA,NA,223,135,88,84,27,57,0.422,0.377,0.307,12050,199
"2314",141185,2006,1,0,"Toccoa Falls College",NA,NA,190,104,86,62,18,44,0.423,0.326,0.209,12900,165
"2315",141185,2007,1,0,"Toccoa Falls College",NA,NA,218,128,90,75,28,47,0.367,0.344,0.311,13700,190
"2316",141185,2008,1,0,"Toccoa Falls College",NA,NA,155,93,62,63,20,43,0.462,0.406,0.323,14500,135
"2317",141185,2009,1,0,"Toccoa Falls College",NA,NA,168,109,59,59,21,38,0.349,0.351,0.356,15450,140
"2318",141185,2010,1,0,"Toccoa Falls College",NA,NA,153,78,75,54,16,38,0.487,0.353,0.213,15760,124
"2319",141264,1991,0,1,"VALDOSTA STATE COLLEGE",1998,0,994,614,380,225,78,147,0.239,0.226,0.205,1638,804
"2320",141264,1992,0,1,"VALDOSTA STATE COLLEGE",1998,0,1057,608,449,146,43,103,0.169,0.138,0.096,1689,778
"2321",141264,1993,0,1,"VALDOSTA STATE UNIVERSITY",1998,0,1357,807,550,211,50,161,0.2,0.155,0.091,1729,986
"2322",141264,1995,0,1,"VALDOSTA STATE UNIVERSITY",1998,0,1665,985,680,247,71,176,0.179,0.148,0.104,1887,1154
"2323",141264,1996,0,1,"VALDOSTA STATE UNIVERSITY",1998,0,1838,1030,808,227,65,162,0.157,0.124,0.08,2043,1281
"2324",141264,1997,0,1,"VALDOSTA STATE UNIVERSITY",1998,0,1594,947,647,179,50,129,0.136,0.112,0.077,2139,1118
"2325",141264,1998,1,0,"VALDOSTA STATE UNIVERSITY",1998,1,1301,755,546,158,44,114,0.151,0.121,0.081,2202,973
"2326",141264,1999,1,0,"VALDOSTA STATE UNIVERSITY",1998,1,1177,735,442,211,52,159,0.216,0.179,0.118,1808,876
"2327",141264,2000,1,0,"VALDOSTA STATE UNIVERSITY",1998,1,788,512,276,141,49,92,0.18,0.179,0.178,1876,568
"2328",141264,2001,1,0,"VALDOSTA STATE UNIVERSITY",1998,1,1534,937,597,266,67,199,0.212,0.173,0.112,1932,1123
"2329",141264,2002,1,0,"VALDOSTA STATE UNIVERSITY",1998,1,1584,973,611,239,54,185,0.19,0.151,0.088,2010,1183
"2330",141264,2003,1,0,"VALDOSTA STATE UNIVERSITY",1998,1,1756,1007,749,262,73,189,0.188,0.149,0.097,2212,1334
"2331",141264,2004,1,0,"VALDOSTA STATE UNIVERSITY",1998,1,1690,969,721,279,78,201,0.207,0.165,0.108,2322,1281
"2332",141264,2005,1,0,"Valdosta State University",1998,1,1775,1072,703,299,69,230,0.215,0.168,0.098,2438,1227
"2333",141264,2006,1,0,"Valdosta State University",1998,1,2015,1195,820,300,78,222,0.186,0.149,0.095,2548,1327
"2334",141264,2007,1,0,"Valdosta State University",1998,1,2029,1233,796,316,86,230,0.186,0.156,0.108,2744,1286
"2335",141264,2008,1,0,"Valdosta State University",1998,1,2106,1223,883,344,93,251,0.205,0.163,0.105,2898,1245
"2336",141264,2009,1,0,"Valdosta State University",1998,1,2416,1421,995,365,85,280,0.197,0.151,0.085,2978,1271
"2337",141264,2010,1,0,"Valdosta State University",1998,1,2528,1554,974,401,100,301,0.194,0.159,0.103,3283,1278
"2338",141334,1991,0,1,"WEST GEORGIA COLLEGE",1998,0,1178,664,514,157,43,114,0.172,0.133,0.084,1653,901
"2339",141334,1992,0,1,"WEST GEORGIA COLLEGE",1998,0,1182,657,525,141,39,102,0.155,0.119,0.074,2067,896
"2340",141334,1993,0,1,"WEST GEORGIA COLLEGE",1998,0,1263,738,525,97,19,78,0.106,0.077,0.036,1766,904
"2341",141334,1995,0,1,"STATE UNIVERSITY OF WEST GEORGIA",1998,0,1430,841,589,128,32,96,0.114,0.09,0.054,2274,1102
"2342",141334,1996,0,1,"STATE UNIVERSITY OF WEST GEORGIA",1998,0,1296,801,495,141,28,113,0.141,0.109,0.057,2364,1034
"2343",141334,1997,0,1,"STATE UNIVERSITY OF WEST GEORGIA",1998,0,1208,718,490,135,29,106,0.148,0.112,0.059,2088,924
"2344",141334,1998,1,0,"STATE UNIVERSITY OF WEST GEORGIA",1998,1,1670,1042,628,166,34,132,0.127,0.099,0.054,2158,1168
"2345",141334,1999,1,0,"STATE UNIVERSITY OF WEST GEORGIA",1998,1,1604,1005,599,144,34,110,0.11,0.09,0.057,1808,1151
"2346",141334,2000,1,0,"STATE UNIVERSITY OF WEST GEORGIA",1998,1,1661,987,674,187,34,153,0.155,0.113,0.05,1876,1220
"2347",141334,2001,1,0,"STATE UNIVERSITY OF WEST GEORGIA",1998,1,1551,931,620,194,34,160,0.172,0.125,0.055,2468,1177
"2348",141334,2002,1,0,"STATE UNIVERSITY OF WEST GEORGIA",1998,1,1617,921,696,181,41,140,0.152,0.112,0.059,2010,1190
"2349",141334,2003,1,0,"STATE UNIVERSITY OF WEST GEORGIA",1998,1,1738,1020,718,215,47,168,0.165,0.124,0.065,2212,1249
"2350",141334,2004,1,0,"STATE UNIVERSITY OF WEST GEORGIA",1998,1,1702,976,726,202,67,135,0.138,0.119,0.092,2322,1198
"2351",141334,2005,1,0,"University of West Georgia",1998,1,1640,966,674,212,47,165,0.171,0.129,0.07,2438,1124
"2352",141334,2006,1,0,"University of West Georgia",1998,1,1694,1002,692,254,67,187,0.187,0.15,0.097,2548,1096
"2353",141334,2007,1,0,"University of West Georgia",1998,1,1803,1051,752,311,93,218,0.207,0.172,0.124,2744,1121
"2354",141334,2008,1,0,"University of West Georgia",1998,1,2008,1216,792,321,88,233,0.192,0.16,0.111,2898,1284
"2355",141334,2009,1,0,"University of West Georgia",1998,1,1911,1095,816,298,81,217,0.198,0.156,0.099,3996,885
"2356",141334,2010,1,0,"University of West Georgia",1998,1,1844,1124,720,309,79,230,0.205,0.168,0.11,3696,747
"2357",141486,1991,1,0,"CHAMINADE UNIVERSITY OF HONOLULU",NA,NA,122,73,49,23,9,14,0.192,0.189,0.184,6800,31
"2358",141486,1992,1,0,"CHAMINADE UNIVERSITY OF HONOLULU",NA,NA,127,73,54,23,8,15,0.206,0.181,0.148,7600,37
"2359",141486,1993,1,0,"CHAMINADE UNIVERSITY OF HONOLULU",NA,NA,84,50,34,17,5,12,0.24,0.202,0.147,9990,25
"2360",141486,1995,1,0,"CHAMINADE UNIVERSITY OF HONOLULU",NA,NA,123,72,51,31,12,19,0.264,0.252,0.235,10600,41
"2361",141486,1996,1,0,"CHAMINADE UNIVERSITY OF HONOLULU",NA,NA,152,100,52,31,10,21,0.21,0.204,0.192,10600,45
"2362",141486,1997,1,0,"CHAMINADE UNIVERSITY OF HONOLULU",NA,NA,146,105,41,30,9,21,0.2,0.205,0.22,10800,47
"2363",141486,1998,1,0,"CHAMINADE UNIVERSITY OF HONOLULU",NA,NA,186,122,64,40,12,28,0.23,0.215,0.188,11180,51
"2364",141486,1999,1,0,"CHAMINADE UNIVERSITY OF HONOLULU",NA,NA,231,159,72,49,12,37,0.233,0.212,0.167,11600,54
"2365",141486,2000,1,0,"CHAMINADE UNIVERSITY OF HONOLULU",NA,NA,237,163,74,45,13,32,0.196,0.19,0.176,12040,59
"2366",141486,2001,1,0,"CHAMINADE UNIVERSITY OF HONOLULU",NA,NA,223,160,63,39,11,28,0.175,0.175,0.175,12500,53
"2367",141486,2002,1,0,"CHAMINADE UNIVERSITY OF HONOLULU",NA,NA,212,154,58,23,8,15,0.097,0.108,0.138,12950,48
"2368",141486,2003,1,0,"CHAMINADE UNIVERSITY OF HONOLULU",NA,NA,254,174,80,54,18,36,0.207,0.213,0.225,13380,72
"2369",141486,2004,1,0,"CHAMINADE UNIVERSITY OF HONOLULU",NA,NA,247,167,80,62,21,41,0.246,0.251,0.262,13850,64
"2370",141486,2005,1,0,"Chaminade University of Honolulu",NA,NA,260,182,78,57,12,45,0.247,0.219,0.154,14330,64
"2371",141486,2006,1,0,"Chaminade University of Honolulu",NA,NA,264,185,79,54,17,37,0.2,0.205,0.215,14820,53
"2372",141486,2007,1,0,"Chaminade University of Honolulu",NA,NA,242,156,86,65,18,47,0.301,0.269,0.209,15330,61
"2373",141486,2008,1,0,"Chaminade University of Honolulu",NA,NA,236,161,75,69,18,51,0.317,0.292,0.24,16000,29
"2374",141486,2009,1,0,"Chaminade University of Honolulu",NA,NA,262,164,98,73,25,48,0.293,0.279,0.255,16900,50
"2375",141486,2010,1,0,"Chaminade University of Honolulu",NA,NA,287,203,84,101,29,72,0.355,0.352,0.345,17600,43
"2376",141565,1991,1,0,"UNIVERSITY OF HAWAII AT HILO",NA,NA,198,100,98,10,2,8,0.08,0.051,0.02,1240,44
"2377",141565,1992,1,0,"UNIVERSITY OF HAWAII AT HILO",NA,NA,286,173,113,23,10,13,0.075,0.08,0.088,1280,51
"2378",141565,1993,1,0,"UNIVERSITY OF HAWAII AT HILO",NA,NA,310,190,120,20,4,16,0.084,0.065,0.033,1320,71
"2379",141565,1995,1,0,"UNIVERSITY OF HAWAII AT HILO",NA,NA,359,216,143,32,5,27,0.125,0.089,0.035,1426,73
"2380",141565,1996,1,0,"UNIVERSITY OF HAWAII AT HILO",NA,NA,333,207,126,35,11,24,0.116,0.105,0.087,1826,62
"2381",141565,1997,1,0,"UNIVERSITY OF HAWAII AT HILO",NA,NA,335,202,133,36,11,25,0.124,0.107,0.083,2186,74
"2382",141565,1998,1,0,"UNIVERSITY OF HAWAII AT HILO",NA,NA,351,194,157,24,11,13,0.067,0.068,0.07,2258,86
"2383",141565,1999,1,0,"UNIVERSITY OF HAWAII AT HILO",NA,NA,366,207,159,39,11,28,0.135,0.107,0.069,2280,98
"2384",141565,2000,1,0,"UNIVERSITY OF HAWAII AT HILO",NA,NA,362,223,139,39,13,26,0.117,0.108,0.094,2280,117
"2385",141565,2001,1,0,"UNIVERSITY OF HAWAII AT HILO",NA,NA,400,231,169,53,17,36,0.156,0.132,0.101,2304,170
"2386",141565,2002,1,0,"UNIVERSITY OF HAWAII AT HILO",NA,NA,404,238,166,57,17,40,0.168,0.141,0.102,2328,144
"2387",141565,2003,1,0,"UNIVERSITY OF HAWAII AT HILO",NA,NA,423,274,149,54,17,37,0.135,0.128,0.114,2376,197
"2388",141565,2004,1,0,"UNIVERSITY OF HAWAII AT HILO",NA,NA,412,225,187,50,18,32,0.142,0.121,0.096,2424,146
"2389",141565,2005,1,0,"University of Hawaii at Hilo",NA,NA,409,215,194,50,15,35,0.163,0.122,0.077,2472,133
"2390",141565,2006,1,0,"University of Hawaii at Hilo",NA,NA,448,267,181,48,9,39,0.146,0.107,0.05,3000,123
"2391",141565,2007,1,0,"University of Hawaii at Hilo",NA,NA,497,299,198,41,11,30,0.1,0.082,0.056,3528,122
"2392",141565,2008,1,0,"University of Hawaii at Hilo",NA,NA,536,326,210,61,16,45,0.138,0.114,0.076,4056,125
"2393",141565,2009,1,0,"University of Hawaii at Hilo",NA,NA,460,269,191,54,17,37,0.138,0.117,0.089,4584,93
"2394",141565,2010,1,0,"University of Hawaii at Hilo",NA,NA,392,230,162,43,13,30,0.13,0.11,0.08,5112,71
"2395",141574,1991,1,0,"UNIVERSITY OF HAWAII AT MANOA",NA,NA,1462,794,668,117,35,82,0.103,0.08,0.052,1387,182
"2396",141574,1992,1,0,"UNIVERSITY OF HAWAII AT MANOA",NA,NA,1485,823,662,158,46,112,0.136,0.106,0.069,1437,147
"2397",141574,1993,1,0,"UNIVERSITY OF HAWAII AT MANOA",NA,NA,1551,899,652,141,44,97,0.108,0.091,0.067,1497,196
"2398",141574,1995,1,0,"UNIVERSITY OF HAWAII AT MANOA",NA,NA,1671,967,704,184,57,127,0.131,0.11,0.081,1631,164
"2399",141574,1996,1,0,"UNIVERSITY OF HAWAII AT MANOA",NA,NA,1357,769,588,154,45,109,0.142,0.113,0.077,2421,168
"2400",141574,1997,1,0,"UNIVERSITY OF HAWAII AT MANOA",NA,NA,1439,807,632,174,50,124,0.154,0.121,0.079,2949,169
"2401",141574,1998,1,0,"UNIVERSITY OF HAWAII AT MANOA",NA,NA,1388,795,593,162,55,107,0.135,0.117,0.093,3046,149
"2402",141574,1999,1,0,"UNIVERSITY OF HAWAII AT MANOA",NA,NA,1421,793,628,164,56,108,0.136,0.115,0.089,3024,217
"2403",141574,2000,1,0,"UNIVERSITY OF HAWAII AT MANOA",NA,NA,1499,846,653,168,48,120,0.142,0.112,0.074,3024,294
"2404",141574,2001,1,0,"UNIVERSITY OF HAWAII AT MANOA",NA,NA,1521,883,638,224,61,163,0.185,0.147,0.096,3120,330
"2405",141574,2002,1,0,"UNIVERSITY OF HAWAII AT MANOA",NA,NA,1726,970,756,251,74,177,0.182,0.145,0.098,3216,435
"2406",141574,2003,1,0,"UNIVERSITY OF HAWAII AT MANOA",NA,NA,1878,1035,843,307,92,215,0.208,0.163,0.109,3312,545
"2407",141574,2004,1,0,"UNIVERSITY OF HAWAII AT MANOA",NA,NA,1892,1039,853,325,109,216,0.208,0.172,0.128,3408,578
"2408",141574,2005,1,0,"University of Hawaii at Manoa",NA,NA,1923,1060,863,354,128,226,0.213,0.184,0.148,3504,413
"2409",141574,2006,1,0,"University of Hawaii at Manoa",NA,NA,1679,922,757,293,107,186,0.202,0.175,0.141,4320,402
"2410",141574,2007,1,0,"University of Hawaii at Manoa",NA,NA,1727,946,781,322,111,211,0.223,0.186,0.142,5136,401
"2411",141574,2008,1,0,"University of Hawaii at Manoa",NA,NA,1808,1027,781,358,114,244,0.238,0.198,0.146,5952,413
"2412",141574,2009,1,0,"University of Hawaii at Manoa",NA,NA,1847,984,863,392,155,237,0.241,0.212,0.18,6768,406
"2413",141574,2010,1,0,"University of Hawaii at Manoa",NA,NA,1776,984,792,439,164,275,0.28,0.247,0.207,7584,349
"2414",142276,1991,1,0,"IDAHO STATE UNIVERSITY",NA,NA,1091,569,522,47,14,33,0.058,0.043,0.027,1230,972
"2415",142276,1992,1,0,"IDAHO STATE UNIVERSITY",NA,NA,1091,556,535,66,22,44,0.079,0.06,0.041,1454,982
"2416",142276,1993,1,0,"IDAHO STATE UNIVERSITY",NA,NA,1165,626,539,44,12,32,0.051,0.038,0.022,1602,1043
"2417",142276,1995,1,0,"IDAHO STATE UNIVERSITY",NA,NA,1363,783,580,37,6,31,0.04,0.027,0.01,1570,1256
"2418",142276,1996,1,0,"IDAHO STATE UNIVERSITY",NA,NA,1378,789,589,49,15,34,0.043,0.036,0.025,2125,1274
"2419",142276,1997,1,0,"IDAHO STATE UNIVERSITY",NA,NA,1400,793,607,44,11,33,0.042,0.031,0.018,2424,1281
"2420",142276,1998,1,0,"IDAHO STATE UNIVERSITY",NA,NA,1442,787,655,52,15,37,0.047,0.036,0.023,2590,1282
"2421",142276,1999,1,0,"IDAHO STATE UNIVERSITY",NA,NA,1345,740,605,45,10,35,0.047,0.033,0.017,0,1205
"2422",142276,2000,1,0,"IDAHO STATE UNIVERSITY",NA,NA,1345,781,564,51,9,42,0.054,0.038,0.016,0,1183
"2423",142276,2001,1,0,"IDAHO STATE UNIVERSITY",NA,NA,1485,783,702,53,9,44,0.056,0.036,0.013,0,1313
"2424",142276,2002,1,0,"IDAHO STATE UNIVERSITY",NA,NA,704,474,230,59,5,54,0.114,0.084,0.022,0,615
"2425",142276,2003,1,0,"IDAHO STATE UNIVERSITY",NA,NA,787,499,288,53,10,43,0.086,0.067,0.035,0,692
"2426",142276,2004,1,0,"IDAHO STATE UNIVERSITY",NA,NA,983,522,461,63,18,45,0.086,0.064,0.039,0,820
"2427",142276,2005,1,0,"Idaho State University",NA,NA,909,519,390,74,22,52,0.1,0.081,0.056,0,762
"2428",142276,2006,1,0,"Idaho State University",NA,NA,994,525,469,85,23,62,0.118,0.086,0.049,2689,804
"2429",142276,2007,1,0,"Idaho State University",NA,NA,998,526,472,88,26,62,0.118,0.088,0.055,2882,803
"2430",142276,2008,1,0,"Idaho State University",NA,NA,1031,525,506,94,35,59,0.112,0.091,0.069,3114,827
"2431",142276,2009,1,0,"Idaho State University",NA,NA,1189,599,590,122,47,75,0.125,0.103,0.08,3318,976
"2432",142276,2010,1,0,"Idaho State University",NA,NA,1432,749,683,121,34,87,0.116,0.084,0.05,3800,650
"2433",142285,1991,1,0,"UNIVERSITY OF IDAHO",NA,NA,1273,524,749,140,72,68,0.13,0.11,0.096,1236,1154
"2434",142285,1992,1,0,"UNIVERSITY OF IDAHO",NA,NA,1290,574,716,173,77,96,0.167,0.134,0.108,1296,1164
"2435",142285,1993,1,0,"UNIVERSITY OF IDAHO",NA,NA,1323,613,710,214,71,143,0.233,0.162,0.1,1426,1167
"2436",142285,1995,1,0,"UNIVERSITY OF IDAHO",NA,NA,1242,602,640,225,78,147,0.244,0.181,0.122,1620,1113
"2437",142285,1996,1,0,"UNIVERSITY OF IDAHO",NA,NA,1201,574,627,222,85,137,0.239,0.185,0.136,1768,1093
"2438",142285,1997,1,0,"UNIVERSITY OF IDAHO",NA,NA,1360,687,673,240,82,158,0.23,0.176,0.122,1942,1220
"2439",142285,1998,1,0,"UNIVERSITY OF IDAHO",NA,NA,1481,732,749,297,112,185,0.253,0.201,0.15,2136,1319
"2440",142285,1999,1,0,"UNIVERSITY OF IDAHO",NA,NA,1457,736,721,318,123,195,0.265,0.218,0.171,0,1295
"2441",142285,2000,1,0,"UNIVERSITY OF IDAHO",NA,NA,1560,722,838,311,127,184,0.255,0.199,0.152,0,1346
"2442",142285,2001,1,0,"UNIVERSITY OF IDAHO",NA,NA,1642,791,851,340,122,218,0.276,0.207,0.143,0,1455
"2443",142285,2002,1,0,"UNIVERSITY OF IDAHO",NA,NA,1619,784,835,371,153,218,0.278,0.229,0.183,0,1384
"2444",142285,2003,1,0,"UNIVERSITY OF IDAHO",NA,NA,1590,748,842,393,163,230,0.308,0.247,0.194,0,1370
"2445",142285,2004,1,0,"UNIVERSITY OF IDAHO",NA,NA,1602,755,847,383,147,236,0.313,0.239,0.174,0,1346
"2446",142285,2005,1,0,"University of Idaho",NA,NA,1673,823,850,386,156,230,0.28,0.231,0.184,0,1416
"2447",142285,2006,1,0,"University of Idaho",NA,NA,1582,749,833,369,150,219,0.292,0.233,0.18,0,1339
"2448",142285,2007,1,0,"University of Idaho",NA,NA,1615,764,851,402,173,229,0.3,0.249,0.203,0,1356
"2449",142285,2008,1,0,"University of Idaho",NA,NA,1663,777,886,460,202,258,0.332,0.277,0.228,0,1401
"2450",142285,2009,1,0,"University of Idaho",NA,NA,1754,841,913,512,180,332,0.395,0.292,0.197,0,1417
"2451",142285,2010,1,0,"University of Idaho",NA,NA,1709,799,910,511,226,285,0.357,0.299,0.248,0,1430
"2452",142461,1991,0,1,"NORTHWEST NAZARENE COLLEGE",2000,0,237,129,108,51,17,34,0.264,0.215,0.157,6966,220
"2453",142461,1992,0,1,"NORTHWEST NAZARENE COLLEGE",2000,0,284,162,122,82,31,51,0.315,0.289,0.254,8160,253
"2454",142461,1993,0,1,"NORTHWEST NAZARENE COLLEGE",2000,0,319,180,139,110,42,68,0.378,0.345,0.302,8766,269
"2455",142461,1995,0,1,"NORTHWEST NAZARENE COLLEGE",2000,0,320,183,137,86,27,59,0.322,0.269,0.197,11145,37
"2456",142461,1996,0,1,"NORTHWEST NAZARENE COLLEGE",2000,0,264,156,108,18,4,14,0.09,0.068,0.037,11685,248
"2457",142461,1997,0,1,"NORTHWEST NAZARENE COLLEGE",2000,0,277,148,129,91,37,54,0.365,0.329,0.287,11823,263
"2458",142461,1998,0,1,"NORTHWEST NAZARENE COLLEGE",2000,0,310,193,117,101,27,74,0.383,0.326,0.231,12456,299
"2459",142461,1999,0,1,"NORTHWEST NAZARENE UNIVERSITY",2000,0,295,165,130,88,31,57,0.346,0.298,0.238,12510,275
"2460",142461,2000,1,0,"NORTHWEST NAZARENE UNIVERSITY",2000,1,240,137,103,74,24,50,0.365,0.308,0.233,12990,228
"2461",142461,2001,1,0,"NORTHWEST NAZARENE UNIVERSITY",2000,1,265,150,115,83,31,52,0.347,0.313,0.27,13700,236
"2462",142461,2002,1,0,"NORTHWEST NAZARENE UNIVERSITY",2000,1,276,169,107,87,38,49,0.29,0.315,0.355,14520,227
"2463",142461,2003,1,0,"NORTHWEST NAZARENE UNIVERSITY",2000,1,241,153,88,89,22,67,0.438,0.369,0.25,15330,206
"2464",142461,2004,1,0,"NORTHWEST NAZARENE UNIVERSITY",2000,1,247,159,88,99,28,71,0.446,0.401,0.318,15980,205
"2465",142461,2005,1,0,"Northwest Nazarene University",2000,1,249,168,81,88,24,64,0.381,0.353,0.296,17280,208
"2466",142461,2006,1,0,"Northwest Nazarene University",2000,1,247,128,119,86,37,49,0.383,0.348,0.311,18430,199
"2467",142461,2007,1,0,"Northwest Nazarene University",2000,1,220,139,81,70,22,48,0.345,0.318,0.272,19700,166
"2468",142461,2008,1,0,"Northwest Nazarene University",2000,1,301,169,132,96,34,62,0.367,0.319,0.258,20900,236
"2469",142461,2009,1,0,"Northwest Nazarene University",2000,1,263,151,112,95,33,62,0.411,0.361,0.295,21930,204
"2470",142461,2010,1,0,"Northwest Nazarene University",2000,1,253,151,102,78,30,48,0.318,0.308,0.294,22810,166
"2471",143084,1991,0,1,"AUGUSTANA COLLEGE",9999,0,526,296,230,337,145,192,0.649,0.641,0.63,11175,455
"2472",143084,1992,0,1,"AUGUSTANA COLLEGE",9999,0,538,309,229,318,119,199,0.644,0.591,0.52,12009,496
"2473",143084,1993,0,1,"AUGUSTANA COLLEGE",9999,0,498,290,208,309,121,188,0.648,0.62,0.582,12942,446
"2474",143084,1995,0,1,"AUGUSTANA COLLEGE",9999,0,605,352,253,394,151,243,0.69,0.651,0.597,14064,549
"2475",143084,1996,0,1,"AUGUSTANA COLLEGE",9999,0,574,345,229,397,153,244,0.707,0.692,0.668,14700,521
"2476",143084,1997,0,1,"AUGUSTANA COLLEGE",9999,0,564,328,236,400,146,254,0.774,0.709,0.619,15300,507
"2477",143084,1998,0,1,"AUGUSTANA COLLEGE",9999,0,567,321,246,389,148,241,0.751,0.686,0.602,16323,527
"2478",143084,1999,0,1,"AUGUSTANA COLLEGE",9999,0,565,338,227,402,161,241,0.713,0.712,0.709,16866,517
"2479",143084,2000,0,1,"AUGUSTANA COLLEGE",9999,0,610,359,251,443,172,271,0.755,0.726,0.685,17541,564
"2480",143084,2001,0,1,"AUGUSTANA COLLEGE",9999,0,550,310,240,392,167,225,0.726,0.713,0.696,18330,511
"2481",143084,2002,0,1,"AUGUSTANA COLLEGE",9999,0,601,349,252,417,158,259,0.742,0.694,0.627,19200,565
"2482",143084,2003,0,1,"AUGUSTANA COLLEGE",9999,0,614,369,245,443,153,290,0.786,0.721,0.624,20397,558
"2483",143084,2004,0,1,"AUGUSTANA COLLEGE",9999,0,599,321,278,426,178,248,0.773,0.711,0.64,21672,547
"2484",143084,2005,0,1,"Augustana College",9999,0,679,383,296,474,193,281,0.734,0.698,0.652,22971,614
"2485",143084,2006,0,1,"Augustana College",9999,0,692,392,300,505,216,289,0.737,0.73,0.72,24408,625
"2486",143084,2007,0,1,"Augustana College",9999,0,713,418,295,525,199,326,0.78,0.736,0.675,25935,576
"2487",143084,2008,0,1,"Augustana College",9999,0,640,369,271,454,179,275,0.745,0.709,0.661,30150,468
"2488",143084,2009,0,1,"Augustana College",9999,0,616,342,274,434,168,266,0.778,0.705,0.613,31326,512
"2489",143084,2010,0,1,"Augustana College",9999,0,753,432,321,532,206,326,0.755,0.707,0.642,32235,616
"2490",143288,1991,1,0,"BLACKBURN COLLEGE",NA,NA,116,44,72,23,6,17,0.386,0.198,0.083,7750,91
"2491",143288,1992,1,0,"BLACKBURN COLLEGE",NA,NA,148,74,74,52,17,35,0.473,0.351,0.23,7750,122
"2492",143288,1993,1,0,"BLACKBURN COLLEGE",NA,NA,156,76,80,42,15,27,0.355,0.269,0.188,7820,132
"2493",143288,1995,1,0,"BLACKBURN COLLEGE",NA,NA,157,66,91,37,17,20,0.303,0.236,0.187,6500,142
"2494",143288,1996,1,0,"BLACKBURN COLLEGE",NA,NA,142,72,70,35,13,22,0.306,0.246,0.186,6850,120
"2495",143288,1997,1,0,"BLACKBURN COLLEGE",NA,NA,155,81,74,39,11,28,0.346,0.252,0.149,7425,135
"2496",143288,1998,1,0,"BLACKBURN COLLEGE",NA,NA,144,66,78,37,16,21,0.318,0.257,0.205,7880,123
"2497",143288,1999,1,0,"BLACKBURN COLLEGE",NA,NA,145,76,69,44,21,23,0.303,0.303,0.304,7950,130
"2498",143288,2000,1,0,"BLACKBURN COLLEGE",NA,NA,191,107,84,56,18,38,0.355,0.293,0.214,8190,158
"2499",143288,2001,1,0,"BLACKBURN COLLEGE",NA,NA,162,95,67,60,18,42,0.442,0.37,0.269,8600,120
"2500",143288,2002,1,0,"BLACKBURN COLLEGE",NA,NA,147,75,72,44,16,28,0.373,0.299,0.222,9200,115
"2501",143288,2003,1,0,"BLACKBURN COLLEGE",NA,NA,176,82,94,49,19,30,0.366,0.278,0.202,9890,140
"2502",143288,2004,1,0,"BLACKBURN COLLEGE",NA,NA,176,87,89,55,23,32,0.368,0.312,0.258,14600,146
"2503",143288,2005,1,0,"Blackburn College",NA,NA,183,92,91,66,30,36,0.391,0.361,0.33,15040,164
"2504",143288,2006,1,0,"Blackburn College",NA,NA,177,111,66,63,17,46,0.414,0.356,0.258,15700,148
"2505",143288,2007,1,0,"Blackburn College",NA,NA,175,93,82,59,23,36,0.387,0.337,0.28,15770,148
"2506",143288,2008,1,0,"Blackburn College",NA,NA,171,94,77,52,18,34,0.362,0.304,0.234,13500,149
"2507",143288,2009,1,0,"Blackburn College",NA,NA,146,93,53,46,18,28,0.301,0.315,0.34,14176,128
"2508",143288,2010,1,0,"Blackburn College",NA,NA,150,105,45,46,9,37,0.352,0.307,0.2,14176,119
"2509",144005,1991,1,0,"CHICAGO STATE UNIVERSITY",NA,NA,614,414,200,7,3,4,0.01,0.011,0.015,1784,6
"2510",144005,1992,1,0,"CHICAGO STATE UNIVERSITY",NA,NA,576,351,225,3,2,1,0.003,0.005,0.009,1868,7
"2511",144005,1993,1,0,"CHICAGO STATE UNIVERSITY",NA,NA,641,432,209,7,1,6,0.014,0.011,0.005,2198,8
"2512",144005,1995,1,0,"CHICAGO STATE UNIVERSITY",NA,NA,613,410,203,35,3,32,0.078,0.057,0.015,2336,12
"2513",144005,1996,1,0,"CHICAGO STATE UNIVERSITY",NA,NA,563,409,154,17,4,13,0.032,0.03,0.026,2420,7
"2514",144005,1997,1,0,"CHICAGO STATE UNIVERSITY",NA,NA,487,332,155,6,1,5,0.015,0.012,0.006,2496,5
"2515",144005,1998,1,0,"CHICAGO STATE UNIVERSITY",NA,NA,601,399,202,10,3,7,0.018,0.017,0.015,2868,9
"2516",144005,1999,1,0,"CHICAGO STATE UNIVERSITY",NA,NA,461,329,132,9,3,6,0.018,0.02,0.023,2290,8
"2517",144005,2000,1,0,"CHICAGO STATE UNIVERSITY",NA,NA,345,232,113,10,5,5,0.022,0.029,0.044,2364,12
"2518",144005,2001,1,0,"CHICAGO STATE UNIVERSITY",NA,NA,395,280,115,16,3,13,0.046,0.041,0.026,2484,9
"2519",144005,2002,1,0,"CHICAGO STATE UNIVERSITY",NA,NA,438,302,136,11,2,9,0.03,0.025,0.015,2732,12
"2520",144005,2003,1,0,"CHICAGO STATE UNIVERSITY",NA,NA,476,336,140,12,4,8,0.024,0.025,0.029,3168,13
"2521",144005,2004,1,0,"CHICAGO STATE UNIVERSITY",NA,NA,563,367,196,17,13,4,0.011,0.03,0.066,4575,12
"2522",144005,2005,1,0,"Chicago State University",NA,NA,405,268,137,15,4,11,0.041,0.037,0.029,4890,8
"2523",144005,2006,1,0,"Chicago State University",NA,NA,359,254,105,16,2,14,0.055,0.045,0.019,5090,9
"2524",144005,2007,1,0,"Chicago State University",NA,NA,372,255,117,15,4,11,0.043,0.04,0.034,5440,9
"2525",144005,2008,1,0,"Chicago State University",NA,NA,402,279,123,10,4,6,0.021,0.025,0.033,5914,6
"2526",144005,2009,1,0,"Chicago State University",NA,NA,589,428,161,13,6,7,0.016,0.022,0.037,5976,12
"2527",144005,2010,1,0,"Chicago State University",NA,NA,523,354,169,14,2,12,0.034,0.027,0.012,6145,9
"2528",144281,1991,1,0,"COLUMBIA COLLEGE",NA,NA,846,439,407,21,8,13,0.03,0.025,0.02,6296,384
"2529",144281,1992,1,0,"COLUMBIA COLLEGE",NA,NA,760,373,387,90,42,48,0.129,0.118,0.109,6664,378
"2530",144281,1993,1,0,"COLUMBIA COLLEGE",NA,NA,817,398,419,95,34,61,0.153,0.116,0.081,6928,409
"2531",144281,1995,1,0,"COLUMBIA COLLEGE",NA,NA,939,464,475,131,67,64,0.138,0.14,0.141,7670,489
"2532",144281,1996,1,0,"COLUMBIA COLLEGE",NA,NA,868,411,457,130,52,78,0.19,0.15,0.114,8030,484
"2533",144281,1997,1,0,"COLUMBIA COLLEGE CHICAGO",NA,NA,1078,519,559,147,61,86,0.166,0.136,0.109,8498,552
"2534",144281,1998,1,0,"COLUMBIA COLLEGE CHICAGO",NA,NA,1210,588,622,229,108,121,0.206,0.189,0.174,9544,649
"2535",144281,1999,1,0,"COLUMBIA COLLEGE CHICAGO",NA,NA,1134,560,574,225,103,122,0.218,0.198,0.179,10690,572
"2536",144281,2000,1,0,"COLUMBIA COLLEGE CHICAGO",NA,NA,1265,640,625,330,139,191,0.298,0.261,0.222,11600,675
"2537",144281,2001,1,0,"COLUMBIA COLLEGE CHICAGO",NA,NA,1448,767,681,353,157,196,0.256,0.244,0.231,12524,811
"2538",144281,2002,1,0,"COLUMBIA COLLEGE CHICAGO",NA,NA,1589,854,735,401,164,237,0.278,0.252,0.223,13714,944
"2539",144281,2003,1,0,"COLUMBIA COLLEGE CHICAGO",NA,NA,1446,777,669,389,166,223,0.287,0.269,0.248,14880,860
"2540",144281,2004,1,0,"COLUMBIA COLLEGE CHICAGO",NA,NA,1744,873,871,449,217,232,0.266,0.257,0.249,14880,1030
"2541",144281,2005,1,0,"Columbia College Chicago",NA,NA,1795,933,862,504,219,285,0.306,0.281,0.254,15588,1148
"2542",144281,2006,1,0,"Columbia College Chicago",NA,NA,1972,1025,947,547,247,300,0.293,0.277,0.261,16328,1229
"2543",144281,2007,1,0,"Columbia College Chicago",NA,NA,2166,1148,1018,692,313,379,0.33,0.319,0.307,17104,1344
"2544",144281,2008,1,0,"Columbia College Chicago",NA,NA,2329,1289,1040,690,277,413,0.32,0.296,0.266,17950,1376
"2545",144281,2009,1,0,"Columbia College Chicago",NA,NA,2089,1170,919,616,241,375,0.32,0.295,0.262,18490,1173
"2546",144281,2010,1,0,"Columbia College-Chicago",NA,NA,2209,1252,957,665,258,407,0.325,0.301,0.27,19140,1278
"2547",144740,1991,0,1,"DEPAUL UNIVERSITY",9999,0,1047,593,454,388,147,241,0.406,0.371,0.324,9342,748
"2548",144740,1992,0,1,"DEPAUL UNIVERSITY",9999,0,927,520,407,350,119,231,0.444,0.378,0.292,10014,671
"2549",144740,1993,0,1,"DEPAUL UNIVERSITY",9999,0,1182,701,481,416,159,257,0.367,0.352,0.331,10590,832
"2550",144740,1995,0,1,"DEPAUL UNIVERSITY",9999,0,1225,700,525,447,177,270,0.386,0.365,0.337,11856,861
"2551",144740,1996,0,1,"DEPAUL UNIVERSITY",9999,0,1122,668,454,483,184,299,0.448,0.43,0.405,12780,752
"2552",144740,1997,0,1,"DEPAUL UNIVERSITY",9999,0,1211,713,498,566,212,354,0.496,0.467,0.426,13490,777
"2553",144740,1998,0,1,"DEPAUL UNIVERSITY",9999,0,1448,852,596,591,216,375,0.44,0.408,0.362,14100,903
"2554",144740,1999,0,1,"DEPAUL UNIVERSITY",9999,0,1700,997,703,771,299,472,0.473,0.454,0.425,14670,1037
"2555",144740,2000,0,1,"DEPAUL UNIVERSITY",9999,0,1897,1140,757,852,308,544,0.477,0.449,0.407,15390,1232
"2556",144740,2001,0,1,"DEPAUL UNIVERSITY",9999,0,2042,1180,862,866,325,541,0.458,0.424,0.377,16500,1242
"2557",144740,2002,0,1,"DEPAUL UNIVERSITY",9999,0,2231,1323,908,985,346,639,0.483,0.442,0.381,17820,1271
"2558",144740,2003,0,1,"DEPAUL UNIVERSITY",9999,0,2249,1351,898,966,341,625,0.463,0.43,0.38,20555,1381
"2559",144740,2004,0,1,"DEPAUL UNIVERSITY",9999,0,2304,1367,937,1097,377,720,0.527,0.476,0.402,21669,1425
"2560",144740,2005,0,1,"DePaul University",9999,0,2392,1411,981,1168,450,718,0.509,0.488,0.459,22789,1566
"2561",144740,2006,0,1,"DePaul University",9999,0,2531,1428,1103,1280,482,798,0.559,0.506,0.437,22365,1652
"2562",144740,2007,0,1,"DePaul University",9999,0,2513,1458,1055,1363,522,841,0.577,0.542,0.495,23820,1580
"2563",144740,2008,0,1,"DePaul University",9999,0,2553,1502,1051,1430,537,893,0.595,0.56,0.511,25770,1574
"2564",144740,2009,0,1,"DePaul University",9999,0,2523,1494,1029,1425,538,887,0.594,0.565,0.523,26765,1412
"2565",144740,2010,0,1,"DePaul University",9999,0,2235,1307,928,1313,501,812,0.621,0.587,0.54,28240,1337
"2566",144892,1991,1,0,"EASTERN ILLINOIS UNIVERSITY",NA,NA,1493,911,582,577,185,392,0.43,0.386,0.318,2358,1342
"2567",144892,1992,1,0,"EASTERN ILLINOIS UNIVERSITY",NA,NA,1463,893,570,464,132,332,0.372,0.317,0.232,2533,1309
"2568",144892,1993,1,0,"EASTERN ILLINOIS UNIVERSITY",NA,NA,1612,969,643,471,112,359,0.37,0.292,0.174,2600,1457
"2569",144892,1995,1,0,"EASTERN ILLINOIS UNIVERSITY",NA,NA,1538,973,565,468,117,351,0.361,0.304,0.207,2777,1349
"2570",144892,1996,1,0,"EASTERN ILLINOIS UNIVERSITY",NA,NA,1640,1000,640,505,126,379,0.379,0.308,0.197,2905,1451
"2571",144892,1997,1,0,"EASTERN ILLINOIS UNIVERSITY",NA,NA,1552,950,602,479,121,358,0.377,0.309,0.201,3078,1373
"2572",144892,1998,1,0,"EASTERN ILLINOIS UNIVERSITY",NA,NA,1604,984,620,547,148,399,0.405,0.341,0.239,3232,1418
"2573",144892,1999,1,0,"EASTERN ILLINOIS UNIVERSITY",NA,NA,1478,929,549,482,131,351,0.378,0.326,0.239,2254,1277
"2574",144892,2000,1,0,"EASTERN ILLINOIS UNIVERSITY",NA,NA,1495,870,625,471,151,320,0.368,0.315,0.242,2910,1294
"2575",144892,2001,1,0,"EASTERN ILLINOIS UNIVERSITY",NA,NA,1431,836,595,445,135,310,0.371,0.311,0.227,2993,1216
"2576",144892,2002,1,0,"EASTERN ILLINOIS UNIVERSITY",NA,NA,1984,1143,841,582,183,399,0.349,0.293,0.218,3254,1714
"2577",144892,2003,1,0,"EASTERN ILLINOIS UNIVERSITY",NA,NA,1892,1098,794,563,185,378,0.344,0.298,0.233,3563,1682
"2578",144892,2004,1,0,"EASTERN ILLINOIS UNIVERSITY",NA,NA,1725,1032,693,594,177,417,0.404,0.344,0.255,3830,1524
"2579",144892,2005,1,0,"Eastern Illinois University",NA,NA,1645,967,678,521,168,353,0.365,0.317,0.248,4629,1286
"2580",144892,2006,1,0,"Eastern Illinois University",NA,NA,1760,1062,698,583,164,419,0.394,0.331,0.235,5207,1399
"2581",144892,2007,1,0,"Eastern Illinois University",NA,NA,1641,988,653,551,171,380,0.385,0.336,0.262,5832,1259
"2582",144892,2008,1,0,"Eastern Illinois University",NA,NA,1764,1029,735,582,196,386,0.375,0.33,0.267,6540,1333
"2583",144892,2009,1,0,"Eastern Illinois University",NA,NA,1637,997,640,520,178,342,0.343,0.318,0.278,7170,1181
"2584",144892,2010,1,0,"Eastern Illinois University",NA,NA,1446,892,554,492,157,335,0.376,0.34,0.283,6835,1039
"2585",144962,1991,1,0,"ELMHURST COLLEGE",NA,NA,247,130,117,99,38,61,0.469,0.401,0.325,8460,199
"2586",144962,1992,1,0,"ELMHURST COLLEGE",NA,NA,229,128,101,92,29,63,0.492,0.402,0.287,9050,175
"2587",144962,1993,1,0,"ELMHURST COLLEGE",NA,NA,252,140,112,99,41,58,0.414,0.393,0.366,9676,191
"2588",144962,1995,1,0,"ELMHURST COLLEGE",NA,NA,253,147,106,128,41,87,0.592,0.506,0.387,10264,195
"2589",144962,1996,1,0,"ELMHURST COLLEGE",NA,NA,222,137,85,130,49,81,0.591,0.586,0.576,10976,181
"2590",144962,1997,1,0,"ELMHURST COLLEGE",NA,NA,289,155,134,2,1,1,0.007,0.007,0.007,11900,230
"2591",144962,1998,1,0,"ELMHURST COLLEGE",NA,NA,266,152,114,154,51,103,0.678,0.579,0.447,12870,211
"2592",144962,1999,1,0,"ELMHURST COLLEGE",NA,NA,269,156,113,158,58,100,0.641,0.587,0.513,13900,220
"2593",144962,2000,1,0,"ELMHURST COLLEGE",NA,NA,301,185,116,183,50,133,0.719,0.608,0.431,15000,237
"2594",144962,2001,1,0,"ELMHURST COLLEGE",NA,NA,302,169,133,153,47,106,0.627,0.507,0.353,16200,222
"2595",144962,2002,1,0,"ELMHURST COLLEGE",NA,NA,295,185,110,157,41,116,0.627,0.532,0.373,17500,243
"2596",144962,2003,1,0,"ELMHURST COLLEGE",NA,NA,366,230,136,194,54,140,0.609,0.53,0.397,18600,279
"2597",144962,2004,1,0,"ELMHURST COLLEGE",NA,NA,386,225,161,215,66,149,0.662,0.557,0.41,20090,300
"2598",144962,2005,1,0,"Elmhurst College",NA,NA,466,282,184,252,84,168,0.596,0.541,0.457,21600,364
"2599",144962,2006,1,0,"Elmhurst College",NA,NA,484,296,188,275,100,175,0.591,0.568,0.532,23100,380
"2600",144962,2007,1,0,"Elmhurst College",NA,NA,508,304,204,300,99,201,0.661,0.591,0.485,24600,394
"2601",144962,2008,1,0,"Elmhurst College",NA,NA,576,348,228,350,113,237,0.681,0.608,0.496,26000,453
"2602",144962,2009,1,0,"Elmhurst College",NA,NA,584,341,243,317,106,211,0.619,0.543,0.436,27270,435
"2603",144962,2010,1,0,"Elmhurst College",NA,NA,537,330,207,301,99,202,0.612,0.561,0.478,28600,436
"2604",144971,1991,1,0,"EUREKA COLLEGE",NA,NA,129,70,59,54,21,33,0.471,0.419,0.356,9425,112
"2605",144971,1992,1,0,"EUREKA COLLEGE",NA,NA,119,60,59,53,22,31,0.517,0.445,0.373,10325,110
"2606",144971,1993,1,0,"EUREKA COLLEGE",NA,NA,109,45,64,50,26,24,0.533,0.459,0.406,11105,96
"2607",144971,1995,1,0,"EUREKA COLLEGE",NA,NA,139,58,81,68,35,33,0.569,0.489,0.432,12505,129
"2608",144971,1996,1,0,"EUREKA COLLEGE",NA,NA,128,67,61,55,19,36,0.537,0.43,0.311,13216,118
"2609",144971,1997,1,0,"EUREKA COLLEGE",NA,NA,141,50,91,54,25,29,0.58,0.383,0.275,13950,135
"2610",144971,1998,1,0,"EUREKA COLLEGE",NA,NA,114,57,57,65,31,34,0.597,0.57,0.544,14790,105
"2611",144971,1999,1,0,"EUREKA COLLEGE",NA,NA,130,76,54,60,19,41,0.54,0.462,0.352,15200,119
"2612",144971,2000,1,0,"EUREKA COLLEGE",NA,NA,121,72,49,49,17,32,0.444,0.405,0.347,15850,102
"2613",144971,2001,1,0,"EUREKA COLLEGE",NA,NA,146,75,71,60,26,34,0.453,0.411,0.366,16600,125
"2614",144971,2002,1,0,"EUREKA COLLEGE",NA,NA,136,70,66,50,16,34,0.486,0.368,0.242,17430,106
"2615",144971,2003,1,0,"EUREKA COLLEGE",NA,NA,92,44,48,15,5,10,0.227,0.163,0.104,18700,79
"2616",144971,2004,1,0,"EUREKA COLLEGE",NA,NA,116,57,59,35,15,20,0.351,0.302,0.254,13000,97
"2617",144971,2005,1,0,"Eureka College",NA,NA,138,74,64,66,29,37,0.5,0.478,0.453,13000,120
"2618",144971,2006,1,0,"Eureka College",NA,NA,137,74,63,54,26,28,0.378,0.394,0.413,13760,120
"2619",144971,2007,1,0,"Eureka College",NA,NA,122,73,49,53,15,38,0.52,0.434,0.306,14800,112
"2620",144971,2008,1,0,"Eureka College",NA,NA,153,75,78,53,18,35,0.467,0.346,0.231,15675,125
"2621",144971,2009,1,0,"Eureka College",NA,NA,143,75,68,55,23,32,0.427,0.385,0.338,16650,125
"2622",144971,2010,1,0,"Eureka College",NA,NA,174,92,82,70,30,40,0.435,0.402,0.366,17275,148
"2623",145600,1991,1,0,"UNIVERSITY OF ILLINOIS AT CHICAGO",NA,NA,2356,1233,1123,197,83,114,0.092,0.084,0.074,3077,960
"2624",145600,1992,1,0,"UNIVERSITY OF ILLINOIS AT CHICAGO",NA,NA,2475,1273,1202,240,95,145,0.114,0.097,0.079,3371,995
"2625",145600,1993,1,0,"UNIVERSITY OF ILLINOIS AT CHICAGO",NA,NA,2589,1360,1229,229,85,144,0.106,0.088,0.069,3439,1022
"2626",145600,1995,1,0,"UNIVERSITY OF ILLINOIS AT CHICAGO",NA,NA,2469,1401,1068,309,110,199,0.142,0.125,0.103,3974,1024
"2627",145600,1996,1,0,"UNIVERSITY OF ILLINOIS AT CHICAGO",NA,NA,2720,1505,1215,454,179,275,0.183,0.167,0.147,4188,1176
"2628",145600,1997,1,0,"UNIVERSITY OF ILLINOIS AT CHICAGO",NA,NA,2820,1560,1260,460,165,295,0.189,0.163,0.131,4358,1107
"2629",145600,1998,1,0,"UNIVERSITY OF ILLINOIS AT CHICAGO",NA,NA,2880,1629,1251,465,166,299,0.184,0.161,0.133,4498,1143
"2630",145600,1999,1,0,"UNIVERSITY OF ILLINOIS AT CHICAGO",NA,NA,2552,1381,1171,506,215,291,0.211,0.198,0.184,3138,1039
"2631",145600,2000,1,0,"UNIVERSITY OF ILLINOIS AT CHICAGO",NA,NA,2762,1557,1205,588,203,385,0.247,0.213,0.168,3232,1069
"2632",145600,2001,1,0,"UNIVERSITY OF ILLINOIS AT CHICAGO",NA,NA,2637,1470,1167,590,210,380,0.258,0.224,0.18,3830,1084
"2633",145600,2002,1,0,"UNIVERSITY OF ILLINOIS AT CHICAGO",NA,NA,2952,1674,1278,607,248,359,0.214,0.206,0.194,4664,1179
"2634",145600,2003,1,0,"UNIVERSITY OF ILLINOIS AT CHICAGO",NA,NA,2880,1573,1307,702,275,427,0.272,0.244,0.21,4898,1095
"2635",145600,2004,1,0,"UNIVERSITY OF ILLINOIS AT CHICAGO",NA,NA,2671,1488,1183,681,278,403,0.271,0.255,0.235,5682,983
"2636",145600,2005,1,0,"University of Illinois at Chicago",NA,NA,2759,1534,1225,742,294,448,0.292,0.269,0.24,6194,1009
"2637",145600,2006,1,0,"University of Illinois at Chicago",NA,NA,2830,1554,1276,878,380,498,0.32,0.31,0.298,6780,1153
"2638",145600,2007,1,0,"University of Illinois at Chicago",NA,NA,3272,1813,1459,978,390,588,0.324,0.299,0.267,7424,1335
"2639",145600,2008,1,0,"University of Illinois at Chicago",NA,NA,2944,1659,1285,981,392,589,0.355,0.333,0.305,8130,1178
"2640",145600,2009,1,0,"University of Illinois at Chicago",NA,NA,3126,1680,1446,1056,411,645,0.384,0.338,0.284,8342,1209
"2641",145600,2010,1,0,"University of Illinois at Chicago",NA,NA,3185,1731,1454,984,387,597,0.345,0.309,0.266,9133,1191
"2642",145619,1991,1,0,"ILLINOIS BENEDICTINE COLLEGE",NA,NA,246,117,129,87,37,50,0.427,0.354,0.287,8980,165
"2643",145619,1992,1,0,"ILLINOIS BENEDICTINE COLLEGE",NA,NA,230,110,120,102,43,59,0.536,0.443,0.358,9300,159
"2644",145619,1993,1,0,"ILLINOIS BENEDICTINE COLLEGE",NA,NA,270,125,145,104,43,61,0.488,0.385,0.297,9950,205
"2645",145619,1995,1,0,"BENEDICTINE UNIVERSITY",NA,NA,245,123,122,95,38,57,0.463,0.388,0.311,11030,160
"2646",145619,1996,1,0,"BENEDICTINE UNIVERSITY",NA,NA,231,112,119,82,30,52,0.464,0.355,0.252,11790,141
"2647",145619,1997,1,0,"BENEDICTINE UNIVERSITY",NA,NA,300,129,171,117,56,61,0.473,0.39,0.327,11990,191
"2648",145619,1998,1,0,"BENEDICTINE UNIVERSITY",NA,NA,299,160,139,93,35,58,0.362,0.311,0.252,12600,173
"2649",145619,1999,1,0,"BENEDICTINE UNIVERSITY",NA,NA,259,127,132,74,30,44,0.346,0.286,0.227,13700,145
"2650",145619,2000,1,0,"BENEDICTINE UNIVERSITY",NA,NA,278,156,122,114,45,69,0.442,0.41,0.369,14500,103
"2651",145619,2001,1,0,"BENEDICTINE UNIVERSITY",NA,NA,262,159,103,120,41,79,0.497,0.458,0.398,15200,125
"2652",145619,2002,1,0,"BENEDICTINE UNIVERSITY",NA,NA,303,165,138,150,56,94,0.57,0.495,0.406,16250,161
"2653",145619,2003,1,0,"BENEDICTINE UNIVERSITY",NA,NA,302,169,133,116,49,67,0.396,0.384,0.368,16960,137
"2654",145619,2004,1,0,"BENEDICTINE UNIVERSITY",NA,NA,301,151,150,121,53,68,0.45,0.402,0.353,17800,125
"2655",145619,2005,1,0,"Benedictine University",NA,NA,308,163,145,97,42,55,0.337,0.315,0.29,18700,98
"2656",145619,2006,1,0,"Benedictine University",NA,NA,379,189,190,139,57,82,0.434,0.367,0.3,19800,167
"2657",145619,2007,1,0,"Benedictine University",NA,NA,385,185,200,146,68,78,0.422,0.379,0.34,20800,159
"2658",145619,2008,1,0,"Benedictine University",NA,NA,434,227,207,141,57,84,0.37,0.325,0.275,21600,142
"2659",145619,2009,1,0,"Benedictine University",NA,NA,451,215,236,156,68,88,0.409,0.346,0.288,21600,169
"2660",145619,2010,1,0,"Benedictine University",NA,NA,548,311,237,197,63,134,0.431,0.359,0.266,22500,190
"2661",145637,1991,1,0,"UNIVERSITY OF ILLINOIS URBANA CAMPUS",NA,NA,5649,2615,3034,2770,1300,1470,0.562,0.49,0.428,3184,4125
"2662",145637,1992,1,0,"UNIVERSITY OF ILLINOIS URBANA CAMPUS",NA,NA,5491,2566,2925,2656,1267,1389,0.541,0.484,0.433,3458,3918
"2663",145637,1993,1,0,"UNIVERSITY OF ILLINOIS AT URBANA",NA,NA,5705,2588,3117,2665,1307,1358,0.525,0.467,0.419,3506,4068
"2664",145637,1995,1,0,"UNIVERSITY OF ILLINOIS AT URBANA",NA,NA,6101,2944,3157,3312,1492,1820,0.618,0.543,0.473,3958,4379
"2665",145637,1996,1,0,"UNIVERSITY OF ILLINOIS AT URBANA",NA,NA,5938,2865,3073,3321,1507,1814,0.633,0.559,0.49,4153,4184
"2666",145637,1997,1,0,"UNIVERSITY OF ILLINOIS AT URBANA",NA,NA,5789,2865,2924,3331,1523,1808,0.631,0.575,0.521,4340,4051
"2667",145637,1998,1,0,"UNIVERSITY OF ILLINOIS AT URBANA",NA,NA,6453,3174,3279,3729,1680,2049,0.646,0.578,0.512,4554,4500
"2668",145637,1999,1,0,"UNIVERSITY OF ILLINOIS AT URBANA",NA,NA,6458,3131,3327,3849,1733,2116,0.676,0.596,0.521,3546,4521
"2669",145637,2000,1,0,"UNIVERSITY OF ILLINOIS AT URBANA-CHAMPAIGN",NA,NA,6167,2990,3177,3737,1692,2045,0.684,0.606,0.533,3724,4241
"2670",145637,2001,1,0,"UNIVERSITY OF ILLINOIS AT URBANA-CHAMPAIGN",NA,NA,6234,3008,3226,3886,1789,2097,0.697,0.623,0.555,4410,4149
"2671",145637,2002,1,0,"UNIVERSITY OF ILLINOIS AT URBANA-CHAMPAIGN",NA,NA,6354,3120,3234,4027,1814,2213,0.709,0.634,0.561,5302,4322
"2672",145637,2003,1,0,"UNIVERSITY OF ILLINOIS AT URBANA-CHAMPAIGN",NA,NA,6807,3268,3539,4390,2070,2320,0.71,0.645,0.585,5568,4543
"2673",145637,2004,1,0,"UNIVERSITY OF ILLINOIS AT URBANA-CHAMPAIGN",NA,NA,7225,3555,3670,4848,2215,2633,0.741,0.671,0.604,6460,4897
"2674",145637,2005,1,0,"University of Illinois at Urbana-Champaign",NA,NA,7565,3511,4054,4966,2375,2591,0.738,0.656,0.586,7042,5099
"2675",145637,2006,1,0,"University of Illinois at Urbana-Champaign",NA,NA,7152,3518,3634,4881,2256,2625,0.746,0.682,0.621,7708,4656
"2676",145637,2007,1,0,"University of Illinois at Urbana-Champaign",NA,NA,6930,3295,3635,4722,2281,2441,0.741,0.681,0.628,8440,4412
"2677",145637,2008,1,0,"University of Illinois at Urbana-Champaign",NA,NA,7277,3386,3891,5015,2439,2576,0.761,0.689,0.627,9242,4416
"2678",145637,2009,1,0,"University of Illinois at Urbana-Champaign",NA,NA,6974,3332,3642,4938,2317,2621,0.787,0.708,0.636,9484,4310
"2679",145637,2010,1,0,"University of Illinois at Urbana-Champaign",NA,NA,6921,3054,3867,4823,2414,2409,0.789,0.697,0.624,11003,3940
"2680",145691,1991,1,0,"ILLINOIS COLLEGE",NA,NA,241,117,124,85,39,46,0.393,0.353,0.315,6600,232
"2681",145691,1992,1,0,"ILLINOIS COLLEGE",NA,NA,260,136,124,114,35,79,0.581,0.438,0.282,7050,255
"2682",145691,1993,1,0,"ILLINOIS COLLEGE",NA,NA,261,150,111,113,34,79,0.527,0.433,0.306,7550,253
"2683",145691,1995,1,0,"ILLINOIS COLLEGE",NA,NA,223,139,84,98,30,68,0.489,0.439,0.357,8600,216
"2684",145691,1996,1,0,"ILLINOIS COLLEGE",NA,NA,200,123,77,87,22,65,0.528,0.435,0.286,9150,191
"2685",145691,1997,1,0,"ILLINOIS COLLEGE",NA,NA,242,148,94,102,30,72,0.486,0.421,0.319,9500,230
"2686",145691,1998,1,0,"ILLINOIS COLLEGE",NA,NA,238,133,105,107,37,70,0.526,0.45,0.352,9850,224
"2687",145691,1999,1,0,"ILLINOIS COLLEGE",NA,NA,241,131,110,97,34,63,0.481,0.402,0.309,10200,224
"2688",145691,2000,1,0,"ILLINOIS COLLEGE",NA,NA,239,128,111,102,32,70,0.547,0.427,0.288,10735,216
"2689",145691,2001,1,0,"ILLINOIS COLLEGE",NA,NA,205,113,92,94,37,57,0.504,0.459,0.402,11272,190
"2690",145691,2002,1,0,"ILLINOIS COLLEGE",NA,NA,306,170,136,156,60,96,0.565,0.51,0.441,11850,287
"2691",145691,2003,1,0,"ILLINOIS COLLEGE",NA,NA,318,180,138,157,59,98,0.544,0.494,0.428,13300,285
"2692",145691,2004,1,0,"ILLINOIS COLLEGE",NA,NA,258,136,122,135,49,86,0.632,0.523,0.402,14600,237
"2693",145691,2005,1,0,"Illinois College",NA,NA,256,117,139,124,60,64,0.547,0.484,0.432,15500,232
"2694",145691,2006,1,0,"Illinois College",NA,NA,293,154,139,148,49,99,0.643,0.505,0.353,16610,260
"2695",145691,2007,1,0,"Illinois College",NA,NA,258,125,133,144,58,86,0.688,0.558,0.436,17600,228
"2696",145691,2008,1,0,"Illinois College",NA,NA,166,84,82,110,51,59,0.702,0.663,0.622,18500,136
"2697",145691,2009,1,0,"Illinois College",NA,NA,224,99,125,139,71,68,0.687,0.621,0.568,20900,191
"2698",145691,2010,1,0,"Illinois College",NA,NA,225,113,112,134,58,76,0.673,0.596,0.518,22350,169
"2699",145813,1991,1,0,"ILLINOIS STATE UNIVERSITY",NA,NA,3055,1757,1298,849,286,563,0.32,0.278,0.22,2430,2588
"2700",145813,1992,1,0,"ILLINOIS STATE UNIVERSITY",NA,NA,2898,1706,1192,772,229,543,0.318,0.266,0.192,2871,2457
"2701",145813,1993,1,0,"ILLINOIS STATE UNIVERSITY",NA,NA,2387,1440,947,648,183,465,0.323,0.271,0.193,3253,1915
"2702",145813,1995,1,0,"ILLINOIS STATE UNIVERSITY",NA,NA,2950,1798,1152,823,240,583,0.324,0.279,0.208,3544,2460
"2703",145813,1996,1,0,"ILLINOIS STATE UNIVERSITY",NA,NA,2888,1793,1095,877,245,632,0.352,0.304,0.224,3720,2416
"2704",145813,1997,1,0,"ILLINOIS STATE UNIVERSITY",NA,NA,3253,1981,1272,1016,297,719,0.363,0.312,0.233,3969,2723
"2705",145813,1998,1,0,"ILLINOIS STATE UNIVERSITY",NA,NA,2740,1728,1012,915,268,647,0.374,0.334,0.265,4085,2281
"2706",145813,1999,1,0,"ILLINOIS STATE UNIVERSITY",NA,NA,3067,1907,1160,1072,301,771,0.404,0.35,0.259,3127,2690
"2707",145813,2000,1,0,"ILLINOIS STATE UNIVERSITY",NA,NA,3254,1996,1258,1204,347,857,0.429,0.37,0.276,3219,2891
"2708",145813,2001,1,0,"ILLINOIS STATE UNIVERSITY",NA,NA,3331,2080,1251,1316,364,952,0.458,0.395,0.291,3332,2943
"2709",145813,2002,1,0,"ILLINOIS STATE UNIVERSITY",NA,NA,3097,1933,1164,1279,366,913,0.472,0.413,0.314,3640,2763
"2710",145813,2003,1,0,"ILLINOIS STATE UNIVERSITY",NA,NA,3088,1934,1154,1294,411,883,0.457,0.419,0.356,3640,2639
"2711",145813,2004,1,0,"ILLINOIS STATE UNIVERSITY",NA,NA,2824,1739,1085,1280,392,888,0.511,0.453,0.361,4800,2290
"2712",145813,2005,1,0,"Illinois State University",NA,NA,3167,1970,1197,1388,419,969,0.492,0.438,0.35,5400,2541
"2713",145813,2006,1,0,"Illinois State University",NA,NA,3188,1915,1273,1496,471,1025,0.535,0.469,0.37,6150,2681
"2714",145813,2007,1,0,"Illinois State University",NA,NA,3140,1887,1253,1457,455,1002,0.531,0.464,0.363,6999,2650
"2715",145813,2008,1,0,"Illinois State University",NA,NA,3387,2088,1299,1545,503,1042,0.499,0.456,0.387,7680,2838
"2716",145813,2009,1,0,"Illinois State University",NA,NA,3060,1816,1244,1462,500,962,0.53,0.478,0.402,8280,2413
"2717",145813,2010,1,0,"Illinois State University",NA,NA,3179,1914,1265,1512,499,1013,0.529,0.476,0.394,8051,2591
"2718",146481,1991,1,0,"LAKE FOREST COLLEGE",NA,NA,234,124,110,123,53,70,0.565,0.526,0.482,13895,201
"2719",146481,1992,1,0,"LAKE FOREST COLLEGE",NA,NA,235,123,112,145,66,79,0.642,0.617,0.589,15085,183
"2720",146481,1993,1,0,"LAKE FOREST COLLEGE",NA,NA,271,140,131,148,65,83,0.593,0.546,0.496,16175,224
"2721",146481,1995,1,0,"LAKE FOREST COLLEGE",NA,NA,266,155,111,156,58,98,0.632,0.586,0.523,18116,218
"2722",146481,1996,1,0,"LAKE FOREST COLLEGE",NA,NA,324,152,172,188,90,98,0.645,0.58,0.523,19000,254
"2723",146481,1997,1,0,"LAKE FOREST COLLEGE",NA,NA,337,191,146,205,77,128,0.67,0.608,0.527,19560,264
"2724",146481,1998,1,0,"LAKE FOREST COLLEGE",NA,NA,302,177,125,167,63,104,0.588,0.553,0.504,20080,246
"2725",146481,1999,1,0,"LAKE FOREST COLLEGE",NA,NA,341,208,133,216,80,136,0.654,0.633,0.602,20240,270
"2726",146481,2000,1,0,"LAKE FOREST COLLEGE",NA,NA,335,187,148,194,78,116,0.62,0.579,0.527,20900,282
"2727",146481,2001,1,0,"LAKE FOREST COLLEGE",NA,NA,336,188,148,214,83,131,0.697,0.637,0.561,21896,256
"2728",146481,2002,1,0,"LAKE FOREST COLLEGE",NA,NA,358,219,139,213,71,142,0.648,0.595,0.511,22976,270
"2729",146481,2003,1,0,"LAKE FOREST COLLEGE",NA,NA,347,194,153,203,86,117,0.603,0.585,0.562,24096,260
"2730",146481,2004,1,0,"LAKE FOREST COLLEGE",NA,NA,405,247,158,257,83,174,0.705,0.635,0.525,25518,322
"2731",146481,2005,1,0,"Lake Forest College",NA,NA,358,202,156,213,78,135,0.668,0.595,0.5,27000,276
"2732",146481,2006,1,0,"Lake Forest College",NA,NA,386,224,162,241,96,145,0.647,0.624,0.593,28700,303
"2733",146481,2007,1,0,"Lake Forest College",NA,NA,356,214,142,208,75,133,0.622,0.584,0.528,30600,273
"2734",146481,2008,1,0,"Lake Forest College",NA,NA,378,218,160,242,85,157,0.72,0.64,0.531,32130,261
"2735",146481,2009,1,0,"Lake Forest College",NA,NA,354,213,141,232,81,151,0.709,0.655,0.574,33576,248
"2736",146481,2010,1,0,"Lake Forest College",NA,NA,402,238,164,258,98,160,0.672,0.642,0.598,34885,232
"2737",146612,1991,1,0,"LEWIS UNIVERSITY",NA,NA,387,166,221,122,59,63,0.38,0.315,0.267,8502,302
"2738",146612,1992,1,0,"LEWIS UNIVERSITY",NA,NA,345,161,184,84,34,50,0.311,0.243,0.185,9536,278
"2739",146612,1993,1,0,"LEWIS UNIVERSITY",NA,NA,344,155,189,109,49,60,0.387,0.317,0.259,10112,252
"2740",146612,1995,1,0,"LEWIS UNIVERSITY",NA,NA,331,158,173,104,49,55,0.348,0.314,0.283,11008,219
"2741",146612,1996,1,0,"LEWIS UNIVERSITY",NA,NA,312,137,175,120,57,63,0.46,0.385,0.326,11552,219
"2742",146612,1997,1,0,"LEWIS UNIVERSITY",NA,NA,386,176,210,145,70,75,0.426,0.376,0.333,12416,252
"2743",146612,1998,1,0,"LEWIS UNIVERSITY",NA,NA,391,193,198,151,64,87,0.451,0.386,0.323,13024,254
"2744",146612,1999,1,0,"LEWIS UNIVERSITY",NA,NA,425,194,231,171,82,89,0.459,0.402,0.355,13664,290
"2745",146612,2000,1,0,"LEWIS UNIVERSITY",NA,NA,427,183,244,127,69,58,0.317,0.297,0.283,14208,293
"2746",146612,2001,1,0,"LEWIS UNIVERSITY",NA,NA,384,191,193,126,52,74,0.387,0.328,0.269,14976,272
"2747",146612,2002,1,0,"LEWIS UNIVERSITY",NA,NA,366,161,205,132,66,66,0.41,0.361,0.322,15250,272
"2748",146612,2003,1,0,"LEWIS UNIVERSITY",NA,NA,458,224,234,179,86,93,0.415,0.391,0.368,15950,321
"2749",146612,2004,1,0,"LEWIS UNIVERSITY",NA,NA,509,275,234,186,81,105,0.382,0.365,0.346,16906,369
"2750",146612,2005,1,0,"Lewis University",NA,NA,557,321,236,232,92,140,0.436,0.417,0.39,17990,404
"2751",146612,2006,1,0,"Lewis University",NA,NA,568,323,245,223,94,129,0.399,0.393,0.384,19200,405
"2752",146612,2007,1,0,"Lewis University",NA,NA,634,365,269,283,131,152,0.416,0.446,0.487,20450,435
"2753",146612,2008,1,0,"Lewis University",NA,NA,650,345,305,272,127,145,0.42,0.418,0.416,21990,435
"2754",146612,2009,1,0,"Lewis University",NA,NA,653,360,293,288,114,174,0.483,0.441,0.389,22990,433
"2755",146612,2010,1,0,"Lewis University",NA,NA,632,319,313,257,126,131,0.411,0.407,0.403,23780,387
"2756",146719,1991,1,0,"LOYOLA UNIVERSITY OF CHICAGO",NA,NA,922,593,329,347,119,228,0.385,0.376,0.362,9270,579
"2757",146719,1992,1,0,"LOYOLA UNIVERSITY OF CHICAGO",NA,NA,985,587,398,377,143,234,0.399,0.383,0.359,9840,707
"2758",146719,1993,1,0,"LOYOLA UNIVERSITY OF CHICAGO",NA,NA,856,511,345,366,141,225,0.44,0.428,0.409,10470,562
"2759",146719,1995,1,0,"LOYOLA UNIVERSITY OF CHICAGO",NA,NA,1182,733,449,544,167,377,0.514,0.46,0.372,13000,793
"2760",146719,1996,1,0,"LOYOLA UNIVERSITY OF CHICAGO",NA,NA,1063,690,373,562,175,387,0.561,0.529,0.469,14400,677
"2761",146719,1997,1,0,"LOYOLA UNIVERSITY OF CHICAGO",NA,NA,1189,758,431,558,189,369,0.487,0.469,0.439,15654,739
"2762",146719,1998,1,0,"LOYOLA UNIVERSITY OF CHICAGO",NA,NA,1340,868,472,641,208,433,0.499,0.478,0.441,16600,819
"2763",146719,1999,1,0,"LOYOLA UNIVERSITY CHICAGO",NA,NA,1067,717,350,541,169,372,0.519,0.507,0.483,17750,638
"2764",146719,2000,1,0,"LOYOLA UNIVERSITY CHICAGO",NA,NA,889,585,304,542,164,378,0.646,0.61,0.539,18266,566
"2765",146719,2001,1,0,"LOYOLA UNIVERSITY CHICAGO",NA,NA,1424,960,464,674,202,472,0.492,0.473,0.435,18814,875
"2766",146719,2002,1,0,"LOYOLA UNIVERSITY CHICAGO",NA,NA,1623,1069,554,821,261,560,0.524,0.506,0.471,19472,1005
"2767",146719,2003,1,0,"LOYOLA UNIVERSITY CHICAGO",NA,NA,1915,1292,623,924,296,628,0.486,0.483,0.475,20544,1172
"2768",146719,2004,1,0,"LOYOLA UNIVERSITY CHICAGO",NA,NA,1787,1176,611,856,296,560,0.476,0.479,0.484,21780,1101
"2769",146719,2005,1,0,"Loyola University Chicago",NA,NA,2080,1365,715,1053,346,707,0.518,0.506,0.484,23500,1316
"2770",146719,2006,1,0,"Loyola University Chicago",NA,NA,2134,1426,708,1104,357,747,0.524,0.517,0.504,24580,1381
"2771",146719,2007,1,0,"Loyola University Chicago",NA,NA,2035,1377,658,1215,371,844,0.613,0.597,0.564,27200,1349
"2772",146719,2008,1,0,"Loyola University Chicago",NA,NA,2176,1460,716,1419,448,971,0.665,0.652,0.626,28700,1541
"2773",146719,2009,1,0,"Loyola University Chicago",NA,NA,2076,1358,718,1323,434,889,0.655,0.637,0.604,29850,1410
"2774",146719,2010,1,0,"Loyola University-Chicago",NA,NA,2063,1315,748,1342,444,898,0.683,0.651,0.594,31040,1400
"2775",146825,1991,1,0,"MACMURRAY COLLEGE",NA,NA,185,89,96,83,28,55,0.618,0.449,0.292,8150,160
"2776",146825,1992,1,0,"MACMURRAY COLLEGE",NA,NA,171,84,87,67,23,44,0.524,0.392,0.264,8620,155
"2777",146825,1993,1,0,"MACMURRAY COLLEGE",NA,NA,151,72,79,64,21,43,0.597,0.424,0.266,9160,130
"2778",146825,1995,1,0,"MACMURRAY COLLEGE",NA,NA,175,75,100,50,12,38,0.507,0.286,0.12,10190,156
"2779",146825,1996,1,0,"MACMURRAY COLLEGE",NA,NA,156,90,66,54,15,39,0.433,0.346,0.227,10940,134
"2780",146825,1997,1,0,"MACMURRAY COLLEGE",NA,NA,127,49,78,47,24,23,0.469,0.37,0.308,11400,109
"2781",146825,1998,1,0,"MACMURRAY COLLEGE",NA,NA,163,79,84,59,22,37,0.468,0.362,0.262,11820,142
"2782",146825,1999,1,0,"MACMURRAY COLLEGE",NA,NA,187,80,107,55,25,30,0.375,0.294,0.234,12300,138
"2783",146825,2000,1,0,"MACMURRAY COLLEGE",NA,NA,199,97,102,55,20,35,0.361,0.276,0.196,13140,158
"2784",146825,2001,1,0,"MACMURRAY COLLEGE",NA,NA,144,65,79,37,14,23,0.354,0.257,0.177,14000,107
"2785",146825,2002,1,0,"MACMURRAY COLLEGE",NA,NA,127,72,55,46,14,32,0.444,0.362,0.255,14500,103
"2786",146825,2003,1,0,"MACMURRAY COLLEGE",NA,NA,162,79,83,48,17,31,0.392,0.296,0.205,14500,113
"2787",146825,2004,1,0,"MACMURRAY COLLEGE",NA,NA,152,74,78,37,17,20,0.27,0.243,0.218,14500,115
"2788",146825,2005,1,0,"MacMurray College",NA,NA,159,77,82,35,10,25,0.325,0.22,0.122,15000,110
"2789",146825,2006,1,0,"MacMurray College",NA,NA,166,86,80,41,14,27,0.314,0.247,0.175,15500,114
"2790",146825,2007,1,0,"MacMurray College",NA,NA,125,73,52,35,3,32,0.438,0.28,0.058,16400,89
"2791",146825,2008,1,0,"MacMurray College",NA,NA,90,36,54,21,8,13,0.361,0.233,0.148,17000,59
"2792",146825,2009,1,0,"MacMurray College",NA,NA,96,34,62,19,6,13,0.382,0.198,0.097,17940,61
"2793",146825,2010,1,0,"MacMurray College",NA,NA,90,39,51,10,4,6,0.154,0.111,0.078,18838,52
"2794",147013,1991,1,0,"MCKENDREE COLLEGE",NA,NA,132,79,53,46,15,31,0.392,0.348,0.283,6746,114
"2795",147013,1992,1,0,"MCKENDREE COLLEGE",NA,NA,134,82,52,53,19,34,0.415,0.396,0.365,7066,118
"2796",147013,1993,1,0,"MCKENDREE COLLEGE",NA,NA,119,72,47,34,12,22,0.306,0.286,0.255,7450,99
"2797",147013,1995,1,0,"MCKENDREE COLLEGE",NA,NA,188,109,79,54,16,38,0.349,0.287,0.203,8640,175
"2798",147013,1996,1,0,"MCKENDREE COLLEGE",NA,NA,309,142,167,106,46,60,0.422,0.343,0.275,9600,282
"2799",147013,1997,1,0,"MCKENDREE COLLEGE",NA,NA,242,131,111,98,35,63,0.481,0.405,0.315,10400,220
"2800",147013,1998,1,0,"MCKENDREE COLLEGE",NA,NA,247,139,108,91,24,67,0.482,0.368,0.222,11200,213
"2801",147013,1999,1,0,"MCKENDREE COLLEGE",NA,NA,246,164,82,101,27,74,0.451,0.411,0.329,12000,211
"2802",147013,2000,1,0,"MCKENDREE COLLEGE",NA,NA,265,154,111,97,35,62,0.403,0.366,0.315,12300,239
"2803",147013,2001,1,0,"MCKENDREE COLLEGE",NA,NA,284,168,116,128,35,93,0.554,0.451,0.302,13350,244
"2804",147013,2002,1,0,"MCKENDREE COLLEGE",NA,NA,258,135,123,127,48,79,0.585,0.492,0.39,14200,229
"2805",147013,2003,1,0,"MCKENDREE COLLEGE",NA,NA,287,124,163,113,55,58,0.468,0.394,0.337,15200,224
"2806",147013,2004,1,0,"MCKENDREE COLLEGE",NA,NA,337,134,203,122,55,67,0.5,0.362,0.271,16400,269
"2807",147013,2005,1,0,"McKendree College",NA,NA,273,126,147,94,39,55,0.436,0.344,0.265,17500,209
"2808",147013,2006,1,0,"McKendree College",NA,NA,343,162,181,114,40,74,0.457,0.332,0.221,18300,265
"2809",147013,2007,1,0,"McKendree University",NA,NA,298,131,167,94,42,52,0.397,0.315,0.251,19500,238
"2810",147013,2008,1,0,"McKendree University",NA,NA,308,145,163,110,40,70,0.483,0.357,0.245,20570,228
"2811",147013,2009,1,0,"McKendree University",NA,NA,305,148,157,102,44,58,0.392,0.334,0.28,21370,231
"2812",147013,2010,1,0,"McKendree University",NA,NA,335,154,181,121,54,67,0.435,0.361,0.298,22330,239
"2813",147244,1991,1,0,"MILLIKIN UNIVERSITY",NA,NA,422,242,180,245,94,151,0.624,0.581,0.522,9990,390
"2814",147244,1992,1,0,"MILLIKIN UNIVERSITY",NA,NA,516,302,214,289,102,187,0.619,0.56,0.477,10590,479
"2815",147244,1993,1,0,"MILLIKIN UNIVERSITY",NA,NA,452,235,217,256,111,145,0.617,0.566,0.512,11240,415
"2816",147244,1995,1,0,"MILLIKIN UNIVERSITY",NA,NA,494,272,222,248,98,150,0.551,0.502,0.441,12596,409
"2817",147244,1996,1,0,"MILLIKIN UNIVERSITY",NA,NA,497,284,213,253,80,173,0.609,0.509,0.376,13290,422
"2818",147244,1997,1,0,"MILLIKIN UNIVERSITY",NA,NA,569,302,267,286,112,174,0.576,0.503,0.419,14138,473
"2819",147244,1998,1,0,"MILLIKIN UNIVERSITY",NA,NA,594,331,263,291,91,200,0.604,0.49,0.346,14758,495
"2820",147244,1999,1,0,"MILLIKIN UNIVERSITY",NA,NA,595,324,271,323,130,193,0.596,0.543,0.48,15348,521
"2821",147244,2000,1,0,"MILLIKIN UNIVERSITY",NA,NA,574,316,258,320,120,200,0.633,0.557,0.465,16192,487
"2822",147244,2001,1,0,"MILLIKIN UNIVERSITY",NA,NA,646,356,290,349,139,210,0.59,0.54,0.479,17084,547
"2823",147244,2002,1,0,"MILLIKIN UNIVERSITY",NA,NA,634,351,283,335,117,218,0.621,0.528,0.413,18109,551
"2824",147244,2003,1,0,"MILLIKIN UNIVERSITY",NA,NA,595,299,296,317,132,185,0.619,0.533,0.446,18834,491
"2825",147244,2004,1,0,"MILLIKIN UNIVERSITY",NA,NA,530,302,228,268,99,169,0.56,0.506,0.434,19900,429
"2826",147244,2005,1,0,"Millikin University",NA,NA,572,313,259,311,119,192,0.613,0.544,0.459,20696,470
"2827",147244,2006,1,0,"Millikin University",NA,NA,475,261,214,214,89,125,0.479,0.451,0.416,21524,386
"2828",147244,2007,1,0,"Millikin University",NA,NA,475,268,207,228,91,137,0.511,0.48,0.44,23250,384
"2829",147244,2008,1,0,"Millikin University",NA,NA,484,298,186,247,83,164,0.55,0.51,0.446,24600,388
"2830",147244,2009,1,0,"Millikin University",NA,NA,541,317,224,259,97,162,0.511,0.479,0.433,25750,421
"2831",147244,2010,1,0,"Millikin University",NA,NA,498,258,240,244,101,143,0.554,0.49,0.421,26780,372
"2832",147341,1991,1,0,"MONMOUTH COLLEGE",NA,NA,252,117,135,113,48,65,0.556,0.448,0.356,12450,222
"2833",147341,1992,1,0,"MONMOUTH COLLEGE",NA,NA,125,67,58,61,23,38,0.567,0.488,0.397,12800,112
"2834",147341,1993,1,0,"MONMOUTH COLLEGE",NA,NA,204,93,111,77,31,46,0.495,0.377,0.279,12900,185
"2835",147341,1995,1,0,"MONMOUTH COLLEGE",NA,NA,308,187,121,156,54,102,0.545,0.506,0.446,13460,284
"2836",147341,1996,1,0,"MONMOUTH COLLEGE",NA,NA,282,167,115,139,52,87,0.521,0.493,0.452,13965,254
"2837",147341,1997,1,0,"MONMOUTH COLLEGE",NA,NA,272,176,96,150,48,102,0.58,0.551,0.5,14420,234
"2838",147341,1998,1,0,"MONMOUTH COLLEGE",NA,NA,320,146,174,170,84,86,0.589,0.531,0.483,15120,271
"2839",147341,1999,1,0,"MONMOUTH COLLEGE",NA,NA,259,155,104,132,44,88,0.568,0.51,0.423,15720,233
"2840",147341,2000,1,0,"MONMOUTH COLLEGE",NA,NA,235,136,99,143,51,92,0.677,0.609,0.515,16370,214
"2841",147341,2001,1,0,"MONMOUTH COLLEGE",NA,NA,258,122,136,128,67,61,0.5,0.496,0.493,17000,236
"2842",147341,2002,1,0,"MONMOUTH COLLEGE",NA,NA,282,147,135,150,61,89,0.605,0.532,0.452,17760,261
"2843",147341,2003,1,0,"MONMOUTH COLLEGE",NA,NA,355,175,180,215,97,118,0.674,0.606,0.539,18600,324
"2844",147341,2004,1,0,"MONMOUTH COLLEGE",NA,NA,389,227,162,169,59,110,0.485,0.434,0.364,19350,349
"2845",147341,2005,1,0,"Monmouth College",NA,NA,367,180,187,140,50,90,0.5,0.381,0.267,20200,325
"2846",147341,2006,1,0,"Monmouth College",NA,NA,392,215,177,172,64,108,0.502,0.439,0.362,21100,310
"2847",147341,2007,1,0,"Monmouth College",NA,NA,393,213,180,223,90,133,0.624,0.567,0.5,22000,344
"2848",147341,2008,1,0,"Monmouth College",NA,NA,383,179,204,182,84,98,0.547,0.475,0.412,24000,319
"2849",147341,2009,1,0,"Monmouth College",NA,NA,378,187,191,183,79,104,0.556,0.484,0.414,24950,296
"2850",147341,2010,1,0,"Monmouth College",NA,NA,355,187,168,168,73,95,0.508,0.473,0.435,26900,249
"2851",147703,1991,1,0,"NORTHERN ILLINOIS UNIVERSITY",NA,NA,3161,1646,1515,651,251,400,0.243,0.206,0.166,2641,2368
"2852",147703,1992,1,0,"NORTHERN ILLINOIS UNIVERSITY",NA,NA,2742,1537,1205,607,211,396,0.258,0.221,0.175,3084,1954
"2853",147703,1993,1,0,"NORTHERN ILLINOIS UNIVERSITY",NA,NA,2380,1320,1060,491,163,328,0.249,0.206,0.154,3339,1633
"2854",147703,1995,1,0,"NORTHERN ILLINOIS UNIVERSITY",NA,NA,2429,1368,1061,582,200,382,0.279,0.24,0.189,3746,1620
"2855",147703,1996,1,0,"NORTHERN ILLINOIS UNIVERSITY",NA,NA,2434,1339,1095,613,246,367,0.274,0.252,0.225,3948,1605
"2856",147703,1997,1,0,"NORTHERN ILLINOIS UNIVERSITY",NA,NA,2673,1444,1229,691,252,439,0.304,0.259,0.205,4122,1855
"2857",147703,1998,1,0,"NORTHERN ILLINOIS UNIVERSITY",NA,NA,2818,1513,1305,682,244,438,0.29,0.242,0.187,4210,1839
"2858",147703,1999,1,0,"NORTHERN ILLINOIS UNIVERSITY",NA,NA,2924,1587,1337,742,285,457,0.288,0.254,0.213,3060,1918
"2859",147703,2000,1,0,"NORTHERN ILLINOIS UNIVERSITY",NA,NA,2765,1341,1424,634,273,361,0.269,0.229,0.192,3150,1748
"2860",147703,2001,1,0,"NORTHERN ILLINOIS UNIVERSITY",NA,NA,2792,1459,1333,725,281,444,0.304,0.26,0.211,3293,1810
"2861",147703,2002,1,0,"NORTHERN ILLINOIS UNIVERSITY",NA,NA,3015,1585,1430,698,283,415,0.262,0.232,0.198,3581,1993
"2862",147703,2003,1,0,"NORTHERN ILLINOIS UNIVERSITY",NA,NA,3229,1635,1594,737,300,437,0.267,0.228,0.188,3956,2097
"2863",147703,2004,1,0,"NORTHERN ILLINOIS UNIVERSITY",NA,NA,2933,1585,1348,807,334,473,0.298,0.275,0.248,4612,2014
"2864",147703,2005,1,0,"Northern Illinois University",NA,NA,3171,1637,1534,826,360,466,0.285,0.26,0.235,5061,2095
"2865",147703,2006,1,0,"Northern Illinois University",NA,NA,3260,1641,1619,903,427,476,0.29,0.277,0.264,5550,2140
"2866",147703,2007,1,0,"Northern Illinois University",NA,NA,2997,1584,1413,793,353,440,0.278,0.265,0.25,6150,1637
"2867",147703,2008,1,0,"Northern Illinois University",NA,NA,2844,1469,1375,718,315,403,0.274,0.252,0.229,6720,1633
"2868",147703,2009,1,0,"Northern Illinois University",NA,NA,2988,1573,1415,754,310,444,0.282,0.252,0.219,7260,1711
"2869",147703,2010,1,0,"Northern Illinois University",NA,NA,2663,1338,1325,625,278,347,0.259,0.235,0.21,7020,1396
"2870",147767,1991,0,1,"NORTHWESTERN UNIVERSITY",9999,0,1945,955,990,1601,782,819,0.858,0.823,0.79,14370,1405
"2871",147767,1992,0,1,"NORTHWESTERN UNIVERSITY",9999,0,1889,948,941,1533,719,814,0.859,0.812,0.764,15075,1364
"2872",147767,1993,0,1,"NORTHWESTERN UNIVERSITY",9999,0,1903,950,953,1566,749,817,0.86,0.823,0.786,15804,1356
"2873",147767,1995,0,1,"NORTHWESTERN UNIVERSITY",9999,0,1948,1066,882,1595,672,923,0.866,0.819,0.762,17184,1235
"2874",147767,1996,0,1,"NORTHWESTERN UNIVERSITY",9999,0,1947,1035,912,1639,719,920,0.889,0.842,0.788,18108,1305
"2875",147767,1997,0,1,"NORTHWESTERN UNIVERSITY",9999,0,1889,959,930,1578,743,835,0.871,0.835,0.799,19152,1206
"2876",147767,1998,0,1,"NORTHWESTERN UNIVERSITY",9999,0,1912,1023,889,1601,706,895,0.875,0.837,0.794,22392,1223
"2877",147767,1999,0,1,"NORTHWESTERN UNIVERSITY",9999,0,1951,1039,912,1657,746,911,0.877,0.849,0.818,23476,1202
"2878",147767,2000,0,1,"NORTHWESTERN UNIVERSITY",9999,0,1876,983,893,1612,731,881,0.896,0.859,0.819,24648,1148
"2879",147767,2001,0,1,"NORTHWESTERN UNIVERSITY",9999,0,1947,1026,921,1682,769,913,0.89,0.864,0.835,25839,1143
"2880",147767,2002,0,1,"NORTHWESTERN UNIVERSITY",9999,0,2000,1075,925,1725,759,966,0.899,0.863,0.821,27108,1199
"2881",147767,2003,0,1,"NORTHWESTERN UNIVERSITY",9999,0,1941,1035,906,1694,753,941,0.909,0.873,0.831,28404,1206
"2882",147767,2004,0,1,"NORTHWESTERN UNIVERSITY",9999,0,1914,1030,884,1652,728,924,0.897,0.863,0.824,29940,1178
"2883",147767,2005,0,1,"Northwestern University",9999,0,1952,1018,934,1669,756,913,0.897,0.855,0.809,31644,1172
"2884",147767,2006,0,1,"Northwestern University",9999,0,2060,1089,971,1768,799,969,0.89,0.858,0.823,33408,1221
"2885",147767,2007,0,1,"Northwestern University",9999,0,1979,1057,922,1705,770,935,0.885,0.862,0.835,35064,1112
"2886",147767,2008,0,1,"Northwestern University",9999,0,2077,1075,1002,1773,822,951,0.885,0.854,0.82,36756,1167
"2887",147767,2009,0,1,"Northwestern University",9999,0,2128,1076,1052,1754,826,928,0.863,0.824,0.785,38463,1186
"2888",147767,2010,0,1,"Northwestern University",9999,0,2126,1125,1001,1785,790,995,0.884,0.84,0.789,39840,1190
"2889",147776,1991,0,1,"NORTHEASTERN ILLINOIS UNIVERSITY",1992,0,724,447,277,17,5,12,0.027,0.023,0.018,2092,314
"2890",147776,1992,1,0,"NORTHEASTERN ILLINOIS UNIVERSITY",1992,1,688,408,280,21,6,15,0.037,0.031,0.021,1834,292
"2891",147776,1993,1,0,"NORTHEASTERN ILLINOIS UNIVERSITY",1992,1,641,374,267,14,3,11,0.029,0.022,0.011,2062,227
"2892",147776,1995,1,0,"NORTHEASTERN ILLINOIS UNIVERSITY",1992,1,812,488,324,20,7,13,0.027,0.025,0.022,2244,316
"2893",147776,1996,1,0,"NORTHEASTERN ILLINOIS UNIVERSITY",1992,1,799,474,325,12,6,6,0.013,0.015,0.018,2352,271
"2894",147776,1997,1,0,"NORTHEASTERN ILLINOIS UNIVERSITY",1992,1,1007,630,377,25,9,16,0.025,0.025,0.024,2469,364
"2895",147776,1998,1,0,"NORTHEASTERN ILLINOIS UNIVERSITY",1992,1,961,594,367,15,3,12,0.02,0.016,0.008,2507,324
"2896",147776,1999,1,0,"NORTHEASTERN ILLINOIS UNIVERSITY",1992,1,943,573,370,22,7,15,0.026,0.023,0.019,2262,304
"2897",147776,2000,1,0,"NORTHEASTERN ILLINOIS UNIVERSITY",1992,1,948,570,378,27,7,20,0.035,0.028,0.019,2340,323
"2898",147776,2001,1,0,"NORTHEASTERN ILLINOIS UNIVERSITY",1992,1,964,622,342,21,7,14,0.022,0.022,0.02,2424,337
"2899",147776,2002,1,0,"NORTHEASTERN ILLINOIS UNIVERSITY",1992,1,977,589,388,27,9,18,0.031,0.028,0.023,2508,331
"2900",147776,2003,1,0,"NORTHEASTERN ILLINOIS UNIVERSITY",1992,1,1046,657,389,36,12,24,0.036,0.034,0.031,2640,361
"2901",147776,2004,1,0,"NORTHEASTERN ILLINOIS UNIVERSITY",1992,1,972,580,392,37,7,30,0.052,0.038,0.018,2976,337
"2902",147776,2005,1,0,"Northeastern Illinois University",1992,1,960,570,390,51,16,35,0.061,0.053,0.041,3840,320
"2903",147776,2006,1,0,"Northeastern Illinois University",1992,1,1022,600,422,40,18,22,0.037,0.039,0.043,4200,300
"2904",147776,2007,1,0,"Northeastern Illinois University",1992,1,870,506,364,36,9,27,0.053,0.041,0.025,4680,298
"2905",147776,2008,1,0,"Northeastern Illinois University",1992,1,952,519,433,48,18,30,0.058,0.05,0.042,5280,269
"2906",147776,2009,1,0,"Northeastern Illinois University",1992,1,996,545,451,50,20,30,0.055,0.05,0.044,5880,273
"2907",147776,2010,1,0,"Northeastern Illinois University",1992,1,976,551,425,37,11,26,0.047,0.038,0.026,5520,274
"2908",147828,1991,1,0,"OLIVET NAZARENE UNIVERSITY",NA,NA,376,209,167,140,42,98,0.469,0.372,0.251,6476,338
"2909",147828,1992,1,0,"OLIVET NAZARENE UNIVERSITY",NA,NA,388,202,186,129,48,81,0.401,0.332,0.258,7050,350
"2910",147828,1993,1,0,"OLIVET NAZARENE UNIVERSITY",NA,NA,421,234,187,169,61,108,0.462,0.401,0.326,7836,386
"2911",147828,1995,1,0,"OLIVET NAZARENE UNIVERSITY",NA,NA,389,217,172,150,60,90,0.415,0.386,0.349,9440,371
"2912",147828,1996,1,0,"OLIVET NAZARENE UNIVERSITY",NA,NA,400,231,169,141,55,86,0.372,0.352,0.325,10166,374
"2913",147828,1997,1,0,"OLIVET NAZARENE UNIVERSITY",NA,NA,426,229,197,170,53,117,0.511,0.399,0.269,10840,385
"2914",147828,1998,1,0,"OLIVET NAZARENE UNIVERSITY",NA,NA,428,227,201,159,59,100,0.44,0.371,0.294,11728,382
"2915",147828,1999,1,0,"OLIVET NAZARENE UNIVERSITY",NA,NA,410,224,186,169,61,108,0.482,0.412,0.328,11528,365
"2916",147828,2000,1,0,"OLIVET NAZARENE UNIVERSITY",NA,NA,468,278,190,187,61,126,0.453,0.4,0.321,11928,421
"2917",147828,2001,1,0,"OLIVET NAZARENE UNIVERSITY",NA,NA,541,297,244,240,90,150,0.505,0.444,0.369,12644,480
"2918",147828,2002,1,0,"OLIVET NAZARENE UNIVERSITY",NA,NA,553,328,225,274,95,179,0.546,0.495,0.422,13400,490
"2919",147828,2003,1,0,"OLIVET NAZARENE UNIVERSITY",NA,NA,578,339,239,252,93,159,0.469,0.436,0.389,14160,506
"2920",147828,2004,1,0,"OLIVET NAZARENE UNIVERSITY",NA,NA,699,427,272,338,97,241,0.564,0.484,0.357,14900,613
"2921",147828,2005,1,0,"Olivet Nazarene University",NA,NA,669,404,265,294,94,200,0.495,0.439,0.355,15650,560
"2922",147828,2006,1,0,"Olivet Nazarene University",NA,NA,751,414,337,332,126,206,0.498,0.442,0.374,16750,654
"2923",147828,2007,1,0,"Olivet Nazarene University",NA,NA,704,384,320,343,135,208,0.542,0.487,0.422,18750,609
"2924",147828,2008,1,0,"Olivet Nazarene University",NA,NA,590,357,233,260,76,184,0.515,0.441,0.326,20750,505
"2925",147828,2009,1,0,"Olivet Nazarene University",NA,NA,771,447,324,395,134,261,0.584,0.512,0.414,22750,677
"2926",147828,2010,1,0,"Olivet Nazarene University",NA,NA,740,417,323,344,128,216,0.518,0.465,0.396,24750,628
"2927",148131,1991,1,0,"QUINCY COLLEGE",NA,NA,296,153,143,105,44,61,0.399,0.355,0.308,8604,278
"2928",148131,1992,1,0,"QUINCY COLLEGE",NA,NA,313,148,165,80,24,56,0.378,0.256,0.145,9160,285
"2929",148131,1993,1,0,"QUINCY UNIVERSITY",NA,NA,297,134,163,71,33,38,0.284,0.239,0.202,9532,262
"2930",148131,1995,1,0,"QUINCY UNIVERSITY",NA,NA,259,126,133,89,30,59,0.468,0.344,0.226,10910,230
"2931",148131,1996,1,0,"QUINCY UNIVERSITY",NA,NA,283,135,148,112,50,62,0.459,0.396,0.338,11510,243
"2932",148131,1997,1,0,"QUINCY UNIVERSITY",NA,NA,224,116,108,77,26,51,0.44,0.344,0.241,12410,199
"2933",148131,1998,1,0,"QUINCY UNIVERSITY",NA,NA,232,122,110,109,43,66,0.541,0.47,0.391,13370,204
"2934",148131,1999,1,0,"QUINCY UNIVERSITY",NA,NA,273,148,125,98,36,62,0.419,0.359,0.288,13450,223
"2935",148131,2000,1,0,"QUINCY UNIVERSITY",NA,NA,235,137,98,81,25,56,0.409,0.345,0.255,14300,201
"2936",148131,2001,1,0,"QUINCY UNIVERSITY",NA,NA,231,119,112,83,32,51,0.429,0.359,0.286,15010,190
"2937",148131,2002,1,0,"QUINCY UNIVERSITY",NA,NA,229,112,117,88,33,55,0.491,0.384,0.282,15910,197
"2938",148131,2003,1,0,"QUINCY UNIVERSITY",NA,NA,222,108,114,68,32,36,0.333,0.306,0.281,16400,179
"2939",148131,2004,1,0,"QUINCY UNIVERSITY",NA,NA,228,124,104,75,27,48,0.387,0.329,0.26,17140,167
"2940",148131,2005,1,0,"Quincy University",NA,NA,202,99,103,69,28,41,0.414,0.342,0.272,17800,150
"2941",148131,2006,1,0,"Quincy University",NA,NA,161,88,73,67,27,40,0.454,0.416,0.37,18450,131
"2942",148131,2007,1,0,"Quincy University",NA,NA,234,104,130,92,42,50,0.481,0.393,0.323,18950,170
"2943",148131,2008,1,0,"Quincy University",NA,NA,245,108,137,81,31,50,0.463,0.331,0.226,20100,176
"2944",148131,2009,1,0,"Quincy University",NA,NA,248,127,121,81,31,50,0.394,0.327,0.256,21300,180
"2945",148131,2010,1,0,"Quincy University",NA,NA,272,136,136,94,44,50,0.368,0.346,0.324,22240,152
"2946",148496,1991,1,0,"ROSARY COLLEGE",NA,NA,152,124,28,58,11,47,0.379,0.382,0.393,9226,113
"2947",148496,1992,1,0,"ROSARY COLLEGE",NA,NA,142,117,25,67,9,58,0.496,0.472,0.36,9940,109
"2948",148496,1993,1,0,"ROSARY COLLEGE",NA,NA,140,101,39,66,17,49,0.485,0.471,0.436,10500,104
"2949",148496,1995,1,0,"ROSARY COLLEGE",NA,NA,124,95,29,67,13,54,0.568,0.54,0.448,11550,98
"2950",148496,1996,1,0,"ROSARY COLLEGE",NA,NA,153,106,47,80,27,53,0.5,0.523,0.574,12230,108
"2951",148496,1997,1,0,"DOMINICAN UNIVERSITY",NA,NA,199,140,59,99,28,71,0.507,0.497,0.475,13050,154
"2952",148496,1998,1,0,"DOMINICAN UNIVERSITY",NA,NA,207,137,70,102,36,66,0.482,0.493,0.514,13700,150
"2953",148496,1999,1,0,"DOMINICAN UNIVERSITY",NA,NA,195,144,51,112,28,84,0.583,0.574,0.549,14160,135
"2954",148496,2000,1,0,"DOMINICAN UNIVERSITY",NA,NA,165,108,57,94,30,64,0.593,0.57,0.526,14720,114
"2955",148496,2001,1,0,"DOMINICAN UNIVERSITY",NA,NA,222,139,83,111,34,77,0.554,0.5,0.41,15600,159
"2956",148496,2002,1,0,"DOMINICAN UNIVERSITY",NA,NA,192,123,69,111,29,82,0.667,0.578,0.42,16620,137
"2957",148496,2003,1,0,"DOMINICAN UNIVERSITY",NA,NA,240,176,64,146,40,106,0.602,0.608,0.625,17850,175
"2958",148496,2004,1,0,"DOMINICAN UNIVERSITY",NA,NA,271,181,90,156,41,115,0.635,0.576,0.456,18900,177
"2959",148496,2005,1,0,"Dominican University",NA,NA,266,178,88,147,46,101,0.567,0.553,0.523,19950,161
"2960",148496,2006,1,0,"Dominican University",NA,NA,362,256,106,203,52,151,0.59,0.561,0.491,21150,205
"2961",148496,2007,1,0,"Dominican University",NA,NA,366,265,101,184,43,141,0.532,0.503,0.426,22350,199
"2962",148496,2008,1,0,"Dominican University",NA,NA,416,291,125,198,59,139,0.478,0.476,0.472,23700,234
"2963",148496,2009,1,0,"Dominican University",NA,NA,405,279,126,193,51,142,0.509,0.477,0.405,24600,231
"2964",148496,2010,1,0,"Dominican University",NA,NA,427,287,140,212,60,152,0.53,0.496,0.429,25560,207
"2965",148584,1991,1,0,"COLLEGE OF SAINT FRANCIS",NA,NA,171,81,90,58,22,36,0.444,0.339,0.244,7982,144
"2966",148584,1992,1,0,"COLLEGE OF SAINT FRANCIS",NA,NA,144,67,77,52,23,29,0.433,0.361,0.299,8600,133
"2967",148584,1993,1,0,"COLLEGE OF SAINT FRANCIS",NA,NA,149,79,70,61,25,36,0.456,0.409,0.357,9100,140
"2968",148584,1995,1,0,"COLLEGE OF ST FRANCIS",NA,NA,165,82,83,67,30,37,0.451,0.406,0.361,10790,149
"2969",148584,1996,1,0,"COLLEGE OF ST FRANCIS",NA,NA,151,91,60,53,15,38,0.418,0.351,0.25,11490,102
"2970",148584,1997,1,0,"UNIVERSITY OF ST FRANCIS",NA,NA,134,82,52,48,13,35,0.427,0.358,0.25,11950,91
"2971",148584,1998,1,0,"UNIVERSITY OF ST FRANCIS",NA,NA,176,88,88,64,21,43,0.489,0.364,0.239,12480,118
"2972",148584,1999,1,0,"UNIVERSITY OF ST FRANCIS",NA,NA,170,101,69,54,14,40,0.396,0.318,0.203,12800,145
"2973",148584,2000,1,0,"UNIVERSITY OF ST FRANCIS",NA,NA,190,109,81,73,25,48,0.44,0.384,0.309,13990,148
"2974",148584,2001,1,0,"UNIVERSITY OF ST FRANCIS",NA,NA,177,112,65,72,21,51,0.455,0.407,0.323,14680,153
"2975",148584,2002,1,0,"UNIVERSITY OF ST FRANCIS",NA,NA,149,86,63,49,17,32,0.372,0.329,0.27,15710,101
"2976",148584,2003,1,0,"UNIVERSITY OF ST FRANCIS",NA,NA,190,110,80,62,27,35,0.318,0.326,0.338,16480,144
"2977",148584,2004,1,0,"UNIVERSITY OF ST FRANCIS",NA,NA,157,94,63,64,21,43,0.457,0.408,0.333,17310,120
"2978",148584,2005,1,0,"University of St Francis",NA,NA,190,116,74,85,27,58,0.5,0.447,0.365,18170,137
"2979",148584,2006,1,0,"University of St Francis",NA,NA,181,104,77,62,21,41,0.394,0.343,0.273,19150,128
"2980",148584,2007,1,0,"University of St Francis",NA,NA,198,124,74,63,18,45,0.363,0.318,0.243,20440,149
"2981",148584,2008,1,0,"University of St Francis",NA,NA,203,125,78,77,27,50,0.4,0.379,0.346,21450,160
"2982",148584,2009,1,0,"University of St Francis",NA,NA,223,144,79,92,26,66,0.458,0.413,0.329,22288,170
"2983",148584,2010,1,0,"University of St Francis",NA,NA,210,131,79,93,29,64,0.489,0.443,0.367,24292,144
"2984",148627,1991,1,0,"SAINT XAVIER COLLEGE",NA,NA,160,109,51,50,11,39,0.358,0.312,0.216,8840,118
"2985",148627,1992,1,0,"SAINT XAVIER UNIVERSITY",NA,NA,192,134,58,55,11,44,0.328,0.286,0.19,9650,129
"2986",148627,1993,1,0,"SAINT XAVIER UNIVERSITY",NA,NA,272,163,109,75,20,55,0.337,0.276,0.183,10340,196
"2987",148627,1995,1,0,"SAINT XAVIER UNIVERSITY",NA,NA,226,139,87,67,19,48,0.345,0.296,0.218,11600,153
"2988",148627,1996,1,0,"SAINT XAVIER UNIVERSITY",NA,NA,203,116,87,56,14,42,0.362,0.276,0.161,12080,133
"2989",148627,1997,1,0,"SAINT XAVIER UNIVERSITY",NA,NA,270,180,90,82,21,61,0.339,0.304,0.233,12560,164
"2990",148627,1998,1,0,"SAINT XAVIER UNIVERSITY",NA,NA,271,180,91,87,21,66,0.367,0.321,0.231,13160,167
"2991",148627,1999,1,0,"SAINT XAVIER UNIVERSITY",NA,NA,325,196,129,96,33,63,0.321,0.295,0.256,13650,222
"2992",148627,2000,1,0,"SAINT XAVIER UNIVERSITY",NA,NA,352,222,130,112,36,76,0.342,0.318,0.277,14400,226
"2993",148627,2001,1,0,"SAINT XAVIER UNIVERSITY",NA,NA,353,208,145,88,31,57,0.274,0.249,0.214,15000,224
"2994",148627,2002,1,0,"SAINT XAVIER UNIVERSITY",NA,NA,375,262,113,89,24,65,0.248,0.237,0.212,15750,240
"2995",148627,2003,1,0,"SAINT XAVIER UNIVERSITY",NA,NA,371,231,140,107,32,75,0.325,0.288,0.229,16500,241
"2996",148627,2004,1,0,"SAINT XAVIER UNIVERSITY",NA,NA,406,259,147,130,44,86,0.332,0.32,0.299,17150,250
"2997",148627,2005,1,0,"Saint Xavier University",NA,NA,410,236,174,133,50,83,0.352,0.324,0.287,18350,251
"2998",148627,2006,1,0,"Saint Xavier University",NA,NA,525,370,155,172,47,125,0.338,0.328,0.303,19640,310
"2999",148627,2007,1,0,"Saint Xavier University",NA,NA,507,342,165,152,50,102,0.298,0.3,0.303,21016,265
"3000",148627,2008,1,0,"Saint Xavier University",NA,NA,547,375,172,176,55,121,0.323,0.322,0.32,22486,291
"3001",148627,2009,1,0,"Saint Xavier University",NA,NA,438,282,156,131,34,97,0.344,0.299,0.218,23610,241
"3002",148627,2010,1,0,"Saint Xavier University",NA,NA,488,308,180,153,41,112,0.364,0.314,0.228,24790,239
"3003",149222,1991,1,0,"SOUTHERN ILLINOIS UNIVERSITY-CARBONDALE",NA,NA,2376,1018,1358,302,139,163,0.16,0.127,0.102,2382,1724
"3004",149222,1992,1,0,"SOUTHERN ILLINOIS UNIVERSITY-CARBONDALE",NA,NA,2756,1203,1553,442,195,247,0.205,0.16,0.126,2556,2019
"3005",149222,1993,1,0,"SOUTHERN ILLINOIS UNIVERSITY-CARBONDALE",NA,NA,2271,969,1302,318,152,166,0.171,0.14,0.117,3052,1673
"3006",149222,1995,1,0,"SOUTHERN ILLINOIS UNIVERSITY-CARBONDALE",NA,NA,2277,1006,1271,371,162,209,0.208,0.163,0.127,3338,1698
"3007",149222,1996,1,0,"SOUTHERN ILLINOIS UNIVERSITY-CARBONDALE",NA,NA,2404,1054,1350,376,152,224,0.212,0.156,0.113,3522,1679
"3008",149222,1997,1,0,"SOUTHERN ILLINOIS UNIVERSITY-CARBONDALE",NA,NA,2400,1051,1349,451,188,263,0.25,0.188,0.139,3716,1682
"3009",149222,1998,1,0,"SOUTHERN ILLINOIS UNIVERSITY-CARBONDALE",NA,NA,2637,1131,1506,542,248,294,0.26,0.206,0.165,3821,1851
"3010",149222,1999,1,0,"SOUTHERN ILLINOIS UNIVERSITY-CARBONDALE",NA,NA,2547,1094,1453,483,234,249,0.228,0.19,0.161,2865,1628
"3011",149222,2000,1,0,"SOUTHERN ILLINOIS UNIVERSITY-CARBONDALE",NA,NA,2325,1036,1289,473,201,272,0.262,0.203,0.156,2408,1545
"3012",149222,2001,1,0,"SOUTHERN ILLINOIS UNIVERSITY-CARBONDALE",NA,NA,2153,967,1186,501,220,281,0.291,0.233,0.185,2482,1571
"3013",149222,2002,1,0,"SOUTHERN ILLINOIS UNIVERSITY-CARBONDALE",NA,NA,2395,1037,1358,550,262,288,0.278,0.23,0.193,2928,1650
"3014",149222,2003,1,0,"SOUTHERN ILLINOIS UNIVERSITY-CARBONDALE",NA,NA,2532,1089,1443,595,280,315,0.289,0.235,0.194,4245,1757
"3015",149222,2004,1,0,"SOUTHERN ILLINOIS UNIVERSITY CARBONDALE",NA,NA,2545,1053,1492,646,308,338,0.321,0.254,0.206,4920,1762
"3016",149222,2005,1,0,"Southern Illinois University Carbondale",NA,NA,2382,1034,1348,560,261,299,0.289,0.235,0.194,5310,1553
"3017",149222,2006,1,0,"Southern Illinois University Carbondale",NA,NA,2278,1005,1273,586,266,320,0.318,0.257,0.209,5808,1527
"3018",149222,2007,1,0,"Southern Illinois University Carbondale",NA,NA,2541,1127,1414,582,268,314,0.279,0.229,0.19,6348,1489
"3019",149222,2008,1,0,"Southern Illinois University Carbondale",NA,NA,2592,1183,1409,627,305,322,0.272,0.242,0.216,6975,1560
"3020",149222,2009,1,0,"Southern Illinois University Carbondale",NA,NA,2445,1131,1314,624,264,360,0.318,0.255,0.201,7290,1460
"3021",149222,2010,1,0,"Southern Illinois University Carbondale",NA,NA,2314,1104,1210,602,283,319,0.289,0.26,0.234,6975,1217
"3022",149231,1991,0,1,"SOUTHERN ILLINOIS UNIVERSITY AT EDWARDSVILLE",1993,0,948,539,409,107,30,77,0.143,0.113,0.073,1965,707
"3023",149231,1992,0,1,"SOUTHERN ILLINOIS UNIVERSITY AT EDWARDSVILLE",1993,0,965,558,407,100,32,68,0.122,0.104,0.079,2158,729
"3024",149231,1993,1,0,"SOUTHERN ILLINOIS UNIVERSITY-EDWARDSVILLE",1993,1,912,523,389,113,38,75,0.143,0.124,0.098,2199,711
"3025",149231,1995,1,0,"SOUTHERN ILLINOIS UNIVERSITY-EDWARDSVILLE",1993,1,1085,644,441,154,40,114,0.177,0.142,0.091,2329,842
"3026",149231,1996,1,0,"SOUTHERN ILLINOIS UNIVERSITY-EDWARDSVILLE",1993,1,1176,741,435,170,36,134,0.181,0.145,0.083,2469,940
"3027",149231,1997,1,0,"SOUTHERN ILLINOIS UNIVERSITY-EDWARDSVILLE",1993,1,1219,734,485,242,65,177,0.241,0.199,0.134,2586,1004
"3028",149231,1998,1,0,"SOUTHERN ILLINOIS UNIVERSITY-EDWARDSVILLE",1993,1,1408,853,555,257,70,187,0.219,0.183,0.126,2664,1125
"3029",149231,1999,1,0,"SOUTHERN ILLINOIS UNIVERSITY-EDWARDSVILLE",1993,1,1357,800,557,253,66,187,0.234,0.186,0.118,2143,1081
"3030",149231,2000,1,0,"SOUTHERN ILLINOIS UNIVERSITY-EDWARDSVILLE",1993,1,1495,848,647,324,103,221,0.261,0.217,0.159,2388,1221
"3031",149231,2001,1,0,"SOUTHERN ILLINOIS UNIVERSITY-EDWARDSVILLE",1993,1,1573,895,678,332,108,224,0.25,0.211,0.159,2574,1313
"3032",149231,2002,1,0,"SOUTHERN ILLINOIS UNIVERSITY-EDWARDSVILLE",1993,1,1629,866,763,356,126,230,0.266,0.219,0.165,2970,1394
"3033",149231,2003,1,0,"SOUTHERN ILLINOIS UNIVERSITY-EDWARDSVILLE",1993,1,1699,982,717,399,129,270,0.275,0.235,0.18,3360,1427
"3034",149231,2004,1,0,"SOUTHERN ILLINOIS UNIVERSITY EDWARDSVILLE",1993,1,1695,986,709,485,162,323,0.328,0.286,0.228,4020,1470
"3035",149231,2005,1,0,"Southern Illinois University Edwardsville",1993,1,1721,994,727,487,166,321,0.323,0.283,0.228,4350,1478
"3036",149231,2006,1,0,"Southern Illinois University Edwardsville",1993,1,1770,1025,745,527,163,364,0.355,0.298,0.219,4758,1535
"3037",149231,2007,1,0,"Southern Illinois University Edwardsville",1993,1,1833,1026,807,509,179,330,0.322,0.278,0.222,5228,1426
"3038",149231,2008,1,0,"Southern Illinois University Edwardsville",1993,1,1901,1101,800,545,194,351,0.319,0.287,0.242,5850,1492
"3039",149231,2009,1,0,"Southern Illinois University Edwardsville",1993,1,1911,1068,843,503,198,305,0.286,0.263,0.235,6201,1437
"3040",149231,2010,1,0,"Southern Illinois University Edwardsville",1993,1,2022,1104,918,520,196,324,0.294,0.257,0.214,5668,1460
"3041",149772,1991,1,0,"WESTERN ILLINOIS UNIVERSITY",NA,NA,1685,877,808,354,155,199,0.227,0.21,0.192,2241,1355
"3042",149772,1992,1,0,"WESTERN ILLINOIS UNIVERSITY",NA,NA,1566,763,803,315,137,178,0.233,0.201,0.171,2454,1264
"3043",149772,1993,1,0,"WESTERN ILLINOIS UNIVERSITY",NA,NA,1531,793,738,347,146,201,0.254,0.227,0.198,2548,1228
"3044",149772,1995,1,0,"WESTERN ILLINOIS UNIVERSITY",NA,NA,1538,757,781,392,168,224,0.296,0.255,0.215,2702,1316
"3045",149772,1996,1,0,"WESTERN ILLINOIS UNIVERSITY",NA,NA,1477,720,757,428,171,257,0.357,0.29,0.226,2810,1275
"3046",149772,1997,1,0,"WESTERN ILLINOIS UNIVERSITY",NA,NA,1602,833,769,450,180,270,0.324,0.281,0.234,3036,1388
"3047",149772,1998,1,0,"WESTERN ILLINOIS UNIVERSITY",NA,NA,1749,928,821,504,203,301,0.324,0.288,0.247,3185,1502
"3048",149772,1999,1,0,"WESTERN ILLINOIS UNIVERSITY",NA,NA,1690,856,834,542,215,327,0.382,0.321,0.258,2730,1434
"3049",149772,2000,1,0,"WESTERN ILLINOIS UNIVERSITY",NA,NA,1762,904,858,557,245,312,0.345,0.316,0.286,2812,1488
"3050",149772,2001,1,0,"WESTERN ILLINOIS UNIVERSITY",NA,NA,1677,836,841,557,245,312,0.373,0.332,0.291,2982,1457
"3051",149772,2002,1,0,"WESTERN ILLINOIS UNIVERSITY",NA,NA,1917,941,976,619,280,339,0.36,0.323,0.287,3465,1637
"3052",149772,2003,1,0,"WESTERN ILLINOIS UNIVERSITY",NA,NA,1938,939,999,675,322,353,0.376,0.348,0.322,3915,1607
"3053",149772,2004,1,0,"WESTERN ILLINOIS UNIVERSITY",NA,NA,2056,1025,1031,681,301,380,0.371,0.331,0.292,4537,1694
"3054",149772,2005,1,0,"Western Illinois University",NA,NA,1802,885,917,549,265,284,0.321,0.305,0.289,4968,1449
"3055",149772,2006,1,0,"Western Illinois University",NA,NA,1907,909,998,583,303,280,0.308,0.306,0.304,5439,1556
"3056",149772,2007,1,0,"Western Illinois University",NA,NA,1943,952,991,572,258,314,0.33,0.294,0.26,5895,1506
"3057",149772,2008,1,0,"Western Illinois University",NA,NA,1806,881,925,536,278,258,0.293,0.297,0.301,6456,1353
"3058",149772,2009,1,0,"Western Illinois University",NA,NA,1633,817,816,515,226,289,0.354,0.315,0.277,6779,1193
"3059",149772,2010,1,0,"Western Illinois University",NA,NA,1741,886,855,534,265,269,0.304,0.307,0.31,6588,1172
"3060",149781,1991,1,0,"WHEATON COLLEGE",NA,NA,544,277,267,373,164,209,0.755,0.686,0.614,9548,504
"3061",149781,1992,1,0,"WHEATON COLLEGE",NA,NA,548,294,254,392,172,220,0.748,0.715,0.677,10280,489
"3062",149781,1993,1,0,"WHEATON COLLEGE",NA,NA,546,282,264,371,159,212,0.752,0.679,0.602,10640,480
"3063",149781,1995,1,0,"WHEATON COLLEGE",NA,NA,546,281,265,425,198,227,0.808,0.778,0.747,12300,480
"3064",149781,1996,1,0,"WHEATON COLLEGE",NA,NA,557,278,279,424,207,217,0.781,0.761,0.742,13100,489
"3065",149781,1997,1,0,"WHEATON COLLEGE",NA,NA,546,290,256,418,189,229,0.79,0.766,0.738,13780,485
"3066",149781,1998,1,0,"WHEATON COLLEGE",NA,NA,573,300,273,409,186,223,0.743,0.714,0.681,14360,519
"3067",149781,1999,1,0,"WHEATON COLLEGE",NA,NA,583,311,272,450,204,246,0.791,0.772,0.75,14930,518
"3068",149781,2000,1,0,"WHEATON COLLEGE",NA,NA,568,291,277,441,212,229,0.787,0.776,0.765,15540,491
"3069",149781,2001,1,0,"WHEATON COLLEGE",NA,NA,572,276,296,416,200,216,0.783,0.727,0.676,16390,494
"3070",149781,2002,1,0,"WHEATON COLLEGE",NA,NA,569,286,283,447,213,234,0.818,0.786,0.753,17320,489
"3071",149781,2003,1,0,"WHEATON COLLEGE",NA,NA,576,288,288,462,223,239,0.83,0.802,0.774,18500,503
"3072",149781,2004,1,0,"WHEATON COLLEGE",NA,NA,595,318,277,469,202,267,0.84,0.788,0.729,20000,503
"3073",149781,2005,1,0,"Wheaton College",NA,NA,578,287,291,458,220,238,0.829,0.792,0.756,21100,496
"3074",149781,2006,1,0,"Wheaton College",NA,NA,572,278,294,435,219,216,0.777,0.76,0.745,22450,481
"3075",149781,2007,1,0,"Wheaton College",NA,NA,580,292,288,432,216,216,0.74,0.745,0.75,23730,486
"3076",149781,2008,1,0,"Wheaton College",NA,NA,580,291,289,462,219,243,0.835,0.797,0.758,25500,475
"3077",149781,2009,1,0,"Wheaton College",NA,NA,620,318,302,501,232,269,0.846,0.808,0.768,26520,510
"3078",149781,2010,1,0,"Wheaton College",NA,NA,602,312,290,495,226,269,0.862,0.822,0.779,27580,502
"3079",150066,1991,1,0,"ANDERSON UNIVERSITY",NA,NA,460,245,215,123,47,76,0.31,0.267,0.219,8060,432
"3080",150066,1992,1,0,"ANDERSON UNIVERSITY",NA,NA,507,297,210,162,53,109,0.367,0.32,0.252,8780,470
"3081",150066,1993,1,0,"ANDERSON UNIVERSITY",NA,NA,423,251,172,131,43,88,0.351,0.31,0.25,9520,394
"3082",150066,1995,1,0,"ANDERSON UNIVERSITY",NA,NA,498,298,200,169,59,110,0.369,0.339,0.295,11240,470
"3083",150066,1996,1,0,"ANDERSON UNIVERSITY",NA,NA,406,222,184,144,47,97,0.437,0.355,0.255,11840,376
"3084",150066,1997,1,0,"ANDERSON UNIVERSITY",NA,NA,451,266,185,172,54,118,0.444,0.381,0.292,12700,418
"3085",150066,1998,1,0,"ANDERSON UNIVERSITY",NA,NA,534,319,215,202,78,124,0.389,0.378,0.363,13360,500
"3086",150066,1999,1,0,"ANDERSON UNIVERSITY",NA,NA,498,304,194,206,61,145,0.477,0.414,0.314,13740,455
"3087",150066,2000,1,0,"ANDERSON UNIVERSITY",NA,NA,538,275,263,212,77,135,0.491,0.394,0.293,14680,497
"3088",150066,2001,1,0,"ANDERSON UNIVERSITY",NA,NA,462,272,190,170,45,125,0.46,0.368,0.237,15380,402
"3089",150066,2002,1,0,"ANDERSON UNIVERSITY",NA,NA,591,335,256,225,72,153,0.457,0.381,0.281,16140,522
"3090",150066,2003,1,0,"ANDERSON UNIVERSITY",NA,NA,559,337,222,246,81,165,0.49,0.44,0.365,17050,511
"3091",150066,2004,1,0,"ANDERSON UNIVERSITY",NA,NA,579,340,239,248,92,156,0.459,0.428,0.385,17990,515
"3092",150066,2005,1,0,"Anderson University",NA,NA,565,348,217,272,93,179,0.514,0.481,0.429,18900,500
"3093",150066,2006,1,0,"Anderson University",NA,NA,447,245,202,206,83,123,0.502,0.461,0.411,19990,397
"3094",150066,2007,1,0,"Anderson University",NA,NA,479,239,240,216,90,126,0.527,0.451,0.375,20976,414
"3095",150066,2008,1,0,"Anderson University",NA,NA,540,316,224,259,97,162,0.513,0.48,0.433,21920,470
"3096",150066,2009,1,0,"Anderson University",NA,NA,547,313,234,238,83,155,0.495,0.435,0.355,22910,478
"3097",150066,2010,1,0,"Anderson University",NA,NA,469,264,205,230,79,151,0.572,0.49,0.385,23940,377
"3098",150136,1991,1,0,"BALL STATE UNIVERSITY",NA,NA,3447,1976,1471,1555,602,953,0.482,0.451,0.409,2280,3132
"3099",150136,1992,1,0,"BALL STATE UNIVERSITY",NA,NA,3265,1841,1424,699,236,463,0.252,0.214,0.166,2464,2983
"3100",150136,1993,1,0,"BALL STATE UNIVERSITY",NA,NA,3872,2104,1768,701,230,471,0.224,0.181,0.13,2656,3496
"3101",150136,1995,1,0,"BALL STATE UNIVERSITY",NA,NA,3855,2068,1787,787,262,525,0.254,0.204,0.147,3048,3463
"3102",150136,1996,1,0,"BALL STATE UNIVERSITY",NA,NA,3763,1959,1804,726,241,485,0.248,0.193,0.134,3188,3377
"3103",150136,1997,1,0,"BALL STATE UNIVERSITY",NA,NA,4047,2177,1870,837,242,595,0.273,0.207,0.129,3316,3537
"3104",150136,1998,1,0,"BALL STATE UNIVERSITY",NA,NA,3512,1905,1607,896,311,585,0.307,0.255,0.194,3454,3126
"3105",150136,1999,1,0,"BALL STATE UNIVERSITY",NA,NA,3602,1931,1671,943,348,595,0.308,0.262,0.208,3576,3171
"3106",150136,2000,1,0,"BALL STATE UNIVERSITY",NA,NA,3694,2023,1671,1062,372,690,0.341,0.287,0.223,3720,3242
"3107",150136,2001,1,0,"BALL STATE UNIVERSITY",NA,NA,3743,2039,1704,1066,344,722,0.354,0.285,0.202,3924,3338
"3108",150136,2002,1,0,"BALL STATE UNIVERSITY",NA,NA,4010,2207,1803,1327,507,820,0.372,0.331,0.281,4320,3571
"3109",150136,2003,1,0,"BALL STATE UNIVERSITY",NA,NA,3963,2139,1824,1329,507,822,0.384,0.335,0.278,4532,3627
"3110",150136,2004,1,0,"BALL STATE UNIVERSITY",NA,NA,3662,1951,1711,1141,390,751,0.385,0.312,0.228,5264,3274
"3111",150136,2005,1,0,"Ball State University",NA,NA,3660,1892,1768,1063,367,696,0.368,0.29,0.208,6030,3165
"3112",150136,2006,1,0,"Ball State University",NA,NA,3947,2027,1920,1155,425,730,0.36,0.293,0.221,6360,3418
"3113",150136,2007,1,0,"Ball State University",NA,NA,3747,2033,1714,1223,432,791,0.389,0.326,0.252,6736,3204
"3114",150136,2008,1,0,"Ball State University",NA,NA,3983,2188,1795,1384,504,880,0.402,0.347,0.281,7000,3447
"3115",150136,2009,1,0,"Ball State University",NA,NA,4131,2240,1891,1542,570,972,0.434,0.373,0.301,7228,3494
"3116",150136,2010,1,0,"Ball State University",NA,NA,3849,2123,1726,1588,560,1028,0.484,0.413,0.324,7508,3259
"3117",150145,1991,1,0,"BETHEL COLLEGE",NA,NA,116,61,55,29,17,12,0.197,0.25,0.309,7500,111
"3118",150145,1992,1,0,"BETHEL COLLEGE",NA,NA,152,88,64,48,16,32,0.364,0.316,0.25,7950,132
"3119",150145,1993,1,0,"BETHEL COLLEGE",NA,NA,168,95,73,62,23,39,0.41,0.369,0.315,8700,158
"3120",150145,1995,1,0,"BETHEL COLLEGE",NA,NA,184,118,66,63,18,45,0.381,0.342,0.273,9750,166
"3121",150145,1996,1,0,"BETHEL COLLEGE",NA,NA,201,117,84,68,22,46,0.393,0.338,0.262,10350,184
"3122",150145,1997,1,0,"BETHEL COLLEGE",NA,NA,223,144,79,97,33,64,0.444,0.435,0.418,11100,201
"3123",150145,1998,1,0,"BETHEL COLLEGE",NA,NA,273,173,100,104,36,68,0.393,0.381,0.36,11500,257
"3124",150145,1999,1,0,"BETHEL COLLEGE",NA,NA,265,156,109,98,30,68,0.436,0.37,0.275,11950,250
"3125",150145,2000,1,0,"BETHEL COLLEGE",NA,NA,294,182,112,114,41,73,0.401,0.388,0.366,12550,277
"3126",150145,2001,1,0,"BETHEL COLLEGE",NA,NA,258,161,97,110,34,76,0.472,0.426,0.351,13300,231
"3127",150145,2002,1,0,"BETHEL COLLEGE",NA,NA,253,143,110,108,34,74,0.517,0.427,0.309,13990,231
"3128",150145,2003,1,0,"BETHEL COLLEGE",NA,NA,291,175,116,117,39,78,0.446,0.402,0.336,14390,265
"3129",150145,2004,1,0,"BETHEL COLLEGE",NA,NA,306,174,132,125,38,87,0.5,0.408,0.288,15200,278
"3130",150145,2005,1,0,"Bethel College",NA,NA,310,207,103,122,41,81,0.391,0.394,0.398,15950,283
"3131",150145,2006,1,0,"Bethel College",NA,NA,303,190,113,136,41,95,0.5,0.449,0.363,17450,259
"3132",150145,2007,1,0,"Bethel College",NA,NA,249,159,90,106,33,73,0.459,0.426,0.367,18600,204
"3133",150145,2008,1,0,"Bethel College",NA,NA,242,149,93,132,45,87,0.584,0.545,0.484,19996,199
"3134",150145,2009,1,0,"Bethel College",NA,NA,295,175,120,165,60,105,0.6,0.559,0.5,20978,263
"3135",150145,2010,1,0,"Bethel College-Mishawaka",NA,NA,269,169,100,144,51,93,0.55,0.535,0.51,21990,225
"3136",150163,1991,1,0,"BUTLER UNIVERSITY",NA,NA,622,363,259,252,94,158,0.435,0.405,0.363,10500,550
"3137",150163,1992,1,0,"BUTLER UNIVERSITY",NA,NA,666,383,283,257,98,159,0.415,0.386,0.346,11340,613
"3138",150163,1993,1,0,"BUTLER UNIVERSITY",NA,NA,700,437,263,288,94,194,0.444,0.411,0.357,12280,646
"3139",150163,1995,1,0,"BUTLER UNIVERSITY",NA,NA,847,510,337,409,145,264,0.518,0.483,0.43,13990,757
"3140",150163,1996,1,0,"BUTLER UNIVERSITY",NA,NA,777,475,302,426,137,289,0.608,0.548,0.454,14900,626
"3141",150163,1997,1,0,"BUTLER UNIVERSITY",NA,NA,699,458,241,369,120,249,0.544,0.528,0.498,15570,541
"3142",150163,1998,1,0,"BUTLER UNIVERSITY",NA,NA,912,557,355,452,145,307,0.551,0.496,0.408,16280,821
"3143",150163,1999,1,0,"BUTLER UNIVERSITY",NA,NA,861,529,332,470,168,302,0.571,0.546,0.506,17180,700
"3144",150163,2000,1,0,"BUTLER UNIVERSITY",NA,NA,868,559,309,516,182,334,0.598,0.594,0.589,18040,736
"3145",150163,2001,1,0,"BUTLER UNIVERSITY",NA,NA,929,593,336,512,168,344,0.58,0.551,0.5,18940,822
"3146",150163,2002,1,0,"BUTLER UNIVERSITY",NA,NA,936,595,341,485,157,328,0.551,0.518,0.46,19990,836
"3147",150163,2003,1,0,"BUTLER UNIVERSITY",NA,NA,972,612,360,550,184,366,0.598,0.566,0.511,20990,803
"3148",150163,2004,1,0,"BUTLER UNIVERSITY",NA,NA,925,571,354,458,143,315,0.552,0.495,0.404,22250,799
"3149",150163,2005,1,0,"Butler University",NA,NA,864,536,328,391,119,272,0.508,0.453,0.363,23530,752
"3150",150163,2006,1,0,"Butler University",NA,NA,965,604,361,479,150,329,0.545,0.496,0.416,24710,811
"3151",150163,2007,1,0,"Butler University",NA,NA,987,613,374,502,157,345,0.563,0.509,0.42,26070,864
"3152",150163,2008,1,0,"Butler University",NA,NA,934,566,368,580,209,371,0.655,0.621,0.568,27500,788
"3153",150163,2009,1,0,"Butler University",NA,NA,944,571,373,501,166,335,0.587,0.531,0.445,28460,804
"3154",150163,2010,1,0,"Butler University",NA,NA,1049,616,433,600,211,389,0.631,0.572,0.487,29740,863
"3155",150400,1991,1,0,"DEPAUW UNIVERSITY",NA,NA,475,258,217,367,157,210,0.814,0.773,0.724,12288,404
"3156",150400,1992,1,0,"DEPAUW UNIVERSITY",NA,NA,566,326,240,410,169,241,0.739,0.724,0.704,13000,471
"3157",150400,1993,1,0,"DEPAUW UNIVERSITY",NA,NA,495,250,245,361,179,182,0.728,0.729,0.731,13700,440
"3158",150400,1995,1,0,"DEPAUW UNIVERSITY",NA,NA,580,328,252,434,187,247,0.753,0.748,0.742,15475,479
"3159",150400,1996,1,0,"DEPAUW UNIVERSITY",NA,NA,619,351,268,450,192,258,0.735,0.727,0.716,16180,538
"3160",150400,1997,1,0,"DEPAUW UNIVERSITY",NA,NA,673,363,310,493,228,265,0.73,0.733,0.735,17050,591
"3161",150400,1998,1,0,"DEPAUW UNIVERSITY",NA,NA,593,344,249,423,164,259,0.753,0.713,0.659,17650,510
"3162",150400,1999,1,0,"DEPAUW UNIVERSITY",NA,NA,579,327,252,436,194,242,0.74,0.753,0.77,19420,491
"3163",150400,2000,1,0,"DEPAUW UNIVERSITY",NA,NA,610,336,274,479,202,277,0.824,0.785,0.737,20200,537
"3164",150400,2001,1,0,"DEPAUW UNIVERSITY",NA,NA,620,350,270,481,205,276,0.789,0.776,0.759,21100,543
"3165",150400,2002,1,0,"DEPAUW UNIVERSITY",NA,NA,685,369,316,566,259,307,0.832,0.826,0.82,22400,590
"3166",150400,2003,1,0,"DEPAUW UNIVERSITY",NA,NA,580,305,275,456,202,254,0.833,0.786,0.735,24000,480
"3167",150400,2004,1,0,"DEPAUW UNIVERSITY",NA,NA,661,367,294,546,229,317,0.864,0.826,0.779,25000,572
"3168",150400,2005,1,0,"DePauw University",NA,NA,586,337,249,470,197,273,0.81,0.802,0.791,26100,505
"3169",150400,2006,1,0,"DePauw University",NA,NA,595,334,261,442,186,256,0.767,0.743,0.713,27400,476
"3170",150400,2007,1,0,"DePauw University",NA,NA,664,369,295,493,211,282,0.764,0.742,0.715,29300,524
"3171",150400,2008,1,0,"DePauw University",NA,NA,600,341,259,448,172,276,0.809,0.747,0.664,31400,437
"3172",150400,2009,1,0,"DePauw University",NA,NA,717,405,312,543,222,321,0.793,0.757,0.712,32800,515
"3173",150400,2010,1,0,"DePauw University",NA,NA,608,345,263,474,202,272,0.788,0.78,0.768,34440,400
"3174",150534,1991,1,0,"UNIVERSITY OF EVANSVILLE",NA,NA,694,403,291,281,101,180,0.447,0.405,0.347,9910,614
"3175",150534,1992,1,0,"UNIVERSITY OF EVANSVILLE",NA,NA,754,435,319,322,117,205,0.471,0.427,0.367,10700,677
"3176",150534,1993,1,0,"UNIVERSITY OF EVANSVILLE",NA,NA,746,424,322,296,113,183,0.432,0.397,0.351,11130,651
"3177",150534,1995,1,0,"UNIVERSITY OF EVANSVILLE",NA,NA,826,504,322,370,131,239,0.474,0.448,0.407,12600,710
"3178",150534,1996,1,0,"UNIVERSITY OF EVANSVILLE",NA,NA,694,428,266,294,99,195,0.456,0.424,0.372,13220,588
"3179",150534,1997,1,0,"UNIVERSITY OF EVANSVILLE",NA,NA,719,424,295,312,108,204,0.481,0.434,0.366,13600,616
"3180",150534,1998,1,0,"UNIVERSITY OF EVANSVILLE",NA,NA,665,423,242,293,92,201,0.475,0.441,0.38,14400,545
"3181",150534,1999,1,0,"UNIVERSITY OF EVANSVILLE",NA,NA,594,367,227,276,97,179,0.488,0.465,0.427,15200,474
"3182",150534,2000,1,0,"UNIVERSITY OF EVANSVILLE",NA,NA,555,320,235,237,84,153,0.478,0.427,0.357,16100,422
"3183",150534,2001,1,0,"UNIVERSITY OF EVANSVILLE",NA,NA,511,310,201,226,93,133,0.429,0.442,0.463,17050,324
"3184",150534,2002,1,0,"UNIVERSITY OF EVANSVILLE",NA,NA,600,369,231,289,100,189,0.512,0.482,0.433,17900,385
"3185",150534,2003,1,0,"UNIVERSITY OF EVANSVILLE",NA,NA,662,418,244,346,119,227,0.543,0.523,0.488,18900,456
"3186",150534,2004,1,0,"UNIVERSITY OF EVANSVILLE",NA,NA,634,382,252,357,131,226,0.592,0.563,0.52,19995,508
"3187",150534,2005,1,0,"University of Evansville",NA,NA,670,416,254,337,105,232,0.558,0.503,0.413,21120,535
"3188",150534,2006,1,0,"University of Evansville",NA,NA,643,379,264,359,139,220,0.581,0.558,0.527,22370,527
"3189",150534,2007,1,0,"University of Evansville",NA,NA,651,375,276,344,129,215,0.573,0.528,0.467,23710,510
"3190",150534,2008,1,0,"University of Evansville",NA,NA,616,377,239,325,116,209,0.554,0.528,0.485,25130,490
"3191",150534,2009,1,0,"University of Evansville",NA,NA,701,433,268,403,152,251,0.58,0.575,0.567,26010,574
"3192",150534,2010,1,0,"University of Evansville",NA,NA,683,403,280,398,136,262,0.65,0.583,0.486,27310,570
"3193",150668,1991,0,1,"GOSHEN COLLEGE",1995,0,194,106,88,83,30,53,0.5,0.428,0.341,7720,167
"3194",150668,1992,0,1,"GOSHEN COLLEGE",1995,0,201,104,97,73,37,36,0.346,0.363,0.381,8310,177
"3195",150668,1993,0,1,"GOSHEN COLLEGE",1995,0,229,140,89,88,34,54,0.386,0.384,0.382,8770,196
"3196",150668,1995,1,0,"GOSHEN COLLEGE",1995,1,213,111,102,104,40,64,0.577,0.488,0.392,9900,192
"3197",150668,1996,1,0,"GOSHEN COLLEGE",1995,1,197,107,90,90,39,51,0.477,0.457,0.433,10900,182
"3198",150668,1997,1,0,"GOSHEN COLLEGE",1995,1,209,116,93,89,32,57,0.491,0.426,0.344,11450,180
"3199",150668,1998,1,0,"GOSHEN COLLEGE",1995,1,207,121,86,99,39,60,0.496,0.478,0.453,12150,181
"3200",150668,1999,1,0,"GOSHEN COLLEGE",1995,1,220,135,85,90,30,60,0.444,0.409,0.353,12320,190
"3201",150668,2000,1,0,"GOSHEN COLLEGE",1995,1,194,113,81,87,30,57,0.504,0.448,0.37,12870,158
"3202",150668,2001,1,0,"GOSHEN COLLEGE",1995,1,172,94,78,87,33,54,0.575,0.506,0.423,13600,140
"3203",150668,2002,1,0,"GOSHEN COLLEGE",1995,1,133,81,52,74,28,46,0.568,0.556,0.538,14700,107
"3204",150668,2003,1,0,"GOSHEN COLLEGE",1995,1,181,99,82,101,41,60,0.606,0.558,0.5,16320,157
"3205",150668,2004,1,0,"GOSHEN COLLEGE",1995,1,168,95,73,84,38,46,0.484,0.5,0.521,18200,143
"3206",150668,2005,1,0,"Goshen College",1995,1,194,108,86,113,44,69,0.639,0.582,0.512,19300,162
"3207",150668,2006,1,0,"Goshen College",1995,1,206,122,84,114,44,70,0.574,0.553,0.524,20300,172
"3208",150668,2007,1,0,"Goshen College",1995,1,202,114,88,110,44,66,0.579,0.545,0.5,21300,160
"3209",150668,2008,1,0,"Goshen College",1995,1,172,97,75,95,36,59,0.608,0.552,0.48,22300,131
"3210",150668,2009,1,0,"Goshen College",1995,1,238,148,90,126,45,81,0.547,0.529,0.5,23400,196
"3211",150668,2010,1,0,"Goshen College",1995,1,179,106,73,100,39,61,0.576,0.559,0.534,24500,128
"3212",150941,1991,1,0,"HUNTINGTON COLLEGE",NA,NA,154,76,78,55,30,25,0.329,0.357,0.385,7890,144
"3213",150941,1992,1,0,"HUNTINGTON COLLEGE",NA,NA,150,92,58,75,24,51,0.554,0.5,0.414,8730,138
"3214",150941,1993,1,0,"HUNTINGTON COLLEGE",NA,NA,124,69,55,64,26,38,0.551,0.516,0.473,9490,117
"3215",150941,1995,1,0,"HUNTINGTON COLLEGE",NA,NA,191,113,78,87,27,60,0.531,0.455,0.346,10800,180
"3216",150941,1996,1,0,"HUNTINGTON COLLEGE",NA,NA,174,104,70,95,37,58,0.558,0.546,0.529,11520,169
"3217",150941,1997,1,0,"HUNTINGTON COLLEGE",NA,NA,197,129,68,95,21,74,0.574,0.482,0.309,12180,193
"3218",150941,1998,1,0,"HUNTINGTON COLLEGE",NA,NA,227,151,76,115,34,81,0.536,0.507,0.447,12250,221
"3219",150941,1999,1,0,"HUNTINGTON COLLEGE",NA,NA,221,140,81,127,43,84,0.6,0.575,0.531,12780,214
"3220",150941,2000,1,0,"HUNTINGTON COLLEGE",NA,NA,206,109,97,100,46,54,0.495,0.485,0.474,13540,200
"3221",150941,2001,1,0,"HUNTINGTON COLLEGE",NA,NA,220,135,85,117,43,74,0.548,0.532,0.506,14270,212
"3222",150941,2002,1,0,"HUNTINGTON COLLEGE",NA,NA,236,145,91,110,40,70,0.483,0.466,0.44,15520,224
"3223",150941,2003,1,0,"HUNTINGTON COLLEGE",NA,NA,190,103,87,94,45,49,0.476,0.495,0.517,16120,184
"3224",150941,2004,1,0,"HUNTINGTON COLLEGE",NA,NA,203,123,80,108,44,64,0.52,0.532,0.55,18060,196
"3225",150941,2005,1,0,"Huntington University",NA,NA,232,133,99,113,45,68,0.511,0.487,0.455,18060,219
"3226",150941,2006,1,0,"Huntington University",NA,NA,250,140,110,126,52,74,0.529,0.504,0.473,18420,238
"3227",150941,2007,1,0,"Huntington University",NA,NA,244,138,106,138,63,75,0.543,0.566,0.594,18980,233
"3228",150941,2008,1,0,"Huntington University",NA,NA,275,161,114,133,51,82,0.509,0.484,0.447,19840,249
"3229",150941,2009,1,0,"Huntington University",NA,NA,250,138,112,142,64,78,0.565,0.568,0.571,20820,229
"3230",150941,2010,1,0,"Huntington University",NA,NA,263,146,117,144,62,82,0.562,0.548,0.53,21850,231
"3231",151102,1991,1,0,"INDIANA UNIVERSITY-PURDUE UNIVERSITY AT FORT WAYNE",NA,NA,1134,607,527,34,17,17,0.028,0.03,0.032,1981,1052
"3232",151102,1992,1,0,"INDIANA UNIVERSITY-PURDUE UNIVERSITY AT FORT WAYNE",NA,NA,1126,612,514,39,14,25,0.041,0.035,0.027,2144,1050
"3233",151102,1993,1,0,"INDIANA UNIVERSITY-PURDUE UNIVERSITY-FORT WAYNE",NA,NA,1189,650,539,47,17,30,0.046,0.04,0.032,2310,1114
"3234",151102,1995,1,0,"INDIANA UNIVERSITY-PURDUE UNIVERSITY-FORT WAYNE",NA,NA,1063,577,486,43,14,29,0.05,0.04,0.029,2709,977
"3235",151102,1996,1,0,"INDIANA UNIVERSITY-PURDUE UNIVERSITY-FORT WAYNE",NA,NA,1196,647,549,44,16,28,0.043,0.037,0.029,3006,1094
"3236",151102,1997,1,0,"INDIANA UNIVERSITY-PURDUE UNIVERSITY-FORT WAYNE",NA,NA,1196,659,537,49,7,42,0.064,0.041,0.013,3213,1086
"3237",151102,1998,1,0,"INDIANA UNIVERSITY-PURDUE UNIVERSITY-FORT WAYNE",NA,NA,1303,673,630,38,16,22,0.033,0.029,0.025,3350,1166
"3238",151102,1999,1,0,"INDIANA UNIVERSITY-PURDUE UNIVERSITY-FORT WAYNE",NA,NA,1303,688,615,48,16,32,0.047,0.037,0.026,3159,1199
"3239",151102,2000,1,0,"INDIANA UNIVERSITY-PURDUE UNIVERSITY-FORT WAYNE",NA,NA,1337,723,614,48,22,26,0.036,0.036,0.036,3446,1248
"3240",151102,2001,1,0,"INDIANA UNIVERSITY-PURDUE UNIVERSITY-FORT WAYNE",NA,NA,1426,735,691,69,30,39,0.053,0.048,0.043,2815,1307
"3241",151102,2002,1,0,"INDIANA UNIVERSITY-PURDUE UNIVERSITY-FORT WAYNE",NA,NA,1409,782,627,61,24,37,0.047,0.043,0.038,3384,1296
"3242",151102,2003,1,0,"INDIANA UNIVERSITY-PURDUE UNIVERSITY-FORT WAYNE",NA,NA,1366,757,609,76,29,47,0.062,0.056,0.048,4108,1218
"3243",151102,2004,1,0,"INDIANA UNIVERSITY-PURDUE UNIVERSITY-FORT WAYNE",NA,NA,1553,859,694,103,29,74,0.086,0.066,0.042,4266,1352
"3244",151102,2005,1,0,"Indiana University-Purdue University-Fort Wayne",NA,NA,1534,850,684,82,31,51,0.06,0.053,0.045,4523,1334
"3245",151102,2006,1,0,"Indiana University-Purdue University-Fort Wayne",NA,NA,1608,859,749,61,20,41,0.048,0.038,0.027,4793,1407
"3246",151102,2007,1,0,"Indiana University-Purdue University-Fort Wayne",NA,NA,1804,942,862,91,33,58,0.062,0.05,0.038,4982,1555
"3247",151102,2008,1,0,"Indiana University-Purdue University-Fort Wayne",NA,NA,1905,1009,896,118,36,82,0.081,0.062,0.04,5181,1614
"3248",151102,2009,1,0,"Indiana University-Purdue University-Fort Wayne",NA,NA,2040,1054,986,131,54,77,0.073,0.064,0.055,5441,1642
"3249",151102,2010,1,0,"Indiana University-Purdue University-Fort Wayne",NA,NA,2117,1078,1039,134,47,87,0.081,0.063,0.045,5712,1654
"3250",151111,1991,1,0,"INDIANA UNIVERSITY-PURDUE UNIV AT INDIANAPOLIS",NA,NA,1536,862,674,54,24,30,0.035,0.035,0.036,2277,1313
"3251",151111,1992,1,0,"INDIANA UNIVERSITY-PURDUE UNIV INDIANAPOLIS",NA,NA,1507,837,670,42,18,24,0.029,0.028,0.027,2461,1300
"3252",151111,1993,1,0,"INDIANA UNIVERSITY-PURDUE UNIVERSITY-INDIANAPOLIS",NA,NA,1509,830,679,70,29,41,0.049,0.046,0.043,2634,1342
"3253",151111,1995,1,0,"INDIANA UNIVERSITY-PURDUE UNIVERSITY-INDIANAPOLIS",NA,NA,1860,1024,836,148,65,83,0.081,0.08,0.078,3156,1610
"3254",151111,1996,1,0,"INDIANA UNIVERSITY-PURDUE UNIVERSITY-INDIANAPOLIS",NA,NA,2100,1172,928,87,30,57,0.049,0.041,0.032,3300,1733
"3255",151111,1997,1,0,"INDIANA UNIVERSITY-PURDUE UNIVERSITY-INDIANAPOLIS",NA,NA,2154,1198,956,113,55,58,0.048,0.052,0.058,3441,1784
"3256",151111,1998,1,0,"INDIANA UNIVERSITY-PURDUE UNIVERSITY-INDIANAPOLIS",NA,NA,2570,1387,1183,110,41,69,0.05,0.043,0.035,3576,2164
"3257",151111,1999,1,0,"INDIANA UNIVERSITY-PURDUE UNIVERSITY-INDIANAPOLIS",NA,NA,2552,1409,1143,166,67,99,0.07,0.065,0.059,3432,2126
"3258",151111,2000,1,0,"INDIANA UNIVERSITY-PURDUE UNIVERSITY-INDIANAPOLIS",NA,NA,2473,1414,1059,168,48,120,0.085,0.068,0.045,3570,2081
"3259",151111,2001,1,0,"INDIANA UNIVERSITY-PURDUE UNIVERSITY-INDIANAPOLIS",NA,NA,2275,1325,950,188,71,117,0.088,0.083,0.075,3839,1911
"3260",151111,2002,1,0,"INDIANA UNIVERSITY-PURDUE UNIVERSITY-INDIANAPOLIS",NA,NA,2235,1286,949,195,63,132,0.103,0.087,0.066,4183,1887
"3261",151111,2003,1,0,"INDIANA UNIVERSITY-PURDUE UNIVERSITY-INDIANAPOLIS",NA,NA,2336,1361,975,210,79,131,0.096,0.09,0.081,5151,1964
"3262",151111,2004,1,0,"INDIANA UNIVERSITY-PURDUE UNIVERSITY-INDIANAPOLIS",NA,NA,2294,1371,923,226,80,146,0.107,0.099,0.087,5357,1849
"3263",151111,2005,1,0,"Indiana University-Purdue University-Indianapolis",NA,NA,2396,1414,982,234,88,146,0.103,0.098,0.09,5625,1895
"3264",151111,2006,1,0,"Indiana University-Purdue University-Indianapolis",NA,NA,2516,1549,967,317,109,208,0.134,0.126,0.113,5924,1992
"3265",151111,2007,1,0,"Indiana University-Purdue University-Indianapolis",NA,NA,2737,1659,1078,392,144,248,0.15,0.143,0.134,6221,2202
"3266",151111,2008,1,0,"Indiana University-Purdue University-Indianapolis",NA,NA,2802,1657,1145,463,170,293,0.177,0.165,0.148,6531,2204
"3267",151111,2009,1,0,"Indiana University-Purdue University-Indianapolis",NA,NA,2794,1670,1124,500,187,313,0.187,0.179,0.166,6923,2230
"3268",151111,2010,1,0,"Indiana University-Purdue University-Indianapolis",NA,NA,2679,1607,1072,478,176,302,0.188,0.178,0.164,7255,2036
"3269",151306,1991,1,0,"UNIVERSITY OF SOUTHERN INDIANA",NA,NA,1078,611,467,86,24,62,0.102,0.08,0.051,1808,1030
"3270",151306,1992,1,0,"UNIVERSITY OF SOUTHERN INDIANA",NA,NA,1080,624,456,90,27,63,0.101,0.083,0.059,2062,1014
"3271",151306,1993,1,0,"UNIVERSITY OF SOUTHERN INDIANA",NA,NA,1162,681,481,79,21,58,0.085,0.068,0.044,2163,1096
"3272",151306,1995,1,0,"UNIVERSITY OF SOUTHERN INDIANA",NA,NA,1407,813,594,138,30,108,0.133,0.098,0.051,2285,1305
"3273",151306,1996,1,0,"UNIVERSITY OF SOUTHERN INDIANA",NA,NA,1573,912,661,173,45,128,0.14,0.11,0.068,2415,1496
"3274",151306,1997,1,0,"UNIVERSITY OF SOUTHERN INDIANA",NA,NA,1839,1053,786,239,63,176,0.167,0.13,0.08,2565,1734
"3275",151306,1998,1,0,"UNIVERSITY OF SOUTHERN INDIANA",NA,NA,1552,945,607,197,56,141,0.149,0.127,0.092,2780,1473
"3276",151306,1999,1,0,"UNIVERSITY OF SOUTHERN INDIANA",NA,NA,1674,1003,671,200,49,151,0.151,0.119,0.073,2768,1591
"3277",151306,2000,1,0,"UNIVERSITY OF SOUTHERN INDIANA",NA,NA,1729,1033,696,247,57,190,0.184,0.143,0.082,2626,1612
"3278",151306,2001,1,0,"UNIVERSITY OF SOUTHERN INDIANA",NA,NA,1897,1135,762,236,64,172,0.152,0.124,0.084,2774,1788
"3279",151306,2002,1,0,"UNIVERSITY OF SOUTHERN INDIANA",NA,NA,1891,1152,739,217,50,167,0.145,0.115,0.068,3051,1788
"3280",151306,2003,1,0,"UNIVERSITY OF SOUTHERN INDIANA",NA,NA,1953,1151,802,271,78,193,0.168,0.139,0.097,3442,1835
"3281",151306,2004,1,0,"UNIVERSITY OF SOUTHERN INDIANA",NA,NA,2004,1196,808,269,71,198,0.166,0.134,0.088,3676,1849
"3282",151306,2005,1,0,"University of Southern Indiana",NA,NA,2042,1195,847,306,90,216,0.181,0.15,0.106,3807,1890
"3283",151306,2006,1,0,"University of Southern Indiana",NA,NA,2021,1253,768,321,70,251,0.2,0.159,0.091,4014,1843
"3284",151306,2007,1,0,"University of Southern Indiana",NA,NA,2074,1209,865,299,74,225,0.186,0.144,0.086,4258,1868
"3285",151306,2008,1,0,"University of Southern Indiana",NA,NA,2055,1232,823,340,83,257,0.209,0.165,0.101,4509,1794
"3286",151306,2009,1,0,"University of Southern Indiana",NA,NA,2048,1199,849,420,100,320,0.267,0.205,0.118,5274,1809
"3287",151306,2010,1,0,"University of Southern Indiana",NA,NA,2041,1179,862,378,115,263,0.223,0.185,0.133,5540,1757
"3288",151324,1991,1,0,"INDIANA STATE UNIVERSITY",NA,NA,1919,969,950,276,114,162,0.167,0.144,0.12,2272,1677
"3289",151324,1992,1,0,"INDIANA STATE UNIVERSITY",NA,NA,2187,1161,1026,339,124,215,0.185,0.155,0.121,2452,1871
"3290",151324,1993,1,0,"INDIANA STATE UNIVERSITY",NA,NA,2221,1165,1056,334,128,206,0.177,0.15,0.121,2622,1939
"3291",151324,1995,1,0,"INDIANA STATE UNIVERSITY",NA,NA,1980,1032,948,350,132,218,0.211,0.177,0.139,2928,1661
"3292",151324,1996,1,0,"INDIANA STATE UNIVERSITY",NA,NA,1911,1026,885,355,111,244,0.238,0.186,0.125,3072,1606
"3293",151324,1997,1,0,"INDIANA STATE UNIVERSITY",NA,NA,1878,998,880,356,127,229,0.23,0.19,0.144,3196,1573
"3294",151324,1998,1,0,"INDIANA STATE UNIVERSITY",NA,NA,1994,1062,932,368,123,245,0.231,0.185,0.132,3324,1653
"3295",151324,1999,1,0,"INDIANA STATE UNIVERSITY",NA,NA,2014,998,1016,352,132,220,0.22,0.175,0.13,3426,1665
"3296",151324,2000,1,0,"INDIANA STATE UNIVERSITY",NA,NA,2124,1122,1002,404,126,278,0.248,0.19,0.126,3564,1766
"3297",151324,2001,1,0,"INDIANA STATE UNIVERSITY",NA,NA,2156,1166,990,413,148,265,0.227,0.192,0.149,3672,1746
"3298",151324,2002,1,0,"INDIANA STATE UNIVERSITY",NA,NA,2083,1065,1018,393,143,250,0.235,0.189,0.14,4116,1719
"3299",151324,2003,1,0,"INDIANA STATE UNIVERSITY",NA,NA,1974,974,1000,351,128,223,0.229,0.178,0.128,5322,1603
"3300",151324,2004,1,0,"INDIANA STATE UNIVERSITY",NA,NA,1813,901,912,341,128,213,0.236,0.188,0.14,5536,1445
"3301",151324,2005,1,0,"Indiana State University",NA,NA,1622,810,812,311,122,189,0.233,0.192,0.15,5756,1287
"3302",151324,2006,1,0,"Indiana State University",NA,NA,1657,827,830,335,125,210,0.254,0.202,0.151,6102,1250
"3303",151324,2007,1,0,"Indiana State University",NA,NA,1820,924,896,375,138,237,0.256,0.206,0.154,6462,1365
"3304",151324,2008,1,0,"Indiana State University",NA,NA,1907,954,953,357,151,206,0.216,0.187,0.158,6792,1405
"3305",151324,2009,1,0,"Indiana State University",NA,NA,1969,954,1015,393,183,210,0.22,0.2,0.18,7226,1412
"3306",151324,2010,1,0,"Indiana State University",NA,NA,2687,1352,1335,497,199,298,0.22,0.185,0.149,7514,1816
"3307",151333,1991,1,0,"INDIANA UNIVERSITY AT KOKOMO",NA,NA,315,199,116,8,1,7,0.035,0.025,0.009,1938,300
"3308",151333,1992,1,0,"INDIANA UNIVERSITY KOKOMO",NA,NA,304,200,104,15,4,11,0.055,0.049,0.038,2099,286
"3309",151333,1993,1,0,"INDIANA UNIVERSITY-KOKOMO",NA,NA,330,208,122,14,7,7,0.034,0.042,0.057,2244,319
"3310",151333,1995,1,0,"INDIANA UNIVERSITY-KOKOMO",NA,NA,294,184,110,27,7,20,0.109,0.092,0.064,2599,276
"3311",151333,1996,1,0,"INDIANA UNIVERSITY-KOKOMO",NA,NA,339,227,112,20,6,14,0.062,0.059,0.054,2757,319
"3312",151333,1997,1,0,"INDIANA UNIVERSITY-KOKOMO",NA,NA,306,204,102,17,5,12,0.059,0.056,0.049,2890,291
"3313",151333,1998,1,0,"INDIANA UNIVERSITY-KOKOMO",NA,NA,333,230,103,25,2,23,0.1,0.075,0.019,3004,319
"3314",151333,1999,1,0,"INDIANA UNIVERSITY-KOKOMO",NA,NA,295,213,82,27,7,20,0.094,0.092,0.085,2922,283
"3315",151333,2000,1,0,"INDIANA UNIVERSITY-KOKOMO",NA,NA,347,223,124,28,9,19,0.085,0.081,0.073,3024,334
"3316",151333,2001,1,0,"INDIANA UNIVERSITY-KOKOMO",NA,NA,343,233,110,36,8,28,0.12,0.105,0.073,3221,314
"3317",151333,2002,1,0,"INDIANA UNIVERSITY-KOKOMO",NA,NA,339,226,113,28,5,23,0.102,0.083,0.044,3478,311
"3318",151333,2003,1,0,"INDIANA UNIVERSITY-KOKOMO",NA,NA,382,264,118,27,5,22,0.083,0.071,0.042,4117,358
"3319",151333,2004,1,0,"INDIANA UNIVERSITY-KOKOMO",NA,NA,356,237,119,18,5,13,0.055,0.051,0.042,4283,328
"3320",151333,2005,1,0,"Indiana University-Kokomo",NA,NA,382,251,131,31,6,25,0.1,0.081,0.046,4475,360
"3321",151333,2006,1,0,"Indiana University-Kokomo",NA,NA,329,210,119,26,6,20,0.095,0.079,0.05,4694,297
"3322",151333,2007,1,0,"Indiana University-Kokomo",NA,NA,381,234,147,27,6,21,0.09,0.071,0.041,4928,343
"3323",151333,2008,1,0,"Indiana University-Kokomo",NA,NA,341,212,129,31,6,25,0.118,0.091,0.047,5174,306
"3324",151333,2009,1,0,"Indiana University-Kokomo",NA,NA,406,232,174,51,14,37,0.16,0.126,0.08,5408,350
"3325",151333,2010,1,0,"Indiana University-Kokomo",NA,NA,345,217,128,59,23,36,0.166,0.171,0.18,5663,314
"3326",151342,1991,1,0,"INDIANA UNIVERSITY AT SOUTH BEND",NA,NA,554,352,202,40,15,25,0.071,0.072,0.074,1952,481
"3327",151342,1992,1,0,"INDIANA UNIVERSITY SOUTH BEND",NA,NA,564,337,227,34,11,23,0.068,0.06,0.048,2105,499
"3328",151342,1993,1,0,"INDIANA UNIVERSITY-SOUTH BEND",NA,NA,554,360,194,32,16,16,0.044,0.058,0.082,2290,485
"3329",151342,1995,1,0,"INDIANA UNIVERSITY-SOUTH BEND",NA,NA,626,374,252,51,19,32,0.086,0.081,0.075,2742,532
"3330",151342,1996,1,0,"INDIANA UNIVERSITY-SOUTH BEND",NA,NA,593,360,233,41,9,32,0.089,0.069,0.039,2856,490
"3331",151342,1997,1,0,"INDIANA UNIVERSITY-SOUTH BEND",NA,NA,629,384,245,47,20,27,0.07,0.075,0.082,2985,529
"3332",151342,1998,1,0,"INDIANA UNIVERSITY-SOUTH BEND",NA,NA,732,427,305,31,14,17,0.04,0.042,0.046,3096,624
"3333",151342,1999,1,0,"INDIANA UNIVERSITY-SOUTH BEND",NA,NA,637,382,255,37,10,27,0.071,0.058,0.039,2974,562
"3334",151342,2000,1,0,"INDIANA UNIVERSITY-SOUTH BEND",NA,NA,637,349,288,22,6,16,0.046,0.035,0.021,3078,562
"3335",151342,2001,1,0,"INDIANA UNIVERSITY-SOUTH BEND",NA,NA,750,449,301,40,15,25,0.056,0.053,0.05,3278,639
"3336",151342,2002,1,0,"INDIANA UNIVERSITY-SOUTH BEND",NA,NA,660,390,270,36,9,27,0.069,0.055,0.033,3543,563
"3337",151342,2003,1,0,"INDIANA UNIVERSITY-SOUTH BEND",NA,NA,707,417,290,42,18,24,0.058,0.059,0.062,4180,619
"3338",151342,2004,1,0,"INDIANA UNIVERSITY-SOUTH BEND",NA,NA,704,432,272,29,11,18,0.042,0.041,0.04,4349,589
"3339",151342,2005,1,0,"Indiana University-South Bend",NA,NA,805,466,339,34,16,18,0.039,0.042,0.047,4583,685
"3340",151342,2006,1,0,"Indiana University-South Bend",NA,NA,772,427,345,31,16,15,0.035,0.04,0.046,4826,629
"3341",151342,2007,1,0,"Indiana University-South Bend",NA,NA,876,524,352,44,26,18,0.034,0.05,0.074,5069,729
"3342",151342,2008,1,0,"Indiana University-South Bend",NA,NA,943,590,353,54,23,31,0.052,0.057,0.065,5324,729
"3343",151342,2009,1,0,"Indiana University-South Bend",NA,NA,1045,611,434,60,21,39,0.064,0.057,0.048,5573,827
"3344",151342,2010,1,0,"Indiana University-South Bend",NA,NA,895,503,392,61,25,36,0.072,0.068,0.064,5843,684
"3345",151351,1991,1,0,"INDIANA UNIVERSITY BLOOMINGTON",NA,NA,5208,3013,2195,2205,881,1324,0.439,0.423,0.401,2484,4596
"3346",151351,1992,1,0,"INDIANA UNIVERSITY BLOOMINGTON",NA,NA,5529,3233,2296,2231,840,1391,0.43,0.404,0.366,2794,4881
"3347",151351,1993,1,0,"INDIANA UNIVERSITY-BLOOMINGTON",NA,NA,5833,3340,2493,2427,906,1521,0.455,0.416,0.363,2988,5174
"3348",151351,1995,1,0,"INDIANA UNIVERSITY-BLOOMINGTON",NA,NA,5705,3293,2412,3057,1182,1875,0.569,0.536,0.49,3582,4952
"3349",151351,1996,1,0,"INDIANA UNIVERSITY-BLOOMINGTON",NA,NA,5766,3376,2390,2660,975,1685,0.499,0.461,0.408,3783,5043
"3350",151351,1997,1,0,"INDIANA UNIVERSITY-BLOOMINGTON",NA,NA,6036,3497,2539,2827,1045,1782,0.51,0.468,0.412,3929,5294
"3351",151351,1998,1,0,"INDIANA UNIVERSITY-BLOOMINGTON",NA,NA,6735,3810,2925,2747,1088,1659,0.435,0.408,0.372,4068,5937
"3352",151351,1999,1,0,"INDIANA UNIVERSITY-BLOOMINGTON",NA,NA,6503,3828,2675,3137,1138,1999,0.522,0.482,0.425,3752,5683
"3353",151351,2000,1,0,"INDIANA UNIVERSITY-BLOOMINGTON",NA,NA,6862,3839,3023,3421,1362,2059,0.536,0.499,0.451,3902,5994
"3354",151351,2001,1,0,"INDIANA UNIVERSITY-BLOOMINGTON",NA,NA,6728,3716,3012,3353,1424,1929,0.519,0.498,0.473,4196,5859
"3355",151351,2002,1,0,"INDIANA UNIVERSITY-BLOOMINGTON",NA,NA,6987,3895,3092,3546,1471,2075,0.533,0.508,0.476,4573,6102
"3356",151351,2003,1,0,"INDIANA UNIVERSITY-BLOOMINGTON",NA,NA,6739,3773,2966,3490,1419,2071,0.549,0.518,0.478,5756,5809
"3357",151351,2004,1,0,"INDIANA UNIVERSITY-BLOOMINGTON",NA,NA,6300,3407,2893,3110,1273,1837,0.539,0.494,0.44,5986,5340
"3358",151351,2005,1,0,"Indiana University-Bloomington",NA,NA,6903,3785,3118,3425,1383,2042,0.54,0.496,0.444,6291,5778
"3359",151351,2006,1,0,"Indiana University-Bloomington",NA,NA,7208,3875,3333,3949,1681,2268,0.585,0.548,0.504,6657,6087
"3360",151351,2007,1,0,"Indiana University-Bloomington",NA,NA,7167,3707,3460,4169,1874,2295,0.619,0.582,0.542,7000,5975
"3361",151351,2008,1,0,"Indiana University-Bloomington",NA,NA,7550,3990,3560,4485,1959,2526,0.633,0.594,0.55,7368,6307
"3362",151351,2009,1,0,"Indiana University-Bloomington",NA,NA,7301,3640,3661,4387,2001,2386,0.655,0.601,0.547,7722,5833
"3363",151351,2010,1,0,"Indiana University-Bloomington",NA,NA,6977,3659,3318,4165,1805,2360,0.645,0.597,0.544,8124,5174
"3364",151360,1991,1,0,"INDIANA UNIVERSITY NORTHWEST",NA,NA,614,396,218,35,14,21,0.053,0.057,0.064,1952,447
"3365",151360,1992,1,0,"INDIANA UNIVERSITY NORTHWEST",NA,NA,597,386,211,26,9,17,0.044,0.044,0.043,2105,405
"3366",151360,1993,1,0,"INDIANA UNIVERSITY-NORTHWEST",NA,NA,665,415,250,26,13,13,0.031,0.039,0.052,2250,473
"3367",151360,1995,1,0,"INDIANA UNIVERSITY-NORTHWEST",NA,NA,599,383,216,42,13,29,0.076,0.07,0.06,2595,376
"3368",151360,1996,1,0,"INDIANA UNIVERSITY-NORTHWEST",NA,NA,560,355,205,37,14,23,0.065,0.066,0.068,2768,368
"3369",151360,1997,1,0,"INDIANA UNIVERSITY-NORTHWEST",NA,NA,508,340,168,21,7,14,0.041,0.041,0.042,2883,315
"3370",151360,1998,1,0,"INDIANA UNIVERSITY-NORTHWEST",NA,NA,535,347,188,31,8,23,0.066,0.058,0.043,3021,329
"3371",151360,1999,1,0,"INDIANA UNIVERSITY-NORTHWEST",NA,NA,540,345,195,45,16,29,0.084,0.083,0.082,2955,352
"3372",151360,2000,1,0,"INDIANA UNIVERSITY-NORTHWEST",NA,NA,517,318,199,33,16,17,0.054,0.064,0.08,3024,332
"3373",151360,2001,1,0,"INDIANA UNIVERSITY-NORTHWEST",NA,NA,511,340,171,43,12,31,0.091,0.084,0.07,3221,330
"3374",151360,2002,1,0,"INDIANA UNIVERSITY-NORTHWEST",NA,NA,602,365,237,39,14,25,0.068,0.065,0.059,3478,402
"3375",151360,2003,1,0,"INDIANA UNIVERSITY-NORTHWEST",NA,NA,660,417,243,49,14,35,0.084,0.074,0.058,4117,433
"3376",151360,2004,1,0,"INDIANA UNIVERSITY-NORTHWEST",NA,NA,604,375,229,28,10,18,0.048,0.046,0.044,4283,401
"3377",151360,2005,1,0,"Indiana University-Northwest",NA,NA,471,280,191,33,19,14,0.05,0.07,0.099,4475,312
"3378",151360,2006,1,0,"Indiana University-Northwest",NA,NA,561,352,209,31,8,23,0.065,0.055,0.038,4710,369
"3379",151360,2007,1,0,"Indiana University-Northwest",NA,NA,556,356,200,38,13,25,0.07,0.068,0.065,4962,362
"3380",151360,2008,1,0,"Indiana University-Northwest",NA,NA,596,387,209,47,13,34,0.088,0.079,0.062,5228,373
"3381",151360,2009,1,0,"Indiana University-Northwest",NA,NA,773,483,290,70,22,48,0.099,0.091,0.076,5478,437
"3382",151360,2010,1,0,"Indiana University-Northwest",NA,NA,784,495,289,47,13,34,0.069,0.06,0.045,5752,440
"3383",151379,1991,1,0,"INDIANA UNIVERSITY SOUTHEAST",NA,NA,589,343,246,23,6,17,0.05,0.039,0.024,1962,572
"3384",151379,1992,1,0,"INDIANA UNIVERSITY SOUTHEAST",NA,NA,638,381,257,27,6,21,0.055,0.042,0.023,2115,621
"3385",151379,1993,1,0,"INDIANA UNIVERSITY-SOUTHEAST",NA,NA,700,392,308,37,12,25,0.064,0.053,0.039,2260,668
"3386",151379,1995,1,0,"INDIANA UNIVERSITY-SOUTHEAST",NA,NA,593,357,236,74,27,47,0.132,0.125,0.114,2572,570
"3387",151379,1996,1,0,"INDIANA UNIVERSITY-SOUTHEAST",NA,NA,643,375,268,60,18,42,0.112,0.093,0.067,2718,629
"3388",151379,1997,1,0,"INDIANA UNIVERSITY-SOUTHEAST",NA,NA,641,376,265,57,12,45,0.12,0.089,0.045,2847,617
"3389",151379,1998,1,0,"INDIANA UNIVERSITY-SOUTHEAST",NA,NA,727,407,320,28,6,22,0.054,0.039,0.019,2986,698
"3390",151379,1999,1,0,"INDIANA UNIVERSITY-SOUTHEAST",NA,NA,719,448,271,54,13,41,0.092,0.075,0.048,2922,694
"3391",151379,2000,1,0,"INDIANA UNIVERSITY-SOUTHEAST",NA,NA,700,413,287,57,18,39,0.094,0.081,0.063,3024,688
"3392",151379,2001,1,0,"INDIANA UNIVERSITY-SOUTHEAST",NA,NA,722,440,282,57,13,44,0.1,0.079,0.046,3221,639
"3393",151379,2002,1,0,"INDIANA UNIVERSITY-SOUTHEAST",NA,NA,678,419,259,53,11,42,0.1,0.078,0.042,3479,627
"3394",151379,2003,1,0,"INDIANA UNIVERSITY-SOUTHEAST",NA,NA,674,400,274,53,15,38,0.095,0.079,0.055,4117,622
"3395",151379,2004,1,0,"INDIANA UNIVERSITY-SOUTHEAST",NA,NA,714,420,294,63,12,51,0.121,0.088,0.041,4283,663
"3396",151379,2005,1,0,"Indiana University-Southeast",NA,NA,664,409,255,53,12,41,0.1,0.08,0.047,4475,594
"3397",151379,2006,1,0,"Indiana University-Southeast",NA,NA,727,430,297,63,24,39,0.091,0.087,0.081,4698,663
"3398",151379,2007,1,0,"Indiana University-Southeast",NA,NA,783,449,334,69,21,48,0.107,0.088,0.063,4934,714
"3399",151379,2008,1,0,"Indiana University-Southeast",NA,NA,970,590,380,81,26,55,0.093,0.084,0.068,5184,841
"3400",151379,2009,1,0,"Indiana University-Southeast",NA,NA,995,612,383,80,27,53,0.087,0.08,0.07,5417,866
"3401",151379,2010,1,0,"Indiana University-Southeast",NA,NA,945,581,364,111,29,82,0.141,0.117,0.08,5672,821
"3402",151388,1991,1,0,"INDIANA UNIVERSITY EAST",NA,NA,222,146,76,2,0,2,0.014,0.009,0,1952,207
"3403",151388,1992,1,0,"INDIANA UNIVERSITY EAST",NA,NA,263,197,66,8,2,6,0.03,0.03,0.03,2105,254
"3404",151388,1993,1,0,"INDIANA UNIVERSITY-EAST",NA,NA,264,168,96,8,2,6,0.036,0.03,0.021,2250,247
"3405",151388,1995,1,0,"INDIANA UNIVERSITY-EAST",NA,NA,242,144,98,12,5,7,0.049,0.05,0.051,2615,220
"3406",151388,1996,1,0,"INDIANA UNIVERSITY-EAST",NA,NA,233,148,85,9,3,6,0.04,0.039,0.035,2728,220
"3407",151388,1997,1,0,"INDIANA UNIVERSITY-EAST",NA,NA,278,193,85,14,7,7,0.036,0.05,0.082,2849,259
"3408",151388,1998,1,0,"INDIANA UNIVERSITY-EAST",NA,NA,230,146,84,7,2,5,0.034,0.03,0.024,2987,210
"3409",151388,1999,1,0,"INDIANA UNIVERSITY-EAST",NA,NA,255,161,94,10,1,9,0.056,0.039,0.011,2922,226
"3410",151388,2000,1,0,"INDIANA UNIVERSITY-EAST",NA,NA,249,161,88,10,1,9,0.056,0.04,0.011,3024,230
"3411",151388,2001,1,0,"INDIANA UNIVERSITY-EAST",NA,NA,264,172,92,18,5,13,0.076,0.068,0.054,3221,236
"3412",151388,2002,1,0,"INDIANA UNIVERSITY-EAST",NA,NA,303,200,103,19,4,15,0.075,0.063,0.039,3478,281
"3413",151388,2003,1,0,"INDIANA UNIVERSITY-EAST",NA,NA,318,203,115,20,7,13,0.064,0.063,0.061,4117,283
"3414",151388,2004,1,0,"INDIANA UNIVERSITY-EAST",NA,NA,270,182,88,14,3,11,0.06,0.052,0.034,4283,250
"3415",151388,2005,1,0,"Indiana University-East",NA,NA,284,179,105,13,2,11,0.062,0.046,0.019,4475,256
"3416",151388,2006,1,0,"Indiana University-East",NA,NA,225,135,90,9,3,6,0.044,0.04,0.033,4697,209
"3417",151388,2007,1,0,"Indiana University-East",NA,NA,264,157,107,22,4,18,0.115,0.083,0.037,4932,243
"3418",151388,2008,1,0,"Indiana University-East",NA,NA,291,190,101,26,8,18,0.095,0.089,0.079,5178,262
"3419",151388,2009,1,0,"Indiana University-East",NA,NA,358,217,141,51,11,40,0.184,0.142,0.078,5416,323
"3420",151388,2010,1,0,"Indiana University-East",NA,NA,378,224,154,54,15,39,0.174,0.143,0.097,5676,347
"3421",151777,1991,1,0,"MANCHESTER COLLEGE",NA,NA,277,146,131,121,48,73,0.5,0.437,0.366,8270,253
"3422",151777,1992,1,0,"MANCHESTER COLLEGE",NA,NA,245,120,125,109,51,58,0.483,0.445,0.408,8960,225
"3423",151777,1993,1,0,"MANCHESTER COLLEGE",NA,NA,238,118,120,94,43,51,0.432,0.395,0.358,9600,217
"3424",151777,1995,1,0,"MANCHESTER COLLEGE",NA,NA,321,158,163,136,61,75,0.475,0.424,0.374,11470,301
"3425",151777,1996,1,0,"MANCHESTER COLLEGE",NA,NA,305,151,154,113,46,67,0.444,0.37,0.299,12120,278
"3426",151777,1997,1,0,"MANCHESTER COLLEGE",NA,NA,288,135,153,122,47,75,0.556,0.424,0.307,12660,257
"3427",151777,1998,1,0,"MANCHESTER COLLEGE",NA,NA,309,173,136,139,47,92,0.532,0.45,0.346,13280,287
"3428",151777,1999,1,0,"MANCHESTER COLLEGE",NA,NA,328,166,162,132,41,91,0.548,0.402,0.253,13930,277
"3429",151777,2000,1,0,"MANCHESTER COLLEGE",NA,NA,333,178,155,142,46,96,0.539,0.426,0.297,14510,292
"3430",151777,2001,1,0,"MANCHESTER COLLEGE",NA,NA,334,179,155,145,53,92,0.514,0.434,0.342,15230,289
"3431",151777,2002,1,0,"MANCHESTER COLLEGE",NA,NA,309,178,131,137,54,83,0.466,0.443,0.412,15990,269
"3432",151777,2003,1,0,"MANCHESTER COLLEGE",NA,NA,335,168,167,127,53,74,0.44,0.379,0.317,16940,298
"3433",151777,2004,1,0,"MANCHESTER COLLEGE",NA,NA,278,154,124,113,34,79,0.513,0.406,0.274,17950,243
"3434",151777,2005,1,0,"Manchester College",NA,NA,329,170,159,140,50,90,0.529,0.426,0.314,18860,290
"3435",151777,2006,1,0,"Manchester College",NA,NA,311,137,174,136,62,74,0.54,0.437,0.356,19800,270
"3436",151777,2007,1,0,"Manchester College",NA,NA,316,147,169,126,55,71,0.483,0.399,0.325,21000,277
"3437",151777,2008,1,0,"Manchester College",NA,NA,396,202,194,190,77,113,0.559,0.48,0.397,22000,346
"3438",151777,2009,1,0,"Manchester College",NA,NA,426,210,216,198,88,110,0.524,0.465,0.407,23000,383
"3439",151777,2010,1,0,"Manchester College",NA,NA,405,217,188,200,81,119,0.548,0.494,0.431,24100,349
"3440",151786,1991,1,0,"MARIAN COLLEGE",NA,NA,217,154,63,53,13,40,0.26,0.244,0.206,7584,195
"3441",151786,1992,1,0,"MARIAN COLLEGE",NA,NA,244,149,95,75,32,43,0.289,0.307,0.337,8594,113
"3442",151786,1993,1,0,"MARIAN COLLEGE",NA,NA,239,150,89,74,23,51,0.34,0.31,0.258,9360,198
"3443",151786,1995,1,0,"MARIAN COLLEGE",NA,NA,255,168,87,90,28,62,0.369,0.353,0.322,10824,190
"3444",151786,1996,1,0,"MARIAN COLLEGE",NA,NA,221,151,70,67,16,51,0.338,0.303,0.229,11440,137
"3445",151786,1997,1,0,"MARIAN COLLEGE",NA,NA,255,156,99,73,21,52,0.333,0.286,0.212,12458,196
"3446",151786,1998,1,0,"MARIAN COLLEGE",NA,NA,205,158,47,70,14,56,0.354,0.341,0.298,13406,162
"3447",151786,1999,1,0,"MARIAN COLLEGE",NA,NA,251,181,70,88,19,69,0.381,0.351,0.271,14012,210
"3448",151786,2000,1,0,"MARIAN COLLEGE",NA,NA,208,126,82,58,12,46,0.365,0.279,0.146,14432,185
"3449",151786,2001,1,0,"MARIAN COLLEGE",NA,NA,183,113,70,66,21,45,0.398,0.361,0.3,15226,148
"3450",151786,2002,1,0,"MARIAN COLLEGE",NA,NA,230,153,77,73,16,57,0.372,0.317,0.208,16000,186
"3451",151786,2003,1,0,"MARIAN COLLEGE",NA,NA,239,162,77,71,27,44,0.272,0.297,0.351,16800,201
"3452",151786,2004,1,0,"MARIAN COLLEGE",NA,NA,245,166,79,84,26,58,0.349,0.343,0.329,17600,210
"3453",151786,2005,1,0,"Marian College",NA,NA,189,127,62,64,17,47,0.37,0.339,0.274,18400,154
"3454",151786,2006,1,0,"Marian College",NA,NA,277,148,129,108,32,76,0.514,0.39,0.248,19900,240
"3455",151786,2007,1,0,"Marian College",NA,NA,271,142,129,76,23,53,0.373,0.28,0.178,20800,224
"3456",151786,2008,1,0,"Marian College",NA,NA,326,158,168,111,50,61,0.386,0.34,0.298,22400,262
"3457",151786,2009,1,0,"Marian University",NA,NA,312,166,146,103,39,64,0.385,0.33,0.267,24000,250
"3458",151786,2010,1,0,"Marian University",NA,NA,317,166,151,124,49,75,0.452,0.391,0.325,24960,266
"3459",152080,1991,1,0,"UNIVERSITY OF NOTRE DAME",NA,NA,1880,717,1163,1635,988,647,0.902,0.87,0.85,6752,1567
"3460",152080,1992,1,0,"UNIVERSITY OF NOTRE DAME",NA,NA,1879,822,1057,1631,900,731,0.889,0.868,0.851,14650,1580
"3461",152080,1993,1,0,"UNIVERSITY OF NOTRE DAME",NA,NA,1901,851,1050,1685,910,775,0.911,0.886,0.867,15810,1602
"3462",152080,1995,1,0,"UNIVERSITY OF NOTRE DAME",NA,NA,1902,870,1032,1667,887,780,0.897,0.876,0.859,17830,1586
"3463",152080,1996,1,0,"UNIVERSITY OF NOTRE DAME",NA,NA,1920,862,1058,1698,915,783,0.908,0.884,0.865,18810,1589
"3464",152080,1997,1,0,"UNIVERSITY OF NOTRE DAME",NA,NA,1904,875,1029,1675,879,796,0.91,0.88,0.854,19800,1620
"3465",152080,1998,1,0,"UNIVERSITY OF NOTRE DAME",NA,NA,1937,895,1042,1706,891,815,0.911,0.881,0.855,20900,1633
"3466",152080,1999,1,0,"UNIVERSITY OF NOTRE DAME",NA,NA,1967,932,1035,1739,880,859,0.922,0.884,0.85,22030,1627
"3467",152080,2000,1,0,"UNIVERSITY OF NOTRE DAME",NA,NA,1955,919,1036,1757,921,836,0.91,0.899,0.889,23180,1580
"3468",152080,2001,1,0,"UNIVERSITY OF NOTRE DAME",NA,NA,2036,958,1078,1825,956,869,0.907,0.896,0.887,24320,1636
"3469",152080,2002,1,0,"UNIVERSITY OF NOTRE DAME",NA,NA,1945,935,1010,1765,909,856,0.915,0.907,0.9,25510,1561
"3470",152080,2003,1,0,"UNIVERSITY OF NOTRE DAME",NA,NA,1995,928,1067,1797,955,842,0.907,0.901,0.895,27170,1511
"3471",152080,2004,1,0,"UNIVERSITY OF NOTRE DAME",NA,NA,1987,947,1040,1789,914,875,0.924,0.9,0.879,29070,1513
"3472",152080,2005,1,0,"University of Notre Dame",NA,NA,1990,935,1055,1800,942,858,0.918,0.905,0.893,31100,1493
"3473",152080,2006,1,0,"University of Notre Dame",NA,NA,2029,928,1101,1800,962,838,0.903,0.887,0.874,32900,1445
"3474",152080,2007,1,0,"University of Notre Dame",NA,NA,1984,948,1036,1782,913,869,0.917,0.898,0.881,34680,1471
"3475",152080,2008,1,0,"University of Notre Dame",NA,NA,1991,951,1040,1806,932,874,0.919,0.907,0.896,36340,1515
"3476",152080,2009,1,0,"University of Notre Dame",NA,NA,2055,930,1125,1867,1009,858,0.923,0.909,0.897,37970,1500
"3477",152080,2010,1,0,"University of Notre Dame",NA,NA,2056,966,1090,1846,966,880,0.911,0.898,0.886,39412,1477
"3478",152248,1991,1,0,"PURDUE UNIVERSITY CALUMET CAMPUS",NA,NA,921,466,455,17,6,11,0.024,0.018,0.013,1985,704
"3479",152248,1992,1,0,"PURDUE UNIVERSITY CALUMET CAMPUS",NA,NA,985,535,450,22,8,14,0.026,0.022,0.018,2145,741
"3480",152248,1993,1,0,"PURDUE UNIVERSITY-CALUMET CAMPUS",NA,NA,847,475,372,64,32,32,0.067,0.076,0.086,2290,607
"3481",152248,1995,1,0,"PURDUE UNIVERSITY-CALUMET CAMPUS",NA,NA,906,487,419,71,21,50,0.103,0.078,0.05,2658,642
"3482",152248,1996,1,0,"PURDUE UNIVERSITY-CALUMET CAMPUS",NA,NA,1026,558,468,92,42,50,0.09,0.09,0.09,2775,741
"3483",152248,1997,1,0,"PURDUE UNIVERSITY-CALUMET CAMPUS",NA,NA,1071,556,515,101,49,52,0.094,0.094,0.095,2970,771
"3484",152248,1998,1,0,"PURDUE UNIVERSITY-CALUMET CAMPUS",NA,NA,1062,560,502,38,17,21,0.038,0.036,0.034,3093,745
"3485",152248,1999,1,0,"PURDUE UNIVERSITY-CALUMET CAMPUS",NA,NA,1112,593,519,42,13,29,0.049,0.038,0.025,2926,800
"3486",152248,2000,1,0,"PURDUE UNIVERSITY-CALUMET CAMPUS",NA,NA,1043,577,466,37,14,23,0.04,0.035,0.03,3043,773
"3487",152248,2001,1,0,"PURDUE UNIVERSITY-CALUMET CAMPUS",NA,NA,958,507,451,37,12,25,0.049,0.039,0.027,3272,713
"3488",152248,2002,1,0,"PURDUE UNIVERSITY-CALUMET CAMPUS",NA,NA,927,474,453,36,16,20,0.042,0.039,0.035,3125,669
"3489",152248,2003,1,0,"PURDUE UNIVERSITY-CALUMET CAMPUS",NA,NA,997,527,470,56,21,35,0.066,0.056,0.045,3708,741
"3490",152248,2004,1,0,"PURDUE UNIVERSITY-CALUMET CAMPUS",NA,NA,954,492,462,55,24,31,0.063,0.058,0.052,3974,630
"3491",152248,2005,1,0,"Purdue University-Calumet Campus",NA,NA,1093,599,494,57,23,34,0.057,0.052,0.047,4212,689
"3492",152248,2006,1,0,"Purdue University-Calumet Campus",NA,NA,1036,546,490,52,19,33,0.06,0.05,0.039,4464,641
"3493",152248,2007,1,0,"Purdue University-Calumet Campus",NA,NA,1220,630,590,104,40,64,0.102,0.085,0.068,4666,728
"3494",152248,2008,1,0,"Purdue University-Calumet Campus",NA,NA,1213,624,589,108,50,58,0.093,0.089,0.085,4875,672
"3495",152248,2009,1,0,"Purdue University-Calumet Campus",NA,NA,1060,499,561,92,37,55,0.11,0.087,0.066,5119,624
"3496",152248,2010,1,0,"Purdue University-Calumet Campus",NA,NA,965,484,481,101,48,53,0.11,0.105,0.1,5374,555
"3497",152363,1991,1,0,"SAINT JOSEPH'S COLLEGE",NA,NA,252,94,158,95,51,44,0.468,0.377,0.323,9410,227
"3498",152363,1992,1,0,"SAINT JOSEPH'S COLLEGE",NA,NA,258,129,129,94,40,54,0.419,0.364,0.31,10030,233
"3499",152363,1993,1,0,"SAINT JOSEPHS COLLEGE",NA,NA,292,140,152,110,59,51,0.364,0.377,0.388,10830,262
"3500",152363,1995,1,0,"SAINT JOSEPHS COLLEGE",NA,NA,237,106,131,99,52,47,0.443,0.418,0.397,11900,200
"3501",152363,1996,1,0,"SAINT JOSEPHS COLLEGE",NA,NA,212,107,105,93,40,53,0.495,0.439,0.381,12260,190
"3502",152363,1997,1,0,"SAINT JOSEPHS COLLEGE",NA,NA,267,138,129,112,46,66,0.478,0.419,0.357,12620,239
"3503",152363,1998,1,0,"SAINT JOSEPHS COLLEGE",NA,NA,254,136,118,113,46,67,0.493,0.445,0.39,13590,227
"3504",152363,1999,1,0,"SAINT JOSEPHS COLLEGE",NA,NA,290,122,168,114,56,58,0.475,0.393,0.333,14070,246
"3505",152363,2000,1,0,"SAINT JOSEPHS COLLEGE",NA,NA,246,132,114,109,50,59,0.447,0.443,0.439,14920,222
"3506",152363,2001,1,0,"SAINT JOSEPHS COLLEGE",NA,NA,232,121,111,105,43,62,0.512,0.453,0.387,15880,205
"3507",152363,2002,1,0,"SAINT JOSEPHS COLLEGE",NA,NA,276,155,121,108,34,74,0.477,0.391,0.281,16900,242
"3508",152363,2003,1,0,"SAINT JOSEPHS COLLEGE",NA,NA,306,159,147,134,66,68,0.428,0.438,0.449,17900,255
"3509",152363,2004,1,0,"SAINT JOSEPHS COLLEGE",NA,NA,246,145,101,128,37,91,0.628,0.52,0.366,19000,210
"3510",152363,2005,1,0,"Saint Josephs College",NA,NA,266,145,121,128,41,87,0.6,0.481,0.339,19960,229
"3511",152363,2006,1,0,"Saint Josephs College",NA,NA,251,111,140,100,49,51,0.46,0.398,0.35,20800,198
"3512",152363,2007,1,0,"Saint Josephs College",NA,NA,300,138,162,107,50,57,0.413,0.357,0.309,21710,226
"3513",152363,2008,1,0,"Saint Josephs College",NA,NA,296,144,152,118,51,67,0.465,0.399,0.336,23000,234
"3514",152363,2009,1,0,"Saint Josephs College",NA,NA,240,108,132,102,41,61,0.565,0.425,0.311,24350,187
"3515",152363,2010,1,0,"Saint Josephs College",NA,NA,257,120,137,111,43,68,0.567,0.432,0.314,25080,191
"3516",152530,1991,1,0,"TAYLOR UNIVERSITY",NA,NA,466,248,218,247,94,153,0.617,0.53,0.431,9353,439
"3517",152530,1992,1,0,"TAYLOR UNIVERSITY-UPLAND",NA,NA,491,256,235,324,153,171,0.668,0.66,0.651,10000,466
"3518",152530,1993,1,0,"TAYLOR UNIVERSITY-UPLAND",NA,NA,435,233,202,270,107,163,0.7,0.621,0.53,10650,399
"3519",152530,1995,1,0,"TAYLOR UNIVERSITY-UPLAND",NA,NA,419,224,195,270,112,158,0.705,0.644,0.574,11914,389
"3520",152530,1996,1,0,"TAYLOR UNIVERSITY-UPLAND",NA,NA,485,270,215,348,147,201,0.744,0.718,0.684,12774,452
"3521",152530,1997,1,0,"TAYLOR UNIVERSITY-UPLAND",NA,NA,486,262,224,321,143,178,0.679,0.66,0.638,13484,457
"3522",152530,1998,1,0,"TAYLOR UNIVERSITY-UPLAND",NA,NA,460,243,217,293,128,165,0.679,0.637,0.59,14456,426
"3523",152530,1999,1,0,"TAYLOR UNIVERSITY-UPLAND",NA,NA,473,256,217,341,142,199,0.777,0.721,0.654,14900,438
"3524",152530,2000,1,0,"TAYLOR UNIVERSITY-UPLAND",NA,NA,482,242,240,332,149,183,0.756,0.689,0.621,15600,443
"3525",152530,2001,1,0,"TAYLOR UNIVERSITY-UPLAND",NA,NA,491,251,240,341,160,181,0.721,0.695,0.667,16350,464
"3526",152530,2002,1,0,"TAYLOR UNIVERSITY-UPLAND",NA,NA,452,244,208,322,142,180,0.738,0.712,0.683,17270,414
"3527",152530,2003,1,0,"TAYLOR UNIVERSITY-UPLAND",NA,NA,468,270,198,331,137,194,0.718,0.707,0.692,18306,438
"3528",152530,2004,1,0,"TAYLOR UNIVERSITY-UPLAND",NA,NA,476,265,211,334,134,200,0.755,0.702,0.635,19450,446
"3529",152530,2005,1,0,"Taylor University-Upland",NA,NA,459,271,188,342,142,200,0.738,0.745,0.755,20520,427
"3530",152530,2006,1,0,"Taylor University",NA,NA,492,266,226,341,146,195,0.733,0.693,0.646,21800,450
"3531",152530,2007,1,0,"Taylor University",NA,NA,472,272,200,306,129,177,0.651,0.648,0.645,23030,422
"3532",152530,2008,1,0,"Taylor University",NA,NA,465,266,199,312,115,197,0.741,0.671,0.578,24314,410
"3533",152530,2009,1,0,"Taylor University",NA,NA,482,263,219,342,141,201,0.764,0.71,0.644,25164,426
"3534",152530,2010,1,0,"Taylor University",NA,NA,467,270,197,308,112,196,0.726,0.66,0.569,26150,417
"3535",152600,1991,1,0,"VALPARAISO UNIVERSITY",NA,NA,615,340,275,327,114,213,0.626,0.532,0.415,9900,565
"3536",152600,1992,1,0,"VALPARAISO UNIVERSITY",NA,NA,601,334,267,305,117,188,0.563,0.507,0.438,10840,563
"3537",152600,1993,1,0,"VALPARAISO UNIVERSITY",NA,NA,487,251,236,278,109,169,0.673,0.571,0.462,11720,438
"3538",152600,1995,1,0,"VALPARAISO UNIVERSITY",NA,NA,673,370,303,405,141,264,0.713,0.602,0.465,12860,574
"3539",152600,1996,1,0,"VALPARAISO UNIVERSITY",NA,NA,656,348,308,381,149,232,0.667,0.581,0.484,13980,558
"3540",152600,1997,1,0,"VALPARAISO UNIVERSITY",NA,NA,702,382,320,416,163,253,0.662,0.593,0.509,14560,601
"3541",152600,1998,1,0,"VALPARAISO UNIVERSITY",NA,NA,685,350,335,396,162,234,0.669,0.578,0.484,15400,580
"3542",152600,1999,1,0,"VALPARAISO UNIVERSITY",NA,NA,730,376,354,429,192,237,0.63,0.588,0.542,16280,660
"3543",152600,2000,1,0,"VALPARAISO UNIVERSITY",NA,NA,707,388,319,450,188,262,0.675,0.636,0.589,17100,624
"3544",152600,2001,1,0,"VALPARAISO UNIVERSITY",NA,NA,660,339,321,442,187,255,0.752,0.67,0.583,18100,598
"3545",152600,2002,1,0,"VALPARAISO UNIVERSITY",NA,NA,715,365,350,454,197,257,0.704,0.635,0.563,19000,635
"3546",152600,2003,1,0,"VALPARAISO UNIVERSITY",NA,NA,791,400,391,501,229,272,0.68,0.633,0.586,20000,700
"3547",152600,2004,1,0,"VALPARAISO UNIVERSITY",NA,NA,746,376,370,446,201,245,0.652,0.598,0.543,21000,637
"3548",152600,2005,1,0,"Valparaiso University",NA,NA,672,332,340,421,183,238,0.717,0.626,0.538,22000,586
"3549",152600,2006,1,0,"Valparaiso University",NA,NA,760,394,366,469,206,263,0.667,0.617,0.563,23200,626
"3550",152600,2007,1,0,"Valparaiso University",NA,NA,713,370,343,413,193,220,0.595,0.579,0.563,24360,580
"3551",152600,2008,1,0,"Valparaiso University",NA,NA,655,336,319,390,169,221,0.658,0.595,0.53,26070,556
"3552",152600,2009,1,0,"Valparaiso University",NA,NA,671,330,341,371,157,214,0.648,0.553,0.46,27360,539
"3553",152600,2010,1,0,"Valparaiso University",NA,NA,691,360,331,376,148,228,0.633,0.544,0.447,28590,544
"3554",153001,1991,1,0,"BUENA VISTA COLLEGE",NA,NA,273,110,163,107,57,50,0.454,0.392,0.35,10900,263
"3555",153001,1992,1,0,"BUENA VISTA COLLEGE",NA,NA,290,132,158,129,56,73,0.553,0.445,0.354,11663,276
"3556",153001,1993,1,0,"BUENA VISTA COLLEGE",NA,NA,284,143,141,130,47,83,0.58,0.458,0.333,12565,274
"3557",153001,1995,1,0,"BUENA VISTA UNIVERSITY",NA,NA,352,167,185,168,71,97,0.581,0.477,0.384,14078,341
"3558",153001,1996,1,0,"BUENA VISTA UNIVERSITY",NA,NA,311,161,150,124,52,72,0.447,0.399,0.347,14458,304
"3559",153001,1997,1,0,"BUENA VISTA UNIVERSITY",NA,NA,385,185,200,169,70,99,0.535,0.439,0.35,14848,374
"3560",153001,1998,1,0,"BUENA VISTA UNIVERSITY",NA,NA,323,165,158,165,68,97,0.588,0.511,0.43,15292,309
"3561",153001,1999,1,0,"BUENA VISTA UNIVERSITY",NA,NA,322,144,178,146,69,77,0.535,0.453,0.388,15751,313
"3562",153001,2000,1,0,"BUENA VISTA UNIVERSITY",NA,NA,326,182,144,153,62,91,0.5,0.469,0.431,17176,309
"3563",153001,2001,1,0,"BUENA VISTA UNIVERSITY",NA,NA,379,189,190,166,69,97,0.513,0.438,0.363,17846,353
"3564",153001,2002,1,0,"BUENA VISTA UNIVERSITY",NA,NA,356,192,164,184,79,105,0.547,0.517,0.482,18738,317
"3565",153001,2003,1,0,"BUENA VISTA UNIVERSITY",NA,NA,377,193,184,172,74,98,0.508,0.456,0.402,19862,331
"3566",153001,2004,1,0,"BUENA VISTA UNIVERSITY",NA,NA,331,173,158,150,63,87,0.503,0.453,0.399,20854,280
"3567",153001,2005,1,0,"Buena Vista University",NA,NA,286,143,143,121,50,71,0.496,0.423,0.35,21688,256
"3568",153001,2006,1,0,"Buena Vista University",NA,NA,265,133,132,111,51,60,0.451,0.419,0.386,22556,241
"3569",153001,2007,1,0,"Buena Vista University",NA,NA,226,122,104,97,35,62,0.508,0.429,0.337,23842,195
"3570",153001,2008,1,0,"Buena Vista University",NA,NA,273,117,156,96,46,50,0.427,0.352,0.295,24796,213
"3571",153001,2009,1,0,"Buena Vista University",NA,NA,271,123,148,116,55,61,0.496,0.428,0.372,25540,216
"3572",153001,2010,1,0,"Buena Vista University",NA,NA,265,139,126,117,43,74,0.532,0.442,0.341,26306,200
"3573",153108,1991,0,1,"CENTRAL UNIVERSITY OF IOWA",1996,0,414,239,175,224,95,129,0.54,0.541,0.543,9198,384
"3574",153108,1992,0,1,"CENTRAL UNIVERSITY OF IOWA",1996,0,428,235,193,242,98,144,0.613,0.565,0.508,9875,394
"3575",153108,1993,0,1,"CENTRAL UNIVERSITY OF IOWA",1996,0,397,210,187,211,87,124,0.591,0.531,0.465,10239,369
"3576",153108,1995,0,1,"CENTRAL COLLEGE",1996,0,410,249,161,247,92,155,0.623,0.602,0.571,11836,378
"3577",153108,1996,1,0,"CENTRAL COLLEGE",1996,1,303,178,125,160,58,102,0.573,0.528,0.464,12304,286
"3578",153108,1997,1,0,"CENTRAL COLLEGE",1996,1,306,178,128,183,67,116,0.652,0.598,0.523,12802,298
"3579",153108,1998,1,0,"CENTRAL COLLEGE",1996,1,411,222,189,249,101,148,0.667,0.606,0.534,13388,403
"3580",153108,1999,1,0,"CENTRAL COLLEGE",1996,1,403,219,184,7,0,7,0.032,0.017,0,14070,386
"3581",153108,2000,1,0,"CENTRAL COLLEGE",1996,1,369,214,155,226,84,142,0.664,0.612,0.542,14638,353
"3582",153108,2001,1,0,"CENTRAL COLLEGE",1996,1,412,237,175,274,108,166,0.7,0.665,0.617,15598,393
"3583",153108,2002,1,0,"CENTRAL COLLEGE",1996,1,425,234,191,263,103,160,0.684,0.619,0.539,16612,402
"3584",153108,2003,1,0,"CENTRAL COLLEGE",1996,1,416,227,189,231,87,144,0.634,0.555,0.46,17609,397
"3585",153108,2004,1,0,"CENTRAL COLLEGE",1996,1,441,223,218,260,118,142,0.637,0.59,0.541,18648,420
"3586",153108,2005,1,0,"Central College",1996,1,366,203,163,213,93,120,0.591,0.582,0.571,19684,339
"3587",153108,2006,1,0,"Central College",1996,1,413,218,195,256,103,153,0.702,0.62,0.528,20972,383
"3588",153108,2007,1,0,"Central College",1996,1,422,219,203,260,111,149,0.68,0.616,0.547,22230,389
"3589",153108,2008,1,0,"Central College",1996,1,404,204,200,255,101,154,0.755,0.631,0.505,23564,377
"3590",153108,2009,1,0,"Central College",1996,1,442,213,229,264,117,147,0.69,0.597,0.511,24630,401
"3591",153108,2010,1,0,"Central College",1996,1,402,212,190,235,99,136,0.642,0.585,0.521,25862,355
"3592",153269,1991,1,0,"DRAKE UNIVERSITY",NA,NA,744,424,320,398,154,244,0.576,0.535,0.481,11040,651
"3593",153269,1992,1,0,"DRAKE UNIVERSITY",NA,NA,838,476,362,407,150,257,0.54,0.486,0.414,11780,731
"3594",153269,1993,1,0,"DRAKE UNIVERSITY",NA,NA,832,492,340,422,158,264,0.537,0.507,0.465,12780,742
"3595",153269,1995,1,0,"DRAKE UNIVERSITY",NA,NA,734,435,299,365,144,221,0.508,0.497,0.482,14100,594
"3596",153269,1996,1,0,"DRAKE UNIVERSITY",NA,NA,638,385,253,352,145,207,0.538,0.552,0.573,14380,537
"3597",153269,1997,1,0,"DRAKE UNIVERSITY",NA,NA,636,368,268,389,141,248,0.674,0.612,0.526,15200,513
"3598",153269,1998,1,0,"DRAKE UNIVERSITY",NA,NA,670,379,291,378,134,244,0.644,0.564,0.46,16000,563
"3599",153269,1999,1,0,"DRAKE UNIVERSITY",NA,NA,670,364,306,371,151,220,0.604,0.554,0.493,16480,553
"3600",153269,2000,1,0,"DRAKE UNIVERSITY",NA,NA,760,475,285,353,127,226,0.476,0.464,0.446,17090,628
"3601",153269,2001,1,0,"DRAKE UNIVERSITY",NA,NA,755,476,279,361,122,239,0.502,0.478,0.437,17580,627
"3602",153269,2002,1,0,"DRAKE UNIVERSITY",NA,NA,775,459,316,360,148,212,0.462,0.465,0.468,18190,650
"3603",153269,2003,1,0,"DRAKE UNIVERSITY",NA,NA,809,474,335,410,151,259,0.546,0.507,0.451,19100,694
"3604",153269,2004,1,0,"DRAKE UNIVERSITY",NA,NA,782,462,320,408,162,246,0.532,0.522,0.506,20200,653
"3605",153269,2005,1,0,"Drake University",NA,NA,809,465,344,438,173,265,0.57,0.541,0.503,21100,688
"3606",153269,2006,1,0,"Drake University",NA,NA,779,470,309,429,173,256,0.545,0.551,0.56,22270,638
"3607",153269,2007,1,0,"Drake University",NA,NA,923,557,366,484,170,314,0.564,0.524,0.464,23280,778
"3608",153269,2008,1,0,"Drake University",NA,NA,901,544,357,507,199,308,0.566,0.563,0.557,24430,797
"3609",153269,2009,1,0,"Drake University",NA,NA,860,512,348,482,185,297,0.58,0.56,0.532,25160,744
"3610",153269,2010,1,0,"Drake University",NA,NA,864,474,390,513,218,295,0.622,0.594,0.559,26400,754
"3611",153384,1991,1,0,"GRINNELL COLLEGE",NA,NA,324,184,140,248,104,144,0.783,0.765,0.743,13742,256
"3612",153384,1992,1,0,"GRINNELL COLLEGE",NA,NA,295,168,127,234,101,133,0.792,0.793,0.795,14532,223
"3613",153384,1993,1,0,"GRINNELL COLLEGE",NA,NA,434,224,210,321,151,170,0.759,0.74,0.719,15368,341
"3614",153384,1995,1,0,"GRINNELL COLLEGE",NA,NA,307,168,139,238,106,132,0.786,0.775,0.763,16628,243
"3615",153384,1996,1,0,"GRINNELL COLLEGE",NA,NA,354,210,144,271,106,165,0.786,0.766,0.736,17134,268
"3616",153384,1997,1,0,"GRINNELL COLLEGE",NA,NA,413,234,179,330,140,190,0.812,0.799,0.782,17568,319
"3617",153384,1998,1,0,"GRINNELL COLLEGE",NA,NA,350,194,156,282,127,155,0.799,0.806,0.814,18446,258
"3618",153384,1999,1,0,"GRINNELL COLLEGE",NA,NA,325,168,157,271,126,145,0.863,0.834,0.803,18990,223
"3619",153384,2000,1,0,"GRINNELL COLLEGE",NA,NA,363,209,154,312,127,185,0.885,0.86,0.825,19982,245
"3620",153384,2001,1,0,"GRINNELL COLLEGE",NA,NA,356,184,172,291,130,161,0.875,0.817,0.756,21700,242
"3621",153384,2002,1,0,"GRINNELL COLLEGE",NA,NA,368,202,166,297,132,165,0.817,0.807,0.795,22960,261
"3622",153384,2003,1,0,"GRINNELL COLLEGE",NA,NA,403,214,189,315,138,177,0.827,0.782,0.73,23898,285
"3623",153384,2004,1,0,"GRINNELL COLLEGE",NA,NA,434,237,197,363,155,208,0.878,0.836,0.787,25200,301
"3624",153384,2005,1,0,"Grinnell College",NA,NA,385,206,179,320,148,172,0.835,0.831,0.827,27060,245
"3625",153384,2006,1,0,"Grinnell College",NA,NA,405,206,199,348,166,182,0.883,0.859,0.834,28566,270
"3626",153384,2007,1,0,"Grinnell College",NA,NA,426,233,193,344,152,192,0.824,0.808,0.788,29710,260
"3627",153384,2008,1,0,"Grinnell College",NA,NA,462,251,211,392,171,221,0.88,0.848,0.81,34932,299
"3628",153384,2009,1,0,"Grinnell College",NA,NA,377,202,175,299,124,175,0.866,0.793,0.709,35976,202
"3629",153384,2010,1,0,"Grinnell College",NA,NA,415,231,184,336,140,196,0.848,0.81,0.761,36948,230
"3630",153603,1991,1,0,"IOWA STATE UNIVERSITY",NA,NA,3228,1368,1860,665,281,384,0.281,0.206,0.151,2072,2787
"3631",153603,1992,1,0,"IOWA STATE UNIVERSITY",NA,NA,3333,1432,1901,723,309,414,0.289,0.217,0.163,2228,2833
"3632",153603,1993,1,0,"IOWA STATE UNIVERSITY",NA,NA,3416,1435,1981,763,327,436,0.304,0.223,0.165,2352,2893
"3633",153603,1995,1,0,"IOWA STATE UNIVERSITY",NA,NA,3274,1490,1784,822,341,481,0.323,0.251,0.191,2574,2937
"3634",153603,1996,1,0,"IOWA STATE UNIVERSITY",NA,NA,3599,1592,2007,1022,455,567,0.356,0.284,0.227,2666,3170
"3635",153603,1997,1,0,"IOWA STATE UNIVERSITY",NA,NA,4007,1790,2217,1081,437,644,0.36,0.27,0.197,2766,3500
"3636",153603,1998,1,0,"IOWA STATE UNIVERSITY",NA,NA,3800,1775,2025,1111,438,673,0.379,0.292,0.216,2874,3348
"3637",153603,1999,1,0,"IOWA STATE UNIVERSITY",NA,NA,4020,1830,2190,1261,520,741,0.405,0.314,0.237,2786,3494
"3638",153603,2000,1,0,"IOWA STATE UNIVERSITY",NA,NA,4282,1928,2354,1340,515,825,0.428,0.313,0.219,2906,3697
"3639",153603,2001,1,0,"IOWA STATE UNIVERSITY",NA,NA,4589,2087,2502,1463,591,872,0.418,0.319,0.236,3116,3910
"3640",153603,2002,1,0,"IOWA STATE UNIVERSITY",NA,NA,4167,1915,2252,1399,566,833,0.435,0.336,0.251,3692,3557
"3641",153603,2003,1,0,"IOWA STATE UNIVERSITY",NA,NA,3860,1683,2177,1364,577,787,0.468,0.353,0.265,4342,3288
"3642",153603,2004,1,0,"IOWA STATE UNIVERSITY",NA,NA,3674,1618,2056,1348,572,776,0.48,0.367,0.278,4702,3142
"3643",153603,2005,1,0,"Iowa State University",NA,NA,3737,1629,2108,1248,535,713,0.438,0.334,0.254,4890,3214
"3644",153603,2006,1,0,"Iowa State University",NA,NA,3933,1780,2153,1525,649,876,0.492,0.388,0.301,5086,3350
"3645",153603,2007,1,0,"Iowa State University",NA,NA,4307,1920,2387,1622,682,940,0.49,0.377,0.286,5352,3671
"3646",153603,2008,1,0,"Iowa State University",NA,NA,4528,2074,2454,1787,772,1015,0.489,0.395,0.315,5524,3740
"3647",153603,2009,1,0,"Iowa State University",NA,NA,4320,1974,2346,1757,742,1015,0.514,0.407,0.316,5756,3501
"3648",153603,2010,1,0,"Iowa State University",NA,NA,4518,2077,2441,2006,847,1159,0.558,0.444,0.347,6102,3623
"3649",153834,1991,1,0,"LUTHER COLLEGE",NA,NA,578,349,229,368,134,234,0.67,0.637,0.585,10600,538
"3650",153834,1992,1,0,"LUTHER COLLEGE",NA,NA,579,357,222,389,144,245,0.686,0.672,0.649,11600,543
"3651",153834,1993,1,0,"LUTHER COLLEGE",NA,NA,586,341,245,411,176,235,0.689,0.701,0.718,12375,554
"3652",153834,1995,1,0,"LUTHER COLLEGE",NA,NA,590,372,218,375,122,253,0.68,0.636,0.56,14100,538
"3653",153834,1996,1,0,"LUTHER COLLEGE",NA,NA,615,347,268,437,190,247,0.712,0.711,0.709,14900,557
"3654",153834,1997,1,0,"LUTHER COLLEGE",NA,NA,629,385,244,431,161,270,0.701,0.685,0.66,15630,562
"3655",153834,1998,1,0,"LUTHER COLLEGE",NA,NA,678,396,282,446,179,267,0.674,0.658,0.635,16525,592
"3656",153834,1999,1,0,"LUTHER COLLEGE",NA,NA,606,354,252,393,155,238,0.672,0.649,0.615,17290,552
"3657",153834,2000,1,0,"LUTHER COLLEGE",NA,NA,662,396,266,420,161,259,0.654,0.634,0.605,18080,588
"3658",153834,2001,1,0,"LUTHER COLLEGE",NA,NA,636,397,239,401,144,257,0.647,0.631,0.603,19325,537
"3659",153834,2002,1,0,"LUTHER COLLEGE",NA,NA,608,365,243,371,135,236,0.647,0.61,0.556,20310,541
"3660",153834,2003,1,0,"LUTHER COLLEGE",NA,NA,667,397,270,436,172,264,0.665,0.654,0.637,21600,612
"3661",153834,2004,1,0,"LUTHER COLLEGE",NA,NA,661,387,274,435,183,252,0.651,0.658,0.668,23070,601
"3662",153834,2005,1,0,"Luther College",NA,NA,629,354,275,367,140,227,0.641,0.583,0.509,24570,558
"3663",153834,2006,1,0,"Luther College",NA,NA,610,350,260,417,180,237,0.677,0.684,0.692,26380,542
"3664",153834,2007,1,0,"Luther College",NA,NA,659,374,285,439,177,262,0.701,0.666,0.621,28840,552
"3665",153834,2008,1,0,"Luther College",NA,NA,630,371,259,469,194,275,0.741,0.744,0.749,30920,511
"3666",153834,2009,1,0,"Luther College",NA,NA,657,380,277,451,190,261,0.687,0.686,0.686,32140,507
"3667",153834,2010,1,0,"Luther College",NA,NA,611,342,269,438,177,261,0.763,0.717,0.658,33330,551
"3668",154095,1991,1,0,"UNIVERSITY OF NORTHERN IOWA",NA,NA,1949,1181,768,470,151,319,0.27,0.241,0.197,1952,1840
"3669",154095,1992,1,0,"UNIVERSITY OF NORTHERN IOWA",NA,NA,1659,984,675,435,143,292,0.297,0.262,0.212,2228,1558
"3670",154095,1993,1,0,"UNIVERSITY OF NORTHERN IOWA",NA,NA,1808,1112,696,491,152,339,0.305,0.272,0.218,2352,1691
"3671",154095,1995,1,0,"UNIVERSITY OF NORTHERN IOWA",NA,NA,2007,1244,763,604,170,434,0.349,0.301,0.223,2558,1912
"3672",154095,1996,1,0,"UNIVERSITY OF NORTHERN IOWA",NA,NA,2012,1234,778,673,224,449,0.364,0.334,0.288,2650,1899
"3673",154095,1997,1,0,"UNIVERSITY OF NORTHERN IOWA",NA,NA,1920,1192,728,553,169,384,0.322,0.288,0.232,2752,1790
"3674",154095,1998,1,0,"UNIVERSITY OF NORTHERN IOWA",NA,NA,1982,1257,725,585,146,439,0.349,0.295,0.201,2860,1864
"3675",154095,1999,1,0,"UNIVERSITY OF NORTHERN IOWA",NA,NA,2122,1303,819,713,211,502,0.385,0.336,0.258,2786,1978
"3676",154095,2000,1,0,"UNIVERSITY OF NORTHERN IOWA",NA,NA,2218,1337,881,751,243,508,0.38,0.339,0.276,2906,2009
"3677",154095,2001,1,0,"UNIVERSITY OF NORTHERN IOWA",NA,NA,2055,1310,745,665,189,476,0.363,0.324,0.254,3116,1878
"3678",154095,2002,1,0,"UNIVERSITY OF NORTHERN IOWA",NA,NA,1821,1139,682,610,194,416,0.365,0.335,0.284,3692,1674
"3679",154095,2003,1,0,"UNIVERSITY OF NORTHERN IOWA",NA,NA,1739,1088,651,613,182,431,0.396,0.353,0.28,4342,1598
"3680",154095,2004,1,0,"UNIVERSITY OF NORTHERN IOWA",NA,NA,1652,995,657,581,172,409,0.411,0.352,0.262,4702,1508
"3681",154095,2005,1,0,"University of Northern Iowa",NA,NA,1693,1062,631,618,184,434,0.409,0.365,0.292,4890,1550
"3682",154095,2006,1,0,"University of Northern Iowa",NA,NA,1684,1010,674,648,200,448,0.444,0.385,0.297,5086,1525
"3683",154095,2007,1,0,"University of Northern Iowa",NA,NA,1922,1177,745,708,237,471,0.4,0.368,0.318,5352,1767
"3684",154095,2008,1,0,"University of Northern Iowa",NA,NA,1972,1206,766,747,254,493,0.409,0.379,0.332,5524,1804
"3685",154095,2009,1,0,"University of Northern Iowa",NA,NA,1913,1194,719,721,220,501,0.42,0.377,0.306,5756,1761
"3686",154095,2010,1,0,"University of Northern Iowa",NA,NA,1934,1214,720,759,229,530,0.437,0.392,0.318,6102,1790
"3687",155089,1991,1,0,"FRIENDS UNIVERSITY",NA,NA,165,99,66,44,12,32,0.323,0.267,0.182,7155,133
"3688",155089,1992,1,0,"FRIENDS UNIVERSITY",NA,NA,150,101,49,31,6,25,0.248,0.207,0.122,7655,127
"3689",155089,1993,1,0,"FRIENDS UNIVERSITY",NA,NA,230,125,105,55,22,33,0.264,0.239,0.21,8185,192
"3690",155089,1995,1,0,"FRIENDS UNIVERSITY",NA,NA,200,109,91,43,19,24,0.22,0.215,0.209,9017,161
"3691",155089,1996,1,0,"FRIENDS UNIVERSITY",NA,NA,196,111,85,47,12,35,0.315,0.24,0.141,9465,153
"3692",155089,1997,1,0,"FRIENDS UNIVERSITY",NA,NA,179,99,80,39,11,28,0.283,0.218,0.138,9974,130
"3693",155089,1998,1,0,"FRIENDS UNIVERSITY",NA,NA,195,106,89,35,14,21,0.198,0.179,0.157,10490,161
"3694",155089,1999,1,0,"FRIENDS UNIVERSITY",NA,NA,226,125,101,36,13,23,0.184,0.159,0.129,10920,182
"3695",155089,2000,1,0,"FRIENDS UNIVERSITY",NA,NA,231,127,104,49,18,31,0.244,0.212,0.173,11460,177
"3696",155089,2001,1,0,"FRIENDS UNIVERSITY",NA,NA,197,133,64,23,6,17,0.128,0.117,0.094,12210,155
"3697",155089,2002,1,0,"FRIENDS UNIVERSITY",NA,NA,203,121,82,35,15,20,0.165,0.172,0.183,12845,163
"3698",155089,2003,1,0,"FRIENDS UNIVERSITY",NA,NA,201,102,99,38,14,24,0.235,0.189,0.141,13620,141
"3699",155089,2004,1,0,"FRIENDS UNIVERSITY",NA,NA,207,112,95,27,14,13,0.116,0.13,0.147,14430,132
"3700",155089,2005,1,0,"Friends University",NA,NA,151,72,79,16,7,9,0.125,0.106,0.089,15150,114
"3701",155089,2006,1,0,"Friends University",NA,NA,139,64,75,12,8,4,0.062,0.086,0.107,16050,101
"3702",155089,2007,1,0,"Friends University",NA,NA,139,72,67,14,7,7,0.097,0.101,0.104,17100,88
"3703",155089,2008,1,0,"Friends University",NA,NA,169,100,69,20,2,18,0.18,0.118,0.029,18200,121
"3704",155089,2009,1,0,"Friends University",NA,NA,217,114,103,62,33,29,0.254,0.286,0.32,18930,161
"3705",155089,2010,1,0,"Friends University",NA,NA,199,90,109,42,17,25,0.278,0.211,0.156,19890,132
"3706",155317,1991,1,0,"UNIVERSITY OF KANSAS MAIN CAMPUS",NA,NA,3287,1755,1532,749,291,458,0.261,0.228,0.19,1662,2810
"3707",155317,1992,1,0,"UNIVERSITY OF KANSAS MAIN CAMPUS",NA,NA,3495,1778,1717,814,304,510,0.287,0.233,0.177,1798,2987
"3708",155317,1993,1,0,"UNIVERSITY OF KANSAS MAIN CAMPUS",NA,NA,3603,1849,1754,843,335,508,0.275,0.234,0.191,1920,3090
"3709",155317,1995,1,0,"UNIVERSITY OF KANSAS MAIN CAMPUS",NA,NA,3474,1857,1617,905,351,554,0.298,0.261,0.217,2182,3022
"3710",155317,1996,1,0,"UNIVERSITY OF KANSAS MAIN CAMPUS",NA,NA,3546,1902,1644,926,349,577,0.303,0.261,0.212,2310,3072
"3711",155317,1997,1,0,"UNIVERSITY OF KANSAS MAIN CAMPUS",NA,NA,3808,1989,1819,1093,424,669,0.336,0.287,0.233,2385,3261
"3712",155317,1998,1,0,"UNIVERSITY OF KANSAS MAIN CAMPUS",NA,NA,3698,2069,1629,974,322,652,0.315,0.263,0.198,2470,3201
"3713",155317,1999,1,0,"UNIVERSITY OF KANSAS MAIN CAMPUS",NA,NA,3784,2099,1685,1155,374,781,0.372,0.305,0.222,2090,3281
"3714",155317,2000,1,0,"UNIVERSITY OF KANSAS MAIN CAMPUS",NA,NA,4119,2268,1851,1282,455,827,0.365,0.311,0.246,2267,3550
"3715",155317,2001,1,0,"UNIVERSITY OF KANSAS MAIN CAMPUS",NA,NA,4024,2198,1826,1267,476,791,0.36,0.315,0.261,2333,3513
"3716",155317,2002,1,0,"UNIVERSITY OF KANSAS MAIN CAMPUS",NA,NA,4013,2181,1832,1227,477,750,0.344,0.306,0.26,2921,3482
"3717",155317,2003,1,0,"UNIVERSITY OF KANSAS MAIN CAMPUS",NA,NA,3971,2126,1845,1261,480,781,0.367,0.318,0.26,3527,3316
"3718",155317,2004,1,0,"UNIVERSITY OF KANSAS MAIN CAMPUS",NA,NA,4182,2148,2034,1345,527,818,0.381,0.322,0.259,4163,3429
"3719",155317,2005,1,0,"University of Kansas Main Campus",NA,NA,4106,2115,1991,1332,518,814,0.385,0.324,0.26,4824,3462
"3720",155317,2006,1,0,"University of Kansas Main Campus",NA,NA,4092,2092,2000,1500,607,893,0.427,0.367,0.304,5513,3417
"3721",155317,2007,1,0,"University of Kansas",NA,NA,4028,2084,1944,1444,582,862,0.414,0.358,0.299,5844,3332
"3722",155317,2008,1,0,"University of Kansas",NA,NA,4435,2260,2175,1649,670,979,0.433,0.372,0.308,6195,3609
"3723",155317,2009,1,0,"University of Kansas",NA,NA,3894,1984,1910,1459,599,860,0.434,0.375,0.314,6567,3067
"3724",155317,2010,1,0,"University of Kansas",NA,NA,3489,1743,1746,1435,603,832,0.477,0.411,0.345,7167,2837
"3725",155335,1991,1,0,"KANSAS NEWMAN COLLEGE",NA,NA,82,61,21,15,3,12,0.197,0.183,0.143,6380,71
"3726",155335,1992,1,0,"KANSAS NEWMAN COLLEGE",NA,NA,83,57,26,28,8,20,0.351,0.337,0.308,6636,69
"3727",155335,1993,1,0,"KANSAS NEWMAN COLLEGE",NA,NA,98,72,26,20,5,15,0.208,0.204,0.192,7380,78
"3728",155335,1995,1,0,"KANSAS NEWMAN COLLEGE",NA,NA,118,74,44,23,6,17,0.23,0.195,0.136,8100,97
"3729",155335,1996,1,0,"KANSAS NEWMAN COLLEGE",NA,NA,96,61,35,29,10,19,0.312,0.302,0.286,8500,74
"3730",155335,1997,1,0,"KANSAS NEWMAN COLLEGE",NA,NA,89,50,39,22,10,12,0.24,0.247,0.256,9000,75
"3731",155335,1998,1,0,"NEWMAN UNIVERSITY",NA,NA,110,65,45,28,8,20,0.308,0.255,0.178,9000,96
"3732",155335,1999,1,0,"NEWMAN UNIVERSITY",NA,NA,148,87,61,50,18,32,0.368,0.338,0.295,9000,130
"3733",155335,2000,1,0,"NEWMAN UNIVERSITY",NA,NA,171,112,59,49,14,35,0.312,0.287,0.237,10148,132
"3734",155335,2001,1,0,"NEWMAN UNIVERSITY",NA,NA,130,76,54,40,18,22,0.29,0.308,0.333,11060,92
"3735",155335,2002,1,0,"NEWMAN UNIVERSITY",NA,NA,143,79,64,37,17,20,0.253,0.259,0.266,11890,107
"3736",155335,2003,1,0,"NEWMAN UNIVERSITY",NA,NA,200,118,82,57,19,38,0.322,0.285,0.232,13198,132
"3737",155335,2004,1,0,"NEWMAN UNIVERSITY",NA,NA,216,112,104,43,17,26,0.232,0.199,0.163,14650,114
"3738",155335,2005,1,0,"Newman University",NA,NA,181,84,97,31,12,19,0.226,0.171,0.124,15822,112
"3739",155335,2006,1,0,"Newman University",NA,NA,167,96,71,48,18,30,0.312,0.287,0.254,17008,109
"3740",155335,2007,1,0,"Newman University",NA,NA,133,72,61,44,13,31,0.431,0.331,0.213,17688,94
"3741",155335,2008,1,0,"Newman University",NA,NA,115,74,41,36,10,26,0.351,0.313,0.244,18574,84
"3742",155335,2009,1,0,"Newman University",NA,NA,174,106,68,55,16,39,0.368,0.316,0.235,19200,112
"3743",155335,2010,1,0,"Newman University",NA,NA,196,118,78,69,23,46,0.39,0.352,0.295,19872,153
"3744",155399,1991,1,0,"KANSAS STATE UNIVERSITY OF AGRICULTURE AND APP SCI",NA,NA,2670,1322,1348,480,158,322,0.244,0.18,0.117,1699,2467
"3745",155399,1992,1,0,"KANSAS STATE UNIVERSITY OF AGRICULTURE AND APP SCI",NA,NA,2778,1357,1421,484,189,295,0.217,0.174,0.133,1841,2525
"3746",155399,1993,1,0,"KANSAS STATE UNIVERSITY OF AGRICULTURE AND APP SCI",NA,NA,2739,1356,1383,550,203,347,0.256,0.201,0.147,1975,2503
"3747",155399,1995,1,0,"KANSAS STATE UNIVERSITY OF AGRICULTURE AND APP SCI",NA,NA,2877,1380,1497,558,219,339,0.246,0.194,0.146,2199,2626
"3748",155399,1996,1,0,"KANSAS STATE UNIVERSITY OF AGRICULTURE AND APP SCI",NA,NA,2681,1326,1355,583,208,375,0.283,0.217,0.154,2373,2463
"3749",155399,1997,1,0,"KANSAS STATE UNIVERSITY",NA,NA,2906,1382,1524,640,232,408,0.295,0.22,0.152,2467,2650
"3750",155399,1998,1,0,"KANSAS STATE UNIVERSITY",NA,NA,2921,1388,1533,755,295,460,0.331,0.258,0.192,2544,2640
"3751",155399,1999,1,0,"KANSAS STATE UNIVERSITY",NA,NA,3280,1574,1706,723,288,435,0.276,0.22,0.169,2090,2921
"3752",155399,2000,1,0,"KANSAS STATE UNIVERSITY",NA,NA,3399,1711,1688,829,289,540,0.316,0.244,0.171,2267,3035
"3753",155399,2001,1,0,"KANSAS STATE UNIVERSITY",NA,NA,3358,1689,1669,836,274,562,0.333,0.249,0.164,2333,2973
"3754",155399,2002,1,0,"KANSAS STATE UNIVERSITY",NA,NA,3338,1652,1686,828,278,550,0.333,0.248,0.165,2918,2988
"3755",155399,2003,1,0,"KANSAS STATE UNIVERSITY",NA,NA,3098,1529,1569,855,303,552,0.361,0.276,0.193,3510,2794
"3756",155399,2004,1,0,"KANSAS STATE UNIVERSITY",NA,NA,3282,1691,1591,823,270,553,0.327,0.251,0.17,4110,2869
"3757",155399,2005,1,0,"Kansas State University",NA,NA,3105,1561,1544,697,255,442,0.283,0.224,0.165,4560,2721
"3758",155399,2006,1,0,"Kansas State University",NA,NA,3140,1602,1538,832,288,544,0.34,0.265,0.187,4830,2748
"3759",155399,2007,1,0,"Kansas State University",NA,NA,3301,1629,1672,843,290,553,0.34,0.255,0.173,5625,2826
"3760",155399,2008,1,0,"Kansas State University",NA,NA,3518,1780,1738,960,339,621,0.349,0.273,0.195,5954,2850
"3761",155399,2009,1,0,"Kansas State University",NA,NA,3420,1686,1734,972,343,629,0.373,0.284,0.198,6186,2748
"3762",155399,2010,1,0,"Kansas State University",NA,NA,3465,1753,1712,1068,416,652,0.372,0.308,0.243,6672,2884
"3763",155520,1991,1,0,"MID-AMERICA NAZARENE COLLEGE",NA,NA,200,112,88,51,15,36,0.321,0.255,0.17,5250,177
"3764",155520,1992,1,0,"MID-AMERICA NAZARENE COLLEGE",NA,NA,217,107,110,42,16,26,0.243,0.194,0.145,6006,188
"3765",155520,1993,1,0,"MID-AMERICA NAZARENE COLLEGE",NA,NA,212,97,115,36,16,20,0.206,0.17,0.139,6483,184
"3766",155520,1995,1,0,"MIDAMERICA NAZARENE COLLEGE",NA,NA,246,124,122,62,17,45,0.363,0.252,0.139,7440,216
"3767",155520,1996,1,0,"MIDAMERICA NAZARENE COLLEGE",NA,NA,230,129,101,70,21,49,0.38,0.304,0.208,8668,214
"3768",155520,1997,1,0,"MIDAMERICA NAZARENE UNIVERSITY",NA,NA,256,140,116,107,38,69,0.493,0.418,0.328,9498,234
"3769",155520,1998,1,0,"MIDAMERICA NAZARENE UNIVERSITY",NA,NA,254,114,140,64,27,37,0.325,0.252,0.193,10122,229
"3770",155520,1999,1,0,"MIDAMERICA NAZARENE UNIVERSITY",NA,NA,205,111,94,71,28,43,0.387,0.346,0.298,9580,189
"3771",155520,2000,1,0,"MIDAMERICA NAZARENE UNIVERSITY",NA,NA,260,133,127,113,39,74,0.556,0.435,0.307,10150,235
"3772",155520,2001,1,0,"MIDAMERICA NAZARENE UNIVERSITY",NA,NA,248,124,124,74,20,54,0.436,0.298,0.161,10650,230
"3773",155520,2002,1,0,"MIDAMERICA NAZARENE UNIVERSITY",NA,NA,306,156,150,128,46,82,0.526,0.418,0.307,11270,281
"3774",155520,2003,1,0,"MIDAMERICA NAZARENE UNIVERSITY",NA,NA,260,125,135,103,41,62,0.496,0.396,0.304,11910,227
"3775",155520,2004,1,0,"MIDAMERICA NAZARENE UNIVERSITY",NA,NA,249,117,132,84,40,44,0.376,0.337,0.303,12630,212
"3776",155520,2005,1,0,"MidAmerica Nazarene University",NA,NA,216,109,107,61,21,40,0.367,0.282,0.196,13754,177
"3777",155520,2006,1,0,"MidAmerica Nazarene University",NA,NA,239,118,121,82,36,46,0.39,0.343,0.298,14968,218
"3778",155520,2007,1,0,"MidAmerica Nazarene University",NA,NA,217,109,108,89,33,56,0.514,0.41,0.306,16090,186
"3779",155520,2008,1,0,"MidAmerica Nazarene University",NA,NA,208,114,94,69,25,44,0.386,0.332,0.266,17216,177
"3780",155520,2009,1,0,"MidAmerica Nazarene University",NA,NA,198,110,88,83,29,54,0.491,0.419,0.33,18146,159
"3781",155520,2010,1,0,"MidAmerica Nazarene University",NA,NA,232,120,112,100,36,64,0.533,0.431,0.321,19250,185
"3782",155627,1991,1,0,"OTTAWA UNIVERSITY",NA,NA,120,48,72,19,11,8,0.167,0.158,0.153,6450,97
"3783",155627,1992,1,0,"OTTAWA UNIVERSITY",NA,NA,119,43,76,24,9,15,0.349,0.202,0.118,6900,93
"3784",155627,1993,1,0,"OTTAWA UNIVERSITY",NA,NA,130,51,79,39,16,23,0.451,0.3,0.203,7250,110
"3785",155627,1995,1,0,"OTTAWA UNIVERSITY",NA,NA,137,44,93,21,9,12,0.273,0.153,0.097,7960,115
"3786",155627,1996,1,0,"OTTAWA UNIVERSITY",NA,NA,130,48,82,52,23,29,0.604,0.4,0.28,8350,117
"3787",155627,1997,1,0,"OTTAWA UNIVERSITY",NA,NA,149,39,110,39,23,16,0.41,0.262,0.209,8850,113
"3788",155627,1998,1,0,"OTTAWA UNIVERSITY",NA,NA,117,43,74,24,10,14,0.326,0.205,0.135,9560,91
"3789",155627,1999,1,0,"OTTAWA UNIVERSITY",NA,NA,136,50,86,22,10,12,0.24,0.162,0.116,10040,92
"3790",155627,2000,1,0,"OTTAWA UNIVERSITY",NA,NA,111,40,71,30,12,18,0.45,0.27,0.169,10750,84
"3791",155627,2001,1,0,"OTTAWA UNIVERSITY",NA,NA,132,46,86,35,11,24,0.522,0.265,0.128,11550,104
"3792",155627,2002,1,0,"OTTAWA UNIVERSITY",NA,NA,112,35,77,32,15,17,0.486,0.286,0.195,12200,76
"3793",155627,2003,1,0,"OTTAWA UNIVERSITY",NA,NA,114,47,67,28,6,22,0.468,0.246,0.09,12810,86
"3794",155627,2004,1,0,"OTTAWA UNIVERSITY",NA,NA,79,30,49,23,11,12,0.4,0.291,0.224,13850,65
"3795",155627,2005,1,0,"Ottawa University",NA,NA,113,47,66,36,19,17,0.362,0.319,0.288,14500,90
"3796",155627,2006,1,0,"Ottawa University",NA,NA,90,38,52,19,6,13,0.342,0.211,0.115,15500,78
"3797",155627,2007,1,0,"Ottawa University",NA,NA,161,79,82,35,11,24,0.304,0.217,0.134,17000,109
"3798",155627,2008,1,0,"Ottawa University",NA,NA,201,100,101,40,17,23,0.23,0.199,0.168,18070,121
"3799",155627,2009,1,0,"Ottawa University",NA,NA,150,67,83,55,30,25,0.373,0.367,0.361,19100,96
"3800",155627,2010,1,0,"Ottawa University-Ottawa",NA,NA,156,66,90,37,12,25,0.379,0.237,0.133,20000,101
"3801",155937,1991,1,0,"STERLING COLLEGE",NA,NA,131,55,76,42,20,22,0.4,0.321,0.263,6800,108
"3802",155937,1992,1,0,"STERLING COLLEGE",NA,NA,118,52,66,33,9,24,0.462,0.28,0.136,7230,106
"3803",155937,1993,1,0,"STERLING COLLEGE",NA,NA,156,76,80,42,18,24,0.316,0.269,0.225,7890,144
"3804",155937,1995,1,0,"STERLING COLLEGE",NA,NA,120,63,57,42,12,30,0.476,0.35,0.211,8926,98
"3805",155937,1996,1,0,"STERLING COLLEGE",NA,NA,146,72,74,50,18,32,0.444,0.342,0.243,9596,125
"3806",155937,1997,1,0,"STERLING COLLEGE",NA,NA,140,56,84,45,21,24,0.429,0.321,0.25,10076,118
"3807",155937,1998,1,0,"STERLING COLLEGE",NA,NA,161,81,80,52,18,34,0.42,0.323,0.225,10504,141
"3808",155937,1999,1,0,"STERLING COLLEGE",NA,NA,110,63,47,61,20,41,0.651,0.555,0.426,11030,106
"3809",155937,2000,1,0,"STERLING COLLEGE",NA,NA,126,60,66,47,18,29,0.483,0.373,0.273,11582,109
"3810",155937,2001,1,0,"STERLING COLLEGE",NA,NA,105,51,54,39,16,23,0.451,0.371,0.296,12100,86
"3811",155937,2002,1,0,"STERLING COLLEGE",NA,NA,98,50,48,43,14,29,0.58,0.439,0.292,12750,76
"3812",155937,2003,1,0,"STERLING COLLEGE",NA,NA,124,57,67,44,16,28,0.491,0.355,0.239,13150,92
"3813",155937,2004,1,0,"STERLING COLLEGE",NA,NA,136,52,84,36,19,17,0.327,0.265,0.226,13807,110
"3814",155937,2005,1,0,"Sterling College",NA,NA,126,57,69,38,16,22,0.386,0.302,0.232,13806,104
"3815",155937,2006,1,0,"Sterling College",NA,NA,197,79,118,40,10,30,0.38,0.203,0.085,14300,155
"3816",155937,2007,1,0,"Sterling College",NA,NA,165,70,95,50,25,25,0.357,0.303,0.263,15500,118
"3817",155937,2008,1,0,"Sterling College",NA,NA,150,71,79,44,15,29,0.409,0.293,0.19,16500,122
"3818",155937,2009,1,0,"Sterling College",NA,NA,182,82,100,49,24,25,0.305,0.269,0.24,18000,143
"3819",155937,2010,1,0,"Sterling College",NA,NA,149,70,79,50,21,29,0.414,0.336,0.266,19000,120
"3820",156213,1991,1,0,"ASBURY COLLEGE",NA,NA,250,144,106,78,31,47,0.326,0.312,0.292,7350,236
"3821",156213,1992,1,0,"ASBURY COLLEGE",NA,NA,268,165,103,95,38,57,0.346,0.354,0.369,7863,259
"3822",156213,1993,1,0,"ASBURY COLLEGE",NA,NA,268,177,91,109,36,73,0.412,0.407,0.396,8322,251
"3823",156213,1995,1,0,"ASBURY COLLEGE",NA,NA,298,180,118,140,65,75,0.417,0.47,0.551,9819,286
"3824",156213,1996,1,0,"ASBURY COLLEGE",NA,NA,289,184,105,133,50,83,0.451,0.46,0.476,10595,272
"3825",156213,1997,1,0,"ASBURY COLLEGE",NA,NA,365,223,142,179,66,113,0.507,0.49,0.465,11237,343
"3826",156213,1998,1,0,"ASBURY COLLEGE",NA,NA,333,204,129,211,82,129,0.632,0.634,0.636,12020,325
"3827",156213,1999,1,0,"ASBURY COLLEGE",NA,NA,326,198,128,200,76,124,0.626,0.613,0.594,12810,309
"3828",156213,2000,1,0,"ASBURY COLLEGE",NA,NA,304,180,124,166,60,106,0.589,0.546,0.484,13744,294
"3829",156213,2001,1,0,"ASBURY COLLEGE",NA,NA,331,206,125,178,66,112,0.544,0.538,0.528,14624,319
"3830",156213,2002,1,0,"ASBURY COLLEGE",NA,NA,323,200,123,195,80,115,0.575,0.604,0.65,15574,313
"3831",156213,2003,1,0,"ASBURY COLLEGE",NA,NA,258,146,112,148,68,80,0.548,0.574,0.607,16352,249
"3832",156213,2004,1,0,"ASBURY COLLEGE",NA,NA,302,183,119,160,68,92,0.503,0.53,0.571,17660,288
"3833",156213,2005,1,0,"Asbury College",NA,NA,276,173,103,168,64,104,0.601,0.609,0.621,18808,259
"3834",156213,2006,1,0,"Asbury College",NA,NA,276,161,115,178,67,111,0.689,0.645,0.583,19260,263
"3835",156213,2007,1,0,"Asbury College",NA,NA,311,173,138,175,65,110,0.636,0.563,0.471,21132,293
"3836",156213,2008,1,0,"Asbury College",NA,NA,313,208,105,173,57,116,0.558,0.553,0.543,22242,283
"3837",156213,2009,1,0,"Asbury College",NA,NA,315,198,117,168,64,104,0.525,0.533,0.547,22242,291
"3838",156213,2010,1,0,"Asbury University",NA,NA,285,187,98,149,51,98,0.524,0.523,0.52,23132,252
"3839",156286,1991,1,0,"BELLARMINE COLLEGE",NA,NA,267,157,110,122,42,80,0.51,0.457,0.382,7160,250
"3840",156286,1992,1,0,"BELLARMINE COLLEGE",NA,NA,283,155,128,98,40,58,0.374,0.346,0.312,7580,261
"3841",156286,1993,1,0,"BELLARMINE COLLEGE",NA,NA,309,172,137,135,65,70,0.407,0.437,0.474,8072,291
"3842",156286,1995,1,0,"BELLARMINE COLLEGE",NA,NA,329,189,140,151,49,102,0.54,0.459,0.35,9550,312
"3843",156286,1996,1,0,"BELLARMINE COLLEGE",NA,NA,327,203,124,164,57,107,0.527,0.502,0.46,10320,302
"3844",156286,1997,1,0,"BELLARMINE COLLEGE",NA,NA,318,178,140,155,62,93,0.522,0.487,0.443,10970,302
"3845",156286,1998,1,0,"BELLARMINE COLLEGE",NA,NA,362,212,150,165,61,104,0.491,0.456,0.407,11770,337
"3846",156286,1999,1,0,"BELLARMINE COLLEGE",NA,NA,324,223,101,182,54,128,0.574,0.562,0.535,12480,304
"3847",156286,2000,1,0,"BELLARMINE UNIVERSITY",NA,NA,355,224,131,172,63,109,0.487,0.485,0.481,13590,325
"3848",156286,2001,1,0,"BELLARMINE UNIVERSITY",NA,NA,376,255,121,178,47,131,0.514,0.473,0.388,14990,343
"3849",156286,2002,1,0,"BELLARMINE UNIVERSITY",NA,NA,325,214,111,165,46,119,0.556,0.508,0.414,16340,292
"3850",156286,2003,1,0,"BELLARMINE UNIVERSITY",NA,NA,450,289,161,235,79,156,0.54,0.522,0.491,17820,410
"3851",156286,2004,1,0,"BELLARMINE UNIVERSITY",NA,NA,407,271,136,225,58,167,0.616,0.553,0.426,19250,374
"3852",156286,2005,1,0,"Bellarmine University",NA,NA,435,282,153,224,69,155,0.55,0.515,0.451,20800,389
"3853",156286,2006,1,0,"Bellarmine University",NA,NA,429,279,150,206,60,146,0.523,0.48,0.4,23300,372
"3854",156286,2007,1,0,"Bellarmine University",NA,NA,567,351,216,304,97,207,0.59,0.536,0.449,25200,495
"3855",156286,2008,1,0,"Bellarmine University",NA,NA,567,356,211,301,109,192,0.539,0.531,0.517,27000,468
"3856",156286,2009,1,0,"Bellarmine University",NA,NA,600,383,217,303,98,205,0.535,0.505,0.452,27800,524
"3857",156286,2010,1,0,"Bellarmine University",NA,NA,573,362,211,301,107,194,0.536,0.525,0.507,29160,470
"3858",156295,1991,1,0,"BEREA COLLEGE",NA,NA,436,246,190,147,58,89,0.362,0.337,0.305,177,359
"3859",156295,1992,1,0,"BEREA COLLEGE",NA,NA,397,206,191,148,66,82,0.398,0.373,0.346,183,324
"3860",156295,1993,1,0,"BEREA COLLEGE",NA,NA,453,230,223,150,78,72,0.313,0.331,0.35,183,382
"3861",156295,1995,1,0,"BEREA COLLEGE",NA,NA,416,220,196,146,64,82,0.373,0.351,0.327,188,347
"3862",156295,1996,1,0,"BEREA COLLEGE",NA,NA,396,225,171,125,53,72,0.32,0.316,0.31,195,313
"3863",156295,1997,1,0,"BEREA COLLEGE",NA,NA,404,239,165,118,36,82,0.343,0.292,0.218,195,321
"3864",156295,1998,1,0,"BEREA COLLEGE",NA,NA,414,237,177,161,70,91,0.384,0.389,0.395,195,312
"3865",156295,1999,1,0,"BEREA COLLEGE",NA,NA,423,233,190,150,57,93,0.399,0.355,0.3,0,313
"3866",156295,2000,1,0,"BEREA COLLEGE",NA,NA,421,245,176,169,60,109,0.445,0.401,0.341,0,315
"3867",156295,2001,1,0,"BEREA COLLEGE",NA,NA,424,241,183,192,76,116,0.481,0.453,0.415,0,314
"3868",156295,2002,1,0,"BEREA COLLEGE",NA,NA,356,206,150,158,61,97,0.471,0.444,0.407,0,240
"3869",156295,2003,1,0,"BEREA COLLEGE",NA,NA,396,240,156,203,83,120,0.5,0.513,0.532,0,284
"3870",156295,2004,1,0,"BEREA COLLEGE",NA,NA,400,209,191,201,84,117,0.56,0.502,0.44,0,265
"3871",156295,2005,1,0,"Berea College",NA,NA,378,219,159,161,67,94,0.429,0.426,0.421,0,261
"3872",156295,2006,1,0,"Berea College",NA,NA,388,220,168,185,78,107,0.486,0.477,0.464,0,266
"3873",156295,2007,1,0,"Berea College",NA,NA,420,252,168,197,72,125,0.496,0.469,0.429,0,296
"3874",156295,2008,1,0,"Berea College",NA,NA,413,241,172,184,72,112,0.465,0.446,0.419,0,289
"3875",156295,2009,1,0,"Berea College",NA,NA,391,221,170,174,74,100,0.452,0.445,0.435,0,266
"3876",156295,2010,1,0,"Berea College",NA,NA,429,230,199,204,72,132,0.574,0.476,0.362,0,300
"3877",156365,1991,1,0,"CAMPBELLSVILLE COLLEGE",NA,NA,255,122,133,29,6,23,0.189,0.114,0.045,4900,236
"3878",156365,1992,1,0,"CAMPBELLSVILLE COLLEGE",NA,NA,208,85,123,27,9,18,0.212,0.13,0.073,5400,189
"3879",156365,1993,1,0,"CAMPBELLSVILLE COLLEGE",NA,NA,286,122,164,48,19,29,0.238,0.168,0.116,5720,255
"3880",156365,1995,1,0,"CAMPBELLSVILLE UNIVERSITY",NA,NA,322,156,166,84,34,50,0.32,0.261,0.205,6420,301
"3881",156365,1996,1,0,"CAMPBELLSVILLE UNIVERSITY",NA,NA,295,151,144,66,21,45,0.298,0.224,0.146,6800,271
"3882",156365,1997,1,0,"CAMPBELLSVILLE UNIVERSITY",NA,NA,342,182,160,93,32,61,0.335,0.272,0.2,7200,310
"3883",156365,1998,1,0,"CAMPBELLSVILLE UNIVERSITY",NA,NA,359,194,165,82,25,57,0.294,0.228,0.152,7400,311
"3884",156365,1999,1,0,"CAMPBELLSVILLE UNIVERSITY",NA,NA,290,155,135,77,31,46,0.297,0.266,0.23,8000,260
"3885",156365,2000,1,0,"CAMPBELLSVILLE UNIVERSITY",NA,NA,317,167,150,88,25,63,0.377,0.278,0.167,8790,289
"3886",156365,2001,1,0,"CAMPBELLSVILLE UNIVERSITY",NA,NA,330,175,155,58,24,34,0.194,0.176,0.155,9800,306
"3887",156365,2002,1,0,"CAMPBELLSVILLE UNIVERSITY",NA,NA,288,138,150,61,18,43,0.312,0.212,0.12,11160,261
"3888",156365,2003,1,0,"CAMPBELLSVILLE UNIVERSITY",NA,NA,351,162,189,86,37,49,0.302,0.245,0.196,12504,299
"3889",156365,2004,1,0,"CAMPBELLSVILLE UNIVERSITY",NA,NA,381,178,203,102,39,63,0.354,0.268,0.192,13632,335
"3890",156365,2005,1,0,"Campbellsville University",NA,NA,345,174,171,83,29,54,0.31,0.241,0.17,15140,298
"3891",156365,2006,1,0,"Campbellsville University",NA,NA,346,182,164,81,32,49,0.269,0.234,0.195,15960,294
"3892",156365,2007,1,0,"Campbellsville University",NA,NA,377,168,209,98,47,51,0.304,0.26,0.225,16880,295
"3893",156365,2008,1,0,"Campbellsville University",NA,NA,442,192,250,112,56,56,0.292,0.253,0.224,17700,327
"3894",156365,2009,1,0,"Campbellsville University",NA,NA,515,260,255,127,44,83,0.319,0.247,0.173,18410,403
"3895",156365,2010,1,0,"Campbellsville University",NA,NA,502,247,255,122,46,76,0.308,0.243,0.18,19310,374
"3896",156541,1991,1,0,"CUMBERLAND COLLEGE",NA,NA,460,240,220,77,29,48,0.2,0.167,0.132,5296,414
"3897",156541,1992,1,0,"CUMBERLAND COLLEGE",NA,NA,332,185,147,97,36,61,0.33,0.292,0.245,5880,305
"3898",156541,1993,1,0,"CUMBERLAND COLLEGE",NA,NA,397,205,192,80,24,56,0.273,0.202,0.125,6230,372
"3899",156541,1995,1,0,"CUMBERLAND COLLEGE",NA,NA,377,204,173,107,33,74,0.363,0.284,0.191,7130,355
"3900",156541,1996,1,0,"CUMBERLAND COLLEGE",NA,NA,421,210,211,95,40,55,0.262,0.226,0.19,7930,400
"3901",156541,1997,1,0,"CUMBERLAND COLLEGE",NA,NA,418,227,191,87,30,57,0.251,0.208,0.157,8430,391
"3902",156541,1998,1,0,"CUMBERLAND COLLEGE",NA,NA,412,177,235,87,30,57,0.322,0.211,0.128,8980,375
"3903",156541,1999,1,0,"CUMBERLAND COLLEGE",NA,NA,403,201,202,114,41,73,0.363,0.283,0.203,9298,382
"3904",156541,2000,1,0,"CUMBERLAND COLLEGE",NA,NA,403,195,208,82,37,45,0.231,0.203,0.178,9698,376
"3905",156541,2001,1,0,"CUMBERLAND COLLEGE",NA,NA,406,203,203,93,33,60,0.296,0.229,0.163,10000,364
"3906",156541,2002,1,0,"CUMBERLAND COLLEGE",NA,NA,386,209,177,93,31,62,0.297,0.241,0.175,10598,348
"3907",156541,2003,1,0,"CUMBERLAND COLLEGE",NA,NA,401,191,210,98,33,65,0.34,0.244,0.157,11098,354
"3908",156541,2004,1,0,"CUMBERLAND COLLEGE",NA,NA,418,190,228,104,36,68,0.358,0.249,0.158,11498,368
"3909",156541,2005,1,0,"University of the Cumberlands",NA,NA,424,192,232,111,48,63,0.328,0.262,0.207,12298,369
"3910",156541,2006,1,0,"University of the Cumberlands",NA,NA,349,177,172,99,34,65,0.367,0.284,0.198,13298,300
"3911",156541,2007,1,0,"University of the Cumberlands",NA,NA,481,217,264,115,45,70,0.323,0.239,0.17,13298,399
"3912",156541,2008,1,0,"University of the Cumberlands",NA,NA,478,223,255,120,38,82,0.368,0.251,0.149,14298,349
"3913",156541,2009,1,0,"University of the Cumberlands",NA,NA,453,211,242,107,31,76,0.36,0.236,0.128,15298,388
"3914",156541,2010,1,0,"University of the Cumberlands",NA,NA,446,202,244,144,66,78,0.386,0.323,0.27,16664,369
"3915",156745,1991,1,0,"GEORGETOWN COLLEGE",NA,NA,309,161,148,103,38,65,0.404,0.333,0.257,6250,297
"3916",156745,1992,1,0,"GEORGETOWN COLLEGE",NA,NA,325,174,151,109,37,72,0.414,0.335,0.245,6760,318
"3917",156745,1993,1,0,"GEORGETOWN COLLEGE",NA,NA,285,153,132,79,20,59,0.386,0.277,0.152,7300,265
"3918",156745,1995,1,0,"GEORGETOWN COLLEGE",NA,NA,304,201,103,134,30,104,0.517,0.441,0.291,8840,294
"3919",156745,1996,1,0,"GEORGETOWN COLLEGE",NA,NA,326,193,133,131,41,90,0.466,0.402,0.308,9540,317
"3920",156745,1997,1,0,"GEORGETOWN COLLEGE",NA,NA,394,239,155,208,59,149,0.623,0.528,0.381,10190,385
"3921",156745,1998,1,0,"GEORGETOWN COLLEGE",NA,NA,408,224,184,194,61,133,0.594,0.475,0.332,10800,395
"3922",156745,1999,1,0,"GEORGETOWN COLLEGE",NA,NA,340,205,135,158,51,107,0.522,0.465,0.378,11350,333
"3923",156745,2000,1,0,"GEORGETOWN COLLEGE",NA,NA,331,189,142,158,49,109,0.577,0.477,0.345,12140,319
"3924",156745,2001,1,0,"GEORGETOWN COLLEGE",NA,NA,356,203,153,173,69,104,0.512,0.486,0.451,13200,345
"3925",156745,2002,1,0,"GEORGETOWN COLLEGE",NA,NA,328,199,129,150,53,97,0.487,0.457,0.411,14260,312
"3926",156745,2003,1,0,"GEORGETOWN COLLEGE",NA,NA,368,213,155,181,54,127,0.596,0.492,0.348,15690,349
"3927",156745,2004,1,0,"GEORGETOWN COLLEGE",NA,NA,354,192,162,205,73,132,0.688,0.579,0.451,17750,332
"3928",156745,2005,1,0,"Georgetown College",NA,NA,416,216,200,209,83,126,0.583,0.502,0.415,19170,394
"3929",156745,2006,1,0,"Georgetown College",NA,NA,363,226,137,185,53,132,0.584,0.51,0.387,20700,346
"3930",156745,2007,1,0,"Georgetown College",NA,NA,366,206,160,180,59,121,0.587,0.492,0.369,22360,289
"3931",156745,2008,1,0,"Georgetown College",NA,NA,379,209,170,169,61,108,0.517,0.446,0.359,24150,334
"3932",156745,2009,1,0,"Georgetown College",NA,NA,378,211,167,186,63,123,0.583,0.492,0.377,26080,342
"3933",156745,2010,1,0,"Georgetown College",NA,NA,336,191,145,172,57,115,0.602,0.512,0.393,27640,297
"3934",157058,1991,1,0,"KENTUCKY STATE UNIVERSITY",NA,NA,390,215,175,33,9,24,0.112,0.085,0.051,1332,122
"3935",157058,1992,1,0,"KENTUCKY STATE UNIVERSITY",NA,NA,393,226,167,16,4,12,0.053,0.041,0.024,1440,90
"3936",157058,1993,1,0,"KENTUCKY STATE UNIVERSITY",NA,NA,335,163,172,18,7,11,0.068,0.054,0.041,1600,101
"3937",157058,1995,1,0,"KENTUCKY STATE UNIVERSITY",NA,NA,370,189,181,13,10,3,0.016,0.035,0.055,1860,96
"3938",157058,1996,1,0,"KENTUCKY STATE UNIVERSITY",NA,NA,364,163,201,27,7,20,0.123,0.074,0.035,1950,74
"3939",157058,1997,1,0,"KENTUCKY STATE UNIVERSITY",NA,NA,302,172,130,33,5,28,0.163,0.109,0.038,2050,65
"3940",157058,1998,1,0,"KENTUCKY STATE UNIVERSITY",NA,NA,379,215,164,34,9,25,0.116,0.09,0.055,2170,87
"3941",157058,1999,1,0,"KENTUCKY STATE UNIVERSITY",NA,NA,366,186,180,40,8,32,0.172,0.109,0.044,2020,61
"3942",157058,2000,1,0,"KENTUCKY STATE UNIVERSITY",NA,NA,340,171,169,49,17,32,0.187,0.144,0.101,2100,64
"3943",157058,2001,1,0,"KENTUCKY STATE UNIVERSITY",NA,NA,387,199,188,31,4,27,0.136,0.08,0.021,2100,57
"3944",157058,2002,1,0,"KENTUCKY STATE UNIVERSITY",NA,NA,373,203,170,34,6,28,0.138,0.091,0.035,2630,50
"3945",157058,2003,1,0,"KENTUCKY STATE UNIVERSITY",NA,NA,309,162,147,23,9,14,0.086,0.074,0.061,2828,62
"3946",157058,2004,1,0,"KENTUCKY STATE UNIVERSITY",NA,NA,346,196,150,37,8,29,0.148,0.107,0.053,3110,66
"3947",157058,2005,1,0,"Kentucky State University",NA,NA,408,223,185,17,4,13,0.058,0.042,0.022,3550,60
"3948",157058,2006,1,0,"Kentucky State University",NA,NA,569,277,292,21,6,15,0.054,0.037,0.021,3900,64
"3949",157058,2007,1,0,"Kentucky State University",NA,NA,602,343,259,39,5,34,0.099,0.065,0.019,4270,62
"3950",157058,2008,1,0,"Kentucky State University",NA,NA,566,293,273,32,7,25,0.085,0.057,0.026,4942,58
"3951",157058,2009,1,0,"Kentucky State University",NA,NA,476,265,211,24,7,17,0.064,0.05,0.033,5086,53
"3952",157058,2010,1,0,"Kentucky State University",NA,NA,569,316,253,25,8,17,0.054,0.044,0.032,4920,47
"3953",157076,1991,1,0,"KENTUCKY WESLEYAN COLLEGE",NA,NA,204,75,129,48,24,24,0.32,0.235,0.186,6690,180
"3954",157076,1992,1,0,"KENTUCKY WESLEYAN COLLEGE",NA,NA,147,71,76,41,13,28,0.394,0.279,0.171,7170,138
"3955",157076,1993,1,0,"KENTUCKY WESLEYAN COLLEGE",NA,NA,173,79,94,41,17,24,0.304,0.237,0.181,7600,161
"3956",157076,1995,1,0,"KENTUCKY WESLEYAN COLLEGE",NA,NA,151,79,72,49,17,32,0.405,0.325,0.236,9100,147
"3957",157076,1996,1,0,"KENTUCKY WESLEYAN COLLEGE",NA,NA,179,103,76,44,22,22,0.214,0.246,0.289,9100,169
"3958",157076,1997,1,0,"KENTUCKY WESLEYAN COLLEGE",NA,NA,203,131,72,84,27,57,0.435,0.414,0.375,9220,191
"3959",157076,1998,1,0,"KENTUCKY WESLEYAN COLLEGE",NA,NA,152,95,57,53,18,35,0.368,0.349,0.316,9730,140
"3960",157076,1999,1,0,"KENTUCKY WESLEYAN COLLEGE",NA,NA,191,102,89,51,18,33,0.324,0.267,0.202,9770,183
"3961",157076,2000,1,0,"KENTUCKY WESLEYAN COLLEGE",NA,NA,159,75,84,37,12,25,0.333,0.233,0.143,10070,150
"3962",157076,2001,1,0,"KENTUCKY WESLEYAN COLLEGE",NA,NA,164,60,104,24,8,16,0.267,0.146,0.077,10570,145
"3963",157076,2002,1,0,"KENTUCKY WESLEYAN COLLEGE",NA,NA,150,77,73,44,13,31,0.403,0.293,0.178,11100,123
"3964",157076,2003,1,0,"KENTUCKY WESLEYAN COLLEGE",NA,NA,165,91,74,58,19,39,0.429,0.352,0.257,11700,145
"3965",157076,2004,1,0,"KENTUCKY WESLEYAN COLLEGE",NA,NA,210,93,117,64,25,39,0.419,0.305,0.214,12160,164
"3966",157076,2005,1,0,"Kentucky Wesleyan College",NA,NA,209,100,109,67,22,45,0.45,0.321,0.202,12590,160
"3967",157076,2006,1,0,"Kentucky Wesleyan College",NA,NA,326,127,199,82,41,41,0.323,0.252,0.206,13200,256
"3968",157076,2007,1,0,"Kentucky Wesleyan College",NA,NA,280,120,160,69,27,42,0.35,0.246,0.169,14100,221
"3969",157076,2008,1,0,"Kentucky Wesleyan College",NA,NA,219,103,116,81,44,37,0.359,0.37,0.379,15500,171
"3970",157076,2009,1,0,"Kentucky Wesleyan College",NA,NA,227,118,109,79,30,49,0.415,0.348,0.275,16870,156
"3971",157076,2010,1,0,"Kentucky Wesleyan College",NA,NA,202,96,106,64,26,38,0.396,0.317,0.245,17980,148
"3972",157085,1991,1,0,"UNIVERSITY OF KENTUCKY",NA,NA,2817,1434,1383,389,138,251,0.175,0.138,0.1,1844,2500
"3973",157085,1992,1,0,"UNIVERSITY OF KENTUCKY",NA,NA,2562,1374,1188,528,195,333,0.242,0.206,0.164,1998,2280
"3974",157085,1993,1,0,"UNIVERSITY OF KENTUCKY",NA,NA,2662,1391,1271,599,210,389,0.28,0.225,0.165,2278,2341
"3975",157085,1995,1,0,"UNIVERSITY OF KENTUCKY",NA,NA,2612,1383,1229,620,235,385,0.278,0.237,0.191,2594,2306
"3976",157085,1996,1,0,"UNIVERSITY OF KENTUCKY",NA,NA,2640,1459,1181,720,253,467,0.32,0.273,0.214,2676,2329
"3977",157085,1997,1,0,"UNIVERSITY OF KENTUCKY",NA,NA,2740,1499,1241,743,281,462,0.308,0.271,0.226,2736,2408
"3978",157085,1998,1,0,"UNIVERSITY OF KENTUCKY",NA,NA,2931,1548,1383,815,331,484,0.313,0.278,0.239,3016,2595
"3979",157085,1999,1,0,"UNIVERSITY OF KENTUCKY",NA,NA,2742,1499,1243,792,293,499,0.333,0.289,0.236,2960,2468
"3980",157085,2000,1,0,"UNIVERSITY OF KENTUCKY",NA,NA,2971,1590,1381,884,333,551,0.346,0.298,0.241,3110,2640
"3981",157085,2001,1,0,"UNIVERSITY OF KENTUCKY",NA,NA,3129,1679,1450,942,374,568,0.338,0.301,0.258,3270,2852
"3982",157085,2002,1,0,"UNIVERSITY OF KENTUCKY",NA,NA,3701,1999,1702,1045,362,683,0.342,0.282,0.213,3480,3347
"3983",157085,2003,1,0,"UNIVERSITY OF KENTUCKY",NA,NA,3678,1951,1727,1160,460,700,0.359,0.315,0.266,4002,3289
"3984",157085,2004,1,0,"UNIVERSITY OF KENTUCKY",NA,NA,3935,2097,1838,1276,486,790,0.377,0.324,0.264,4602,3464
"3985",157085,2005,1,0,"University of Kentucky",NA,NA,3824,2045,1779,1291,502,789,0.386,0.338,0.282,5162,3437
"3986",157085,2006,1,0,"University of Kentucky",NA,NA,4113,2201,1912,1253,443,810,0.368,0.305,0.232,5782,3517
"3987",157085,2007,1,0,"University of Kentucky",NA,NA,3826,2006,1820,1276,498,778,0.388,0.334,0.274,6302,3271
"3988",157085,2008,1,0,"University of Kentucky",NA,NA,4074,2086,1988,1323,513,810,0.388,0.325,0.258,6870,3391
"3989",157085,2009,1,0,"University of Kentucky",NA,NA,4105,2102,2003,1438,551,887,0.422,0.35,0.275,7214,3368
"3990",157085,2010,1,0,"University of Kentucky",NA,NA,4270,2203,2067,1625,615,1010,0.458,0.381,0.298,7656,3376
"3991",157289,1991,1,0,"UNIVERSITY OF LOUISVILLE",NA,NA,2050,1007,1043,105,28,77,0.076,0.051,0.027,1740,1701
"3992",157289,1992,1,0,"UNIVERSITY OF LOUISVILLE",NA,NA,1745,843,902,133,45,88,0.104,0.076,0.05,1880,1404
"3993",157289,1993,1,0,"UNIVERSITY OF LOUISVILLE",NA,NA,1743,858,885,157,57,100,0.117,0.09,0.064,2170,1384
"3994",157289,1995,1,0,"UNIVERSITY OF LOUISVILLE",NA,NA,1835,903,932,193,69,124,0.137,0.105,0.074,2470,1451
"3995",157289,1996,1,0,"UNIVERSITY OF LOUISVILLE",NA,NA,1861,950,911,197,69,128,0.135,0.106,0.076,2570,1463
"3996",157289,1997,1,0,"UNIVERSITY OF LOUISVILLE",NA,NA,1931,1024,907,241,86,155,0.151,0.125,0.095,2630,1528
"3997",157289,1998,1,0,"UNIVERSITY OF LOUISVILLE",NA,NA,2032,1011,1021,222,81,141,0.139,0.109,0.079,2920,1662
"3998",157289,1999,1,0,"UNIVERSITY OF LOUISVILLE",NA,NA,2297,1232,1065,289,90,199,0.161,0.126,0.085,2960,1838
"3999",157289,2000,1,0,"UNIVERSITY OF LOUISVILLE",NA,NA,2249,1162,1087,321,113,208,0.179,0.143,0.104,3149,1802
"4000",157289,2001,1,0,"UNIVERSITY OF LOUISVILLE",NA,NA,2209,1150,1059,351,137,214,0.186,0.159,0.129,3794,1786
"4001",157289,2002,1,0,"UNIVERSITY OF LOUISVILLE",NA,NA,2209,1153,1056,428,157,271,0.235,0.194,0.149,4082,1773
"4002",157289,2003,1,0,"UNIVERSITY OF LOUISVILLE",NA,NA,2197,1118,1079,468,173,295,0.264,0.213,0.16,4450,1789
"4003",157289,2004,1,0,"UNIVERSITY OF LOUISVILLE",NA,NA,2303,1197,1106,489,164,325,0.272,0.212,0.148,5040,1867
"4004",157289,2005,1,0,"University of Louisville",NA,NA,2255,1144,1111,497,205,292,0.255,0.22,0.185,5532,1799
"4005",157289,2006,1,0,"University of Louisville",NA,NA,2380,1230,1150,628,257,371,0.302,0.264,0.223,6252,1916
"4006",157289,2007,1,0,"University of Louisville",NA,NA,2525,1314,1211,634,262,372,0.283,0.251,0.216,6940,2033
"4007",157289,2008,1,0,"University of Louisville",NA,NA,2548,1344,1204,915,391,524,0.39,0.359,0.325,7564,2076
"4008",157289,2009,1,0,"University of Louisville",NA,NA,2441,1273,1168,622,270,352,0.276,0.255,0.231,7944,1943
"4009",157289,2010,1,0,"University of Louisville",NA,NA,2507,1266,1241,696,308,388,0.306,0.278,0.248,8424,1955
"4010",157386,1991,1,0,"MOREHEAD STATE UNIVERSITY",NA,NA,1261,674,587,99,32,67,0.099,0.079,0.055,1510,1197
"4011",157386,1992,1,0,"MOREHEAD STATE UNIVERSITY",NA,NA,1349,769,580,133,39,94,0.122,0.099,0.067,1630,1260
"4012",157386,1993,1,0,"MOREHEAD STATE UNIVERSITY",NA,NA,1266,706,560,143,41,102,0.144,0.113,0.073,1800,1201
"4013",157386,1995,1,0,"MOREHEAD STATE UNIVERSITY",NA,NA,1119,646,473,104,7,97,0.15,0.093,0.015,2000,1069
"4014",157386,1996,1,0,"MOREHEAD STATE UNIVERSITY",NA,NA,1271,687,584,157,55,102,0.148,0.124,0.094,2090,1176
"4015",157386,1997,1,0,"MOREHEAD STATE UNIVERSITY",NA,NA,1227,674,553,160,55,105,0.156,0.13,0.099,2150,1134
"4016",157386,1998,1,0,"MOREHEAD STATE UNIVERSITY",NA,NA,1369,739,630,157,48,109,0.148,0.115,0.076,2270,1255
"4017",157386,1999,1,0,"MOREHEAD STATE UNIVERSITY",NA,NA,1325,756,569,156,55,101,0.134,0.118,0.097,2020,1242
"4018",157386,2000,1,0,"MOREHEAD STATE UNIVERSITY",NA,NA,1473,849,624,181,59,122,0.144,0.123,0.095,2510,1397
"4019",157386,2001,1,0,"MOREHEAD STATE UNIVERSITY",NA,NA,1588,894,694,185,66,119,0.133,0.116,0.095,2710,1482
"4020",157386,2002,1,0,"MOREHEAD STATE UNIVERSITY",NA,NA,1563,882,681,172,59,113,0.128,0.11,0.087,2926,1461
"4021",157386,2003,1,0,"MOREHEAD STATE UNIVERSITY",NA,NA,1555,867,688,185,60,125,0.144,0.119,0.087,3364,1462
"4022",157386,2004,1,0,"MOREHEAD STATE UNIVERSITY",NA,NA,1307,737,570,125,39,86,0.117,0.096,0.068,3840,1223
"4023",157386,2005,1,0,"Morehead State University",NA,NA,1310,745,565,162,55,107,0.144,0.124,0.097,4320,1205
"4024",157386,2006,1,0,"Morehead State University",NA,NA,1330,741,589,201,65,136,0.184,0.151,0.11,4870,1236
"4025",157386,2007,1,0,"Morehead State University",NA,NA,1445,803,642,257,87,170,0.212,0.178,0.136,5280,1347
"4026",157386,2008,1,0,"Morehead State University",NA,NA,1313,777,536,235,78,157,0.202,0.179,0.146,5400,1210
"4027",157386,2009,1,0,"Morehead State University",NA,NA,1240,708,532,231,74,157,0.222,0.186,0.139,6036,1143
"4028",157386,2010,1,0,"Morehead State University",NA,NA,1175,662,513,294,118,176,0.266,0.25,0.23,6492,1072
"4029",157401,1991,1,0,"MURRAY STATE UNIVERSITY",NA,NA,1147,633,514,120,34,86,0.136,0.105,0.066,1410,1056
"4030",157401,1992,1,0,"MURRAY STATE UNIVERSITY",NA,NA,982,538,444,223,76,147,0.273,0.227,0.171,1600,911
"4031",157401,1993,1,0,"MURRAY STATE UNIVERSITY",NA,NA,946,510,436,228,77,151,0.296,0.241,0.177,1780,861
"4032",157401,1995,1,0,"MURRAY STATE UNIVERSITY",NA,NA,1201,661,540,262,82,180,0.272,0.218,0.152,1960,1095
"4033",157401,1996,1,0,"MURRAY STATE UNIVERSITY",NA,NA,1366,749,617,339,105,234,0.312,0.248,0.17,2060,1242
"4034",157401,1997,1,0,"MURRAY STATE UNIVERSITY",NA,NA,1206,691,515,184,51,133,0.192,0.153,0.099,2120,1087
"4035",157401,1998,1,0,"MURRAY STATE UNIVERSITY",NA,NA,1275,707,568,341,122,219,0.31,0.267,0.215,2300,1133
"4036",157401,1999,1,0,"MURRAY STATE UNIVERSITY",NA,NA,1177,666,511,345,114,231,0.347,0.293,0.223,2020,1051
"4037",157401,2000,1,0,"MURRAY STATE UNIVERSITY",NA,NA,1210,730,480,348,108,240,0.329,0.288,0.225,2172,1070
"4038",157401,2001,1,0,"MURRAY STATE UNIVERSITY",NA,NA,1409,827,582,423,135,288,0.348,0.3,0.232,2334,1282
"4039",157401,2002,1,0,"MURRAY STATE UNIVERSITY",NA,NA,1467,879,588,439,130,309,0.352,0.299,0.221,2540,1322
"4040",157401,2003,1,0,"MURRAY STATE UNIVERSITY",NA,NA,1500,876,624,477,160,317,0.362,0.318,0.256,2944,1321
"4041",157401,2004,1,0,"MURRAY STATE UNIVERSITY",NA,NA,1414,804,610,531,176,355,0.442,0.376,0.289,3420,1282
"4042",157401,2005,1,0,"Murray State University",NA,NA,1442,841,601,532,180,352,0.419,0.369,0.3,3792,1310
"4043",157401,2006,1,0,"Murray State University",NA,NA,1390,822,568,391,123,268,0.326,0.281,0.217,4284,1222
"4044",157401,2007,1,0,"Murray State University",NA,NA,1393,835,558,397,128,269,0.322,0.285,0.229,4650,1222
"4045",157401,2008,1,0,"Murray State University",NA,NA,1452,875,577,415,120,295,0.337,0.286,0.208,4932,1232
"4046",157401,2009,1,0,"Murray State University",NA,NA,1374,837,537,330,101,229,0.274,0.24,0.188,5130,1127
"4047",157401,2010,1,0,"Murray State University",NA,NA,1363,830,533,344,104,240,0.289,0.252,0.195,5388,1152
"4048",157447,1991,1,0,"NORTHERN KENTUCKY UNIVERSITY",NA,NA,1282,698,584,42,14,28,0.04,0.033,0.024,1410,1221
"4049",157447,1992,1,0,"NORTHERN KENTUCKY UNIVERSITY",NA,NA,1359,714,645,49,12,37,0.052,0.036,0.019,1560,1299
"4050",157447,1993,1,0,"NORTHERN KENTUCKY UNIVERSITY",NA,NA,1517,890,627,55,11,44,0.049,0.036,0.018,1720,1450
"4051",157447,1995,1,0,"NORTHERN KENTUCKY UNIVERSITY",NA,NA,1545,873,672,79,22,57,0.065,0.051,0.033,1960,1471
"4052",157447,1996,1,0,"NORTHERN KENTUCKY UNIVERSITY",NA,NA,1487,823,664,71,16,55,0.067,0.048,0.024,2020,1407
"4053",157447,1997,1,0,"NORTHERN KENTUCKY UNIVERSITY",NA,NA,1657,949,708,84,21,63,0.066,0.051,0.03,2120,1569
"4054",157447,1998,1,0,"NORTHERN KENTUCKY UNIVERSITY",NA,NA,1627,956,671,118,32,86,0.09,0.073,0.048,2248,1525
"4055",157447,1999,1,0,"NORTHERN KENTUCKY UNIVERSITY",NA,NA,1696,969,727,35,13,22,0.023,0.021,0.018,2100,1578
"4056",157447,2000,1,0,"NORTHERN KENTUCKY UNIVERSITY",NA,NA,1682,974,708,114,37,77,0.079,0.068,0.052,2328,1551
"4057",157447,2001,1,0,"NORTHERN KENTUCKY UNIVERSITY",NA,NA,1787,1008,779,149,52,97,0.096,0.083,0.067,2460,1635
"4058",157447,2002,1,0,"NORTHERN KENTUCKY UNIVERSITY",NA,NA,1907,1084,823,185,66,119,0.11,0.097,0.08,3216,1713
"4059",157447,2003,1,0,"NORTHERN KENTUCKY UNIVERSITY",NA,NA,1962,1108,854,155,35,120,0.108,0.079,0.041,3744,1785
"4060",157447,2004,1,0,"NORTHERN KENTUCKY UNIVERSITY",NA,NA,1915,1123,792,151,43,108,0.096,0.079,0.054,4368,1739
"4061",157447,2005,1,0,"Northern Kentucky University",NA,NA,1759,1000,759,185,50,135,0.135,0.105,0.066,4968,1588
"4062",157447,2006,1,0,"Northern Kentucky University",NA,NA,1908,1069,839,230,83,147,0.138,0.121,0.099,5448,1668
"4063",157447,2007,1,0,"Northern Kentucky University",NA,NA,1896,1068,828,253,84,169,0.158,0.133,0.101,5952,1623
"4064",157447,2008,1,0,"Northern Kentucky University",NA,NA,2001,1117,884,252,77,175,0.157,0.126,0.087,6528,1684
"4065",157447,2009,1,0,"Northern Kentucky University",NA,NA,2187,1219,968,340,121,219,0.18,0.155,0.125,6792,1837
"4066",157447,2010,1,0,"Northern Kentucky University",NA,NA,2230,1238,992,321,116,205,0.166,0.144,0.117,7128,1785
"4067",157535,1991,1,0,"PIKEVILLE COLLEGE",NA,NA,181,134,47,25,6,19,0.142,0.138,0.128,4200,177
"4068",157535,1992,1,0,"PIKEVILLE COLLEGE",NA,NA,198,139,59,17,8,9,0.065,0.086,0.136,4900,197
"4069",157535,1993,1,0,"PIKEVILLE COLLEGE",NA,NA,167,117,50,20,7,13,0.111,0.12,0.14,5500,163
"4070",157535,1995,1,0,"PIKEVILLE COLLEGE",NA,NA,227,154,73,34,8,26,0.169,0.15,0.11,6000,220
"4071",157535,1996,1,0,"PIKEVILLE COLLEGE",NA,NA,211,144,67,34,11,23,0.16,0.161,0.164,6500,211
"4072",157535,1997,1,0,"PIKEVILLE COLLEGE",NA,NA,178,110,68,25,8,17,0.154,0.14,0.118,6500,178
"4073",157535,1998,1,0,"PIKEVILLE COLLEGE",NA,NA,169,110,59,30,12,18,0.164,0.178,0.203,7500,169
"4074",157535,1999,1,0,"PIKEVILLE COLLEGE",NA,NA,206,140,66,41,10,31,0.221,0.199,0.152,7500,203
"4075",157535,2000,1,0,"PIKEVILLE COLLEGE",NA,NA,282,137,145,45,7,38,0.277,0.16,0.048,7800,232
"4076",157535,2001,1,0,"PIKEVILLE COLLEGE",NA,NA,258,142,116,41,11,30,0.211,0.159,0.095,8200,218
"4077",157535,2002,1,0,"PIKEVILLE COLLEGE",NA,NA,226,129,97,40,9,31,0.24,0.177,0.093,9000,206
"4078",157535,2003,1,0,"PIKEVILLE COLLEGE",NA,NA,147,67,80,27,10,17,0.254,0.184,0.125,9900,133
"4079",157535,2004,1,0,"PIKEVILLE COLLEGE",NA,NA,175,103,72,31,8,23,0.223,0.177,0.111,10500,167
"4080",157535,2005,1,0,"Pikeville College",NA,NA,206,98,108,31,8,23,0.235,0.15,0.074,11500,190
"4081",157535,2006,1,0,"Pikeville College",NA,NA,220,105,115,26,4,22,0.21,0.118,0.035,12750,180
"4082",157535,2007,1,0,"Pikeville College",NA,NA,233,103,130,35,15,20,0.194,0.15,0.115,13750,200
"4083",157535,2008,1,0,"Pikeville College",NA,NA,177,83,94,41,13,28,0.337,0.232,0.138,14250,156
"4084",157535,2009,1,0,"Pikeville College",NA,NA,185,62,123,38,20,18,0.29,0.205,0.163,14535,148
"4085",157535,2010,1,0,"Pikeville College",NA,NA,393,154,239,56,22,34,0.221,0.142,0.092,15250,335
"4086",157951,1991,1,0,"WESTERN KENTUCKY UNIVERSITY",NA,NA,2263,1267,996,259,77,182,0.144,0.114,0.077,1440,2044
"4087",157951,1992,1,0,"WESTERN KENTUCKY UNIVERSITY",NA,NA,2192,1261,931,271,80,191,0.152,0.124,0.086,1544,2005
"4088",157951,1993,1,0,"WESTERN KENTUCKY UNIVERSITY",NA,NA,2201,1222,979,238,80,158,0.129,0.108,0.082,1704,1990
"4089",157951,1995,1,0,"WESTERN KENTUCKY UNIVERSITY",NA,NA,2454,1364,1090,496,159,337,0.247,0.202,0.146,1910,2182
"4090",157951,1996,1,0,"WESTERN KENTUCKY UNIVERSITY",NA,NA,2257,1234,1023,471,164,307,0.249,0.209,0.16,1970,1999
"4091",157951,1997,1,0,"WESTERN KENTUCKY UNIVERSITY",NA,NA,2205,1244,961,445,148,297,0.239,0.202,0.154,2140,1955
"4092",157951,1998,1,0,"WESTERN KENTUCKY UNIVERSITY",NA,NA,2353,1347,1006,542,190,352,0.261,0.23,0.189,2260,2058
"4093",157951,1999,1,0,"WESTERN KENTUCKY UNIVERSITY",NA,NA,2480,1447,1033,568,204,364,0.252,0.229,0.197,2020,2201
"4094",157951,2000,1,0,"WESTERN KENTUCKY UNIVERSITY",NA,NA,2477,1444,1033,634,202,432,0.299,0.256,0.196,2150,2145
"4095",157951,2001,1,0,"WESTERN KENTUCKY UNIVERSITY",NA,NA,2640,1563,1077,651,192,459,0.294,0.247,0.178,2290,2281
"4096",157951,2002,1,0,"WESTERN KENTUCKY UNIVERSITY",NA,NA,2954,1714,1240,513,136,377,0.22,0.174,0.11,3120,2533
"4097",157951,2003,1,0,"WESTERN KENTUCKY UNIVERSITY",NA,NA,3034,1782,1252,541,169,372,0.209,0.178,0.135,3232,2620
"4098",157951,2004,1,0,"WESTERN KENTUCKY UNIVERSITY",NA,NA,2918,1647,1271,456,155,301,0.183,0.156,0.122,4596,2441
"4099",157951,2005,1,0,"Western Kentucky University",NA,NA,3002,1680,1322,539,189,350,0.208,0.18,0.143,5316,2549
"4100",157951,2006,1,0,"Western Kentucky University",NA,NA,3118,1768,1350,649,217,432,0.244,0.208,0.161,5952,2529
"4101",157951,2007,1,0,"Western Kentucky University",NA,NA,3013,1716,1297,610,197,413,0.241,0.202,0.152,6416,2470
"4102",157951,2008,1,0,"Western Kentucky University",NA,NA,3203,1821,1382,684,247,437,0.24,0.214,0.179,6930,2545
"4103",157951,2009,1,0,"Western Kentucky University",NA,NA,3288,1783,1505,700,249,451,0.253,0.213,0.165,7200,2605
"4104",157951,2010,1,0,"Western Kentucky University",NA,NA,3279,1865,1414,747,228,519,0.278,0.228,0.161,7560,2610
"4105",158477,1991,1,0,"CENTENARY COLLEGE OF LOUISIANA",NA,NA,207,124,83,87,29,58,0.468,0.42,0.349,7220,175
"4106",158477,1992,1,0,"CENTENARY COLLEGE OF LOUISIANA",NA,NA,249,146,103,84,38,46,0.315,0.337,0.369,7550,214
"4107",158477,1993,1,0,"CENTENARY COLLEGE OF LOUISIANA",NA,NA,211,121,90,80,33,47,0.388,0.379,0.367,8406,185
"4108",158477,1995,1,0,"CENTENARY COLLEGE OF LOUISIANA",NA,NA,213,134,79,91,26,65,0.485,0.427,0.329,10122,188
"4109",158477,1996,1,0,"CENTENARY COLLEGE OF LOUISIANA",NA,NA,190,103,87,74,29,45,0.437,0.389,0.333,10400,175
"4110",158477,1997,1,0,"CENTENARY COLLEGE OF LOUISIANA",NA,NA,226,116,110,88,28,60,0.517,0.389,0.255,11050,190
"4111",158477,1998,1,0,"CENTENARY COLLEGE OF LOUISIANA",NA,NA,294,180,114,126,34,92,0.511,0.429,0.298,12100,257
"4112",158477,1999,1,0,"CENTENARY COLLEGE OF LOUISIANA",NA,NA,270,162,108,112,34,78,0.482,0.415,0.315,13200,230
"4113",158477,2000,1,0,"CENTENARY COLLEGE OF LOUISIANA",NA,NA,229,152,77,99,33,66,0.434,0.432,0.429,14200,198
"4114",158477,2001,1,0,"CENTENARY COLLEGE OF LOUISIANA",NA,NA,256,168,88,116,31,85,0.506,0.453,0.352,15400,224
"4115",158477,2002,1,0,"CENTENARY COLLEGE OF LOUISIANA",NA,NA,272,163,109,122,42,80,0.491,0.449,0.385,16000,227
"4116",158477,2003,1,0,"CENTENARY COLLEGE OF LOUISIANA",NA,NA,197,113,84,101,34,67,0.593,0.513,0.405,16750,155
"4117",158477,2004,1,0,"CENTENARY COLLEGE OF LOUISIANA",NA,NA,282,190,92,145,42,103,0.542,0.514,0.457,16750,245
"4118",158477,2005,1,0,"Centenary College of Louisiana",NA,NA,232,145,87,104,33,71,0.49,0.448,0.379,17750,198
"4119",158477,2006,1,0,"Centenary College of Louisiana",NA,NA,241,136,105,104,45,59,0.434,0.432,0.429,18900,196
"4120",158477,2007,1,0,"Centenary College of Louisiana",NA,NA,200,114,86,97,35,62,0.544,0.485,0.407,19850,160
"4121",158477,2008,1,0,"Centenary College of Louisiana",NA,NA,246,148,98,104,41,63,0.426,0.423,0.418,20940,202
"4122",158477,2009,1,0,"Centenary College of Louisiana",NA,NA,278,162,116,128,49,79,0.488,0.46,0.422,21790,205
"4123",158477,2010,1,0,"Centenary College of Louisiana",NA,NA,192,104,88,81,29,52,0.5,0.422,0.33,22880,131
"4124",159009,1991,1,0,"GRAMBLING STATE UNIVERSITY",NA,NA,1325,741,584,121,30,91,0.123,0.091,0.051,1802,6
"4125",159009,1992,1,0,"GRAMBLING STATE UNIVERSITY",NA,NA,1385,775,610,109,30,79,0.102,0.079,0.049,1788,13
"4126",159009,1993,1,0,"GRAMBLING STATE UNIVERSITY",NA,NA,1620,859,761,160,34,126,0.147,0.099,0.045,2088,2
"4127",159009,1995,1,0,"GRAMBLING STATE UNIVERSITY",NA,NA,1121,569,552,107,23,84,0.148,0.095,0.042,2088,2
"4128",159009,1996,1,0,"GRAMBLING STATE UNIVERSITY",NA,NA,1091,574,517,90,27,63,0.11,0.082,0.052,2112,4
"4129",159009,1997,1,0,"GRAMBLING STATE UNIVERSITY",NA,NA,799,408,391,52,25,27,0.066,0.065,0.064,2022,0
"4130",159009,1998,1,0,"GRAMBLING STATE UNIVERSITY",NA,NA,771,359,412,71,23,48,0.134,0.092,0.056,2208,1
"4131",159009,1999,1,0,"GRAMBLING STATE UNIVERSITY",NA,NA,690,367,323,88,24,64,0.174,0.128,0.074,2301,3
"4132",159009,2000,1,0,"GRAMBLING STATE UNIVERSITY",NA,NA,908,513,395,182,46,136,0.265,0.2,0.116,2589,9
"4133",159009,2001,1,0,"GRAMBLING STATE UNIVERSITY",NA,NA,884,479,405,94,23,71,0.148,0.106,0.057,1900,3
"4134",159009,2002,1,0,"GRAMBLING STATE UNIVERSITY",NA,NA,850,430,420,107,44,63,0.147,0.126,0.105,1980,2
"4135",159009,2003,1,0,"GRAMBLING STATE UNIVERSITY",NA,NA,1022,570,452,124,29,95,0.167,0.121,0.064,2352,12
"4136",159009,2004,1,0,"GRAMBLING STATE UNIVERSITY",NA,NA,1132,675,457,115,33,82,0.122,0.102,0.072,2280,10
"4137",159009,2005,1,0,"Grambling State University",NA,NA,1129,568,561,82,22,60,0.106,0.073,0.039,2232,7
"4138",159009,2006,1,0,"Grambling State University",NA,NA,1119,609,510,108,33,75,0.123,0.097,0.065,2232,4
"4139",159009,2007,1,0,"Grambling State University",NA,NA,1184,610,574,83,24,59,0.097,0.07,0.042,2232,8
"4140",159009,2008,1,0,"Grambling State University",NA,NA,1203,626,577,144,53,91,0.145,0.12,0.092,2414,7
"4141",159009,2009,1,0,"Grambling State University",NA,NA,910,548,362,177,65,112,0.204,0.195,0.18,2606,6
"4142",159009,2010,1,0,"Grambling State University",NA,NA,706,384,322,183,63,120,0.312,0.259,0.196,3018,5
"4143",159391,1991,1,0,"LOUISIANA ST UNIV & AGRL & MECH & HEBERT LAWS CTR",NA,NA,3342,1779,1563,579,201,378,0.212,0.173,0.129,2058,2744
"4144",159391,1992,1,0,"LOUISIANA ST UNIV & AGRL & MECH & HEBERT LAWS CTR",NA,NA,3503,1884,1619,651,219,432,0.229,0.186,0.135,2173,2880
"4145",159391,1993,1,0,"LOUISIANA ST UNIV & AGRL & MECH & HEBERT LAWS CTR",NA,NA,3178,1697,1481,586,182,404,0.238,0.184,0.123,2625,2549
"4146",159391,1995,1,0,"LOUISIANA ST UNIV & AGRL & MECH & HEBERT LAWS CTR",NA,NA,3646,2007,1639,746,257,489,0.244,0.205,0.157,2663,2969
"4147",159391,1996,1,0,"LOUISIANA ST UNIV & AGRL & MECH & HEBERT LAWS CTR",NA,NA,3992,2169,1823,867,264,603,0.278,0.217,0.145,2687,3184
"4148",159391,1997,1,0,"LOUISIANA STATE UNIV & AG & MECH & HEBERT LAWS CTR",NA,NA,4443,2533,1910,959,319,640,0.253,0.216,0.167,2711,3504
"4149",159391,1998,1,0,"LOUISIANA STATE UNIV & AG & MECH & HEBERT LAW CTR",NA,NA,5066,2874,2192,1198,399,799,0.278,0.236,0.182,2871,4076
"4150",159391,1999,1,0,"LOUISIANA STATE UNIV & AG & MECH & HEBERT LAWS CTR",NA,NA,5173,2956,2217,1262,398,864,0.292,0.244,0.18,2301,4159
"4151",159391,2000,1,0,"LOUISIANA STATE UNIV & AG & MECH & HEBERT LAWS CTR",NA,NA,5072,2803,2269,1229,431,798,0.285,0.242,0.19,2551,4148
"4152",159391,2001,1,0,"LOUISIANA STATE UNIV & AG & MECH & HEBERT LAWS CTR",NA,NA,5214,2873,2341,1282,424,858,0.299,0.246,0.181,2551,4297
"4153",159391,2002,1,0,"LOUISIANA STATE UNIV & AG & MECH & HEBERT LAWS CTR",NA,NA,5170,2842,2328,1353,464,889,0.313,0.262,0.199,2635,4282
"4154",159391,2003,1,0,"LOUISIANA STATE UNIV & AG & MECH & HEBERT LAWS CTR",NA,NA,5359,2938,2421,1396,468,928,0.316,0.26,0.193,2739,4402
"4155",159391,2004,1,0,"LOUISIANA STATE UNIV & AG & MECH & HEBERT LAWS CTR",NA,NA,5692,3099,2593,1492,539,953,0.308,0.262,0.208,2855,4607
"4156",159391,2005,1,0,"Louisiana State University and Agricultural & Mechanical College",NA,NA,4966,2653,2313,1440,576,864,0.326,0.29,0.249,2981,4075
"4157",159391,2006,1,0,"Louisiana State University and Agricultural & Mechanical College",NA,NA,4503,2449,2054,1530,584,946,0.386,0.34,0.284,2981,3711
"4158",159391,2007,1,0,"Louisiana State University and Agricultural & Mechanical College",NA,NA,4585,2415,2170,1737,658,1079,0.447,0.379,0.303,2981,3741
"4159",159391,2008,1,0,"Louisiana State University and Agricultural & Mechanical College",NA,NA,5131,2781,2350,1900,699,1201,0.432,0.37,0.297,3215,4084
"4160",159391,2009,1,0,"Louisiana State University and Agricultural & Mechanical College",NA,NA,4776,2516,2260,1823,665,1158,0.46,0.382,0.294,3469,3785
"4161",159391,2010,1,0,"Louisiana State University and Agricultural & Mechanical College",NA,NA,5477,2904,2573,2145,777,1368,0.471,0.392,0.302,3968,4257
"4162",159647,1991,0,1,"LOUISIANA TECH UNIVERSITY",9999,0,1834,827,1007,278,108,170,0.206,0.152,0.107,1841,1247
"4163",159647,1992,0,1,"LOUISIANA TECH UNIVERSITY",9999,0,1473,703,770,264,86,178,0.253,0.179,0.112,1868,1174
"4164",159647,1993,0,1,"LOUISIANA TECHNICAL UNIVERSITY",9999,0,1411,672,739,258,96,162,0.241,0.183,0.13,2169,1173
"4165",159647,1995,0,1,"LOUISIANA TECH UNIVERSITY",9999,0,1278,598,680,281,103,178,0.298,0.22,0.151,2274,1040
"4166",159647,1996,0,1,"LOUISIANA TECH UNIVERSITY",9999,0,1279,618,661,330,133,197,0.319,0.258,0.201,2352,1057
"4167",159647,1997,0,1,"LOUISIANA TECH UNIVERSITY",9999,0,1428,714,714,361,133,228,0.319,0.253,0.186,2517,1163
"4168",159647,1998,0,1,"LOUISIANA TECH UNIVERSITY",9999,0,1621,794,827,449,178,271,0.341,0.277,0.215,2532,1342
"4169",159647,1999,0,1,"LOUISIANA TECH UNIVERSITY",9999,0,1753,840,913,478,199,279,0.332,0.273,0.218,2379,1391
"4170",159647,2000,0,1,"LOUISIANA TECH UNIVERSITY",9999,0,1795,819,976,480,222,258,0.315,0.267,0.227,2778,1425
"4171",159647,2001,0,1,"LOUISIANA TECH UNIVERSITY",9999,0,1770,850,920,481,211,270,0.318,0.272,0.229,2922,1391
"4172",159647,2002,0,1,"LOUISIANA TECH UNIVERSITY",9999,0,1936,947,989,500,202,298,0.315,0.258,0.204,2919,1448
"4173",159647,2003,0,1,"LOUISIANA TECH UNIVERSITY",9999,0,1948,958,990,485,190,295,0.308,0.249,0.192,3462,1493
"4174",159647,2004,0,1,"LOUISIANA TECH UNIVERSITY",9999,0,1644,730,914,432,189,243,0.333,0.263,0.207,3795,1151
"4175",159647,2005,0,1,"Louisiana Tech University",9999,0,1653,762,891,446,177,269,0.353,0.27,0.199,3951,1304
"4176",159647,2006,0,1,"Louisiana Tech University",9999,0,1625,753,872,426,185,241,0.32,0.262,0.212,4383,1204
"4177",159647,2007,0,1,"Louisiana Tech University",9999,0,1522,704,818,432,180,252,0.358,0.284,0.22,4458,1193
"4178",159647,2008,0,1,"Louisiana Tech University",9999,0,1503,695,808,428,187,241,0.347,0.285,0.231,4911,1136
"4179",159647,2009,0,1,"Louisiana Tech University",9999,0,1448,622,826,438,209,229,0.368,0.302,0.253,5091,948
"4180",159647,2010,0,1,"Louisiana Tech University",9999,0,1530,679,851,504,220,284,0.418,0.329,0.259,3640,1116
"4181",159717,1991,1,0,"MCNEESE STATE UNIVERSITY",NA,NA,1253,652,601,83,23,60,0.092,0.066,0.038,1626,1058
"4182",159717,1992,1,0,"MCNEESE STATE UNIVERSITY",NA,NA,1272,705,567,64,16,48,0.068,0.05,0.028,1626,1062
"4183",159717,1993,1,0,"MCNEESE STATE UNIVERSITY",NA,NA,1307,702,605,66,13,53,0.076,0.05,0.021,1968,1024
"4184",159717,1995,1,0,"MCNEESE STATE UNIVERSITY",NA,NA,1376,775,601,71,22,49,0.063,0.052,0.037,1998,1067
"4185",159717,1996,1,0,"MCNEESE STATE UNIVERSITY",NA,NA,1357,750,607,105,24,81,0.108,0.077,0.04,1998,1046
"4186",159717,1997,1,0,"MCNEESE STATE UNIVERSITY",NA,NA,1447,779,668,116,27,89,0.114,0.08,0.04,1998,1118
"4187",159717,1998,1,0,"MCNEESE STATE UNIVERSITY",NA,NA,1433,802,631,141,35,106,0.132,0.098,0.055,2128,1088
"4188",159717,1999,1,0,"MCNEESE STATE UNIVERSITY",NA,NA,1275,636,639,127,34,93,0.146,0.1,0.053,1650,1016
"4189",159717,2000,1,0,"MCNEESE STATE UNIVERSITY",NA,NA,1320,767,553,110,31,79,0.103,0.083,0.056,1900,1035
"4190",159717,2001,1,0,"MCNEESE STATE UNIVERSITY",NA,NA,1350,745,605,151,56,95,0.128,0.112,0.093,1900,1077
"4191",159717,2002,1,0,"MCNEESE STATE UNIVERSITY",NA,NA,1358,762,596,179,67,112,0.147,0.132,0.112,1974,1024
"4192",159717,2003,1,0,"MCNEESE STATE UNIVERSITY",NA,NA,1506,843,663,176,51,125,0.148,0.117,0.077,2050,1076
"4193",159717,2004,1,0,"MCNEESE STATE UNIVERSITY",NA,NA,1603,923,680,196,61,135,0.146,0.122,0.09,2134,1186
"4194",159717,2005,1,0,"McNeese State University",NA,NA,1311,743,568,177,52,125,0.168,0.135,0.092,2226,982
"4195",159717,2006,1,0,"McNeese State University",NA,NA,1272,741,531,195,60,135,0.182,0.153,0.113,2226,996
"4196",159717,2007,1,0,"McNeese State University",NA,NA,1247,717,530,163,55,108,0.151,0.131,0.104,2226,920
"4197",159717,2008,1,0,"McNeese State University",NA,NA,1272,742,530,203,62,141,0.19,0.16,0.117,2386,943
"4198",159717,2009,1,0,"McNeese State University",NA,NA,1221,728,493,256,83,173,0.238,0.21,0.168,2556,927
"4199",159717,2010,1,0,"McNeese State University",NA,NA,1259,756,503,261,84,177,0.234,0.207,0.167,2916,943
"4200",159966,1991,1,0,"NICHOLLS STATE UNIVERSITY",NA,NA,1204,698,506,57,13,44,0.063,0.047,0.026,1591,996
"4201",159966,1992,1,0,"NICHOLLS STATE UNIVERSITY",NA,NA,1059,613,446,53,10,43,0.07,0.05,0.022,1661,854
"4202",159966,1993,1,0,"NICHOLLS STATE UNIVERSITY",NA,NA,969,586,383,33,12,21,0.036,0.034,0.031,1981,756
"4203",159966,1995,1,0,"NICHOLLS STATE UNIVERSITY",NA,NA,1170,672,498,76,19,57,0.085,0.065,0.038,2016,866
"4204",159966,1996,1,0,"NICHOLLS STATE UNIVERSITY",NA,NA,1008,603,405,54,13,41,0.068,0.054,0.032,2016,741
"4205",159966,1997,1,0,"NICHOLLS STATE UNIVERSITY",NA,NA,1075,646,429,81,14,67,0.104,0.075,0.033,2136,760
"4206",159966,1998,1,0,"NICHOLLS STATE UNIVERSITY",NA,NA,1351,781,570,117,22,95,0.122,0.087,0.039,2136,1009
"4207",159966,1999,1,0,"NICHOLLS STATE UNIVERSITY",NA,NA,1445,860,585,129,30,99,0.115,0.089,0.051,1645,1109
"4208",159966,2000,1,0,"NICHOLLS STATE UNIVERSITY",NA,NA,1460,882,578,118,26,92,0.104,0.081,0.045,1895,1075
"4209",159966,2001,1,0,"NICHOLLS STATE UNIVERSITY",NA,NA,1408,841,567,121,28,93,0.111,0.086,0.049,1895,1007
"4210",159966,2002,1,0,"NICHOLLS STATE UNIVERSITY",NA,NA,1404,821,583,120,27,93,0.113,0.085,0.046,1967,1000
"4211",159966,2003,1,0,"NICHOLLS STATE UNIVERSITY",NA,NA,1391,813,578,121,36,85,0.105,0.087,0.062,2045,955
"4212",159966,2004,1,0,"NICHOLLS STATE UNIVERSITY",NA,NA,1574,939,635,146,44,102,0.109,0.093,0.069,2135,1068
"4213",159966,2005,1,0,"Nicholls State University",NA,NA,1171,703,468,163,62,101,0.144,0.139,0.132,2231,893
"4214",159966,2006,1,0,"Nicholls State University",NA,NA,1069,650,419,170,44,126,0.194,0.159,0.105,2231,788
"4215",159966,2007,1,0,"Nicholls State University",NA,NA,1156,696,460,196,59,137,0.197,0.17,0.128,2231,905
"4216",159966,2008,1,0,"Nicholls State University",NA,NA,1217,712,505,207,60,147,0.206,0.17,0.119,2411,861
"4217",159966,2009,1,0,"Nicholls State University",NA,NA,1212,707,505,200,67,133,0.188,0.165,0.133,2603,880
"4218",159966,2010,1,0,"Nicholls State University",NA,NA,1048,652,396,201,63,138,0.212,0.192,0.159,3024,774
"4219",160038,1991,1,0,"NORTHWESTERN STATE UNIVERSITY OF LOUISIANA",NA,NA,1179,710,469,110,24,86,0.121,0.093,0.051,1771,850
"4220",160038,1992,1,0,"NORTHWESTERN STATE UNIVERSITY OF LOUISIANA",NA,NA,1227,737,490,108,30,78,0.106,0.088,0.061,1771,878
"4221",160038,1993,1,0,"NORTHWESTERN STATE UNIVERSITY OF LOUISIANA",NA,NA,1380,824,556,112,28,84,0.102,0.081,0.05,2071,918
"4222",160038,1995,1,0,"NORTHWESTERN STATE UNIVERSITY OF LOUISIANA",NA,NA,1556,947,609,165,41,124,0.131,0.106,0.067,2067,1023
"4223",160038,1996,1,0,"NORTHWESTERN STATE UNIVERSITY OF LOUISIANA",NA,NA,1480,891,589,22,5,17,0.019,0.015,0.008,2067,942
"4224",160038,1997,1,0,"NORTHWESTERN STATE UNIVERSITY OF LOUISIANA",NA,NA,1415,878,537,129,35,94,0.107,0.091,0.065,2057,857
"4225",160038,1998,1,0,"NORTHWESTERN STATE UNIVERSITY OF LOUISIANA",NA,NA,1364,857,507,157,43,114,0.133,0.115,0.085,2177,808
"4226",160038,1999,1,0,"NORTHWESTERN STATE UNIVERSITY OF LOUISIANA",NA,NA,1656,988,668,184,71,113,0.114,0.111,0.106,2030,1037
"4227",160038,2000,1,0,"NORTHWESTERN STATE UNIVERSITY OF LOUISIANA",NA,NA,1555,959,596,194,56,138,0.144,0.125,0.094,2086,979
"4228",160038,2001,1,0,"NORTHWESTERN STATE UNIVERSITY OF LOUISIANA",NA,NA,1543,951,592,198,43,155,0.163,0.128,0.073,1970,948
"4229",160038,2002,1,0,"NORTHWESTERN STATE UNIVERSITY OF LOUISIANA",NA,NA,1875,1093,782,216,80,136,0.124,0.115,0.102,1976,993
"4230",160038,2003,1,0,"NORTHWESTERN STATE UNIVERSITY OF LOUISIANA",NA,NA,1826,1117,709,227,71,156,0.14,0.124,0.1,2054,961
"4231",160038,2004,1,0,"NORTHWESTERN STATE UNIVERSITY OF LOUISIANA",NA,NA,1793,1084,709,187,55,132,0.122,0.104,0.078,2144,902
"4232",160038,2005,1,0,"Northwestern State University of Louisiana",NA,NA,1417,869,548,218,71,147,0.169,0.154,0.13,2240,791
"4233",160038,2006,1,0,"Northwestern State University of Louisiana",NA,NA,1324,854,470,214,62,152,0.178,0.162,0.132,2240,777
"4234",160038,2007,1,0,"Northwestern State University of Louisiana",NA,NA,1281,812,469,223,69,154,0.19,0.174,0.147,2240,769
"4235",160038,2008,1,0,"Northwestern State University of Louisiana",NA,NA,1183,736,447,225,69,156,0.212,0.19,0.154,2412,664
"4236",160038,2009,1,0,"Northwestern State University of Louisiana",NA,NA,1235,781,454,231,64,167,0.214,0.187,0.141,2594,677
"4237",160038,2010,1,0,"Northwestern State University of Louisiana",NA,NA,1056,678,378,213,60,153,0.226,0.202,0.159,3002,583
"4238",160612,1991,1,0,"SOUTHEASTERN LOUISIANA UNIVERSITY",NA,NA,1898,1075,823,53,9,44,0.041,0.028,0.011,1607,1739
"4239",160612,1992,1,0,"SOUTHEASTERN LOUISIANA UNIVERSITY",NA,NA,2199,1285,914,86,21,65,0.051,0.039,0.023,1610,1960
"4240",160612,1993,1,0,"SOUTHEASTERN LOUISIANA UNIVERSITY",NA,NA,2192,1222,970,77,19,58,0.048,0.035,0.02,1760,1950
"4241",160612,1995,1,0,"SOUTHEASTERN LOUISIANA UNIVERSITY",NA,NA,2367,1387,980,94,21,73,0.053,0.04,0.021,2050,2037
"4242",160612,1996,1,0,"SOUTHEASTERN LOUISIANA UNIVERSITY",NA,NA,2337,1273,1064,107,33,74,0.058,0.046,0.031,2050,2014
"4243",160612,1997,1,0,"SOUTHEASTERN LOUISIANA UNIVERSITY",NA,NA,2487,1371,1116,107,24,83,0.06,0.043,0.022,2050,2090
"4244",160612,1998,1,0,"SOUTHEASTERN LOUISIANA UNIVERSITY",NA,NA,2588,1471,1117,156,50,106,0.072,0.06,0.045,2150,2148
"4245",160612,1999,1,0,"SOUTHEASTERN LOUISIANA UNIVERSITY",NA,NA,2315,1361,954,170,44,126,0.093,0.073,0.046,2210,1910
"4246",160612,2000,1,0,"SOUTHEASTERN LOUISIANA UNIVERSITY",NA,NA,2220,1351,869,176,59,117,0.087,0.079,0.068,2490,1839
"4247",160612,2001,1,0,"SOUTHEASTERN LOUISIANA UNIVERSITY",NA,NA,2007,1209,798,199,51,148,0.122,0.099,0.064,2607,1657
"4248",160612,2002,1,0,"SOUTHEASTERN LOUISIANA UNIVERSITY",NA,NA,2382,1370,1012,168,49,119,0.087,0.071,0.048,2618,1879
"4249",160612,2003,1,0,"SOUTHEASTERN LOUISIANA UNIVERSITY",NA,NA,2539,1451,1088,221,72,149,0.103,0.087,0.066,2951,1933
"4250",160612,2004,1,0,"SOUTHEASTERN LOUISIANA UNIVERSITY",NA,NA,2137,1250,887,210,68,142,0.114,0.098,0.077,3191,1700
"4251",160612,2005,1,0,"Southeastern Louisiana University",NA,NA,2228,1388,840,252,74,178,0.128,0.113,0.088,3341,1689
"4252",160612,2006,1,0,"Southeastern Louisiana University",NA,NA,2665,1604,1061,320,93,227,0.142,0.12,0.088,2216,1968
"4253",160612,2007,1,0,"Southeastern Louisiana University",NA,NA,2524,1458,1066,336,102,234,0.16,0.133,0.096,2216,1895
"4254",160612,2008,1,0,"Southeastern Louisiana University",NA,NA,2613,1538,1075,358,112,246,0.16,0.137,0.104,2376,1915
"4255",160612,2009,1,0,"Southeastern Louisiana University",NA,NA,2508,1497,1011,359,118,241,0.161,0.143,0.117,2546,1851
"4256",160612,2010,1,0,"Southeastern Louisiana University",NA,NA,2414,1408,1006,408,133,275,0.195,0.169,0.132,2993,1853
"4257",160621,1991,1,0,"SOUTHERN UNIVERSITY AND A & M COL AT BATON ROUGE",NA,NA,1907,985,922,59,10,49,0.05,0.031,0.011,1580,23
"4258",160621,1992,1,0,"SOUTHERN UNIVERSITY AND A & M COL AT BATON ROUGE",NA,NA,2033,1066,967,91,20,71,0.067,0.045,0.021,1588,30
"4259",160621,1993,1,0,"SOUTHERN UNIVERSITY AND A & M COLLEGE-BATON ROUGE",NA,NA,1658,862,796,80,16,64,0.074,0.048,0.02,2028,56
"4260",160621,1995,1,0,"SOUTHERN UNIVERSITY AND A & M COLLEGE",NA,NA,1846,991,855,101,21,80,0.081,0.055,0.025,2028,9
"4261",160621,1996,1,0,"SOUTHERN UNIVERSITY AND A & M COLLEGE",NA,NA,1910,1041,869,129,24,105,0.101,0.068,0.028,2028,10
"4262",160621,1997,1,0,"SOUTHERN UNIVERSITY AND A & M COLLEGE",NA,NA,1853,997,856,106,28,78,0.078,0.057,0.033,2068,12
"4263",160621,1998,1,0,"SOUTHERN UNIVERSITY AND A & M COLLEGE",NA,NA,1715,911,804,110,25,85,0.093,0.064,0.031,2208,6
"4264",160621,1999,1,0,"SOUTHERN UNIVERSITY AND A & M COLLEGE",NA,NA,1287,693,594,86,19,67,0.097,0.067,0.032,2286,4
"4265",160621,2000,1,0,"SOUTHERN UNIVERSITY AND A & M COLLEGE",NA,NA,1766,996,770,2,2,0,0,0.001,0.003,2286,7
"4266",160621,2001,1,0,"SOUTHERN UNIVERSITY AND A & M COLLEGE",NA,NA,1206,690,516,75,14,61,0.088,0.062,0.027,2682,9
"4267",160621,2002,1,0,"SOUTHERN UNIVERSITY AND A & M COLLEGE",NA,NA,1176,673,503,77,14,63,0.094,0.065,0.028,2702,7
"4268",160621,2003,1,0,"SOUTHERN UNIVERSITY AND A & M COLLEGE",NA,NA,1351,782,569,77,16,61,0.078,0.057,0.028,3066,11
"4269",160621,2004,1,0,"SOUTHERN UNIVERSITY AND A & M COLLEGE",NA,NA,1575,931,644,115,30,85,0.091,0.073,0.047,3440,6
"4270",160621,2005,1,0,"Southern University and A & M College",NA,NA,1434,797,637,290,93,197,0.247,0.202,0.146,3592,6
"4271",160621,2006,1,0,"Southern University and A & M College",NA,NA,1136,659,477,132,33,99,0.15,0.116,0.069,3602,2
"4272",160621,2007,1,0,"Southern University and A & M College",NA,NA,1178,658,520,95,18,77,0.117,0.081,0.035,3666,7
"4273",160621,2008,1,0,"Southern University and A & M College",NA,NA,1034,605,429,62,19,43,0.071,0.06,0.044,3906,10
"4274",160621,2009,1,0,"Southern University and A & M College",NA,NA,992,539,453,96,31,65,0.121,0.097,0.068,4100,18
"4275",160621,2010,1,0,"Southern University and A & M College",NA,NA,852,488,364,60,18,42,0.086,0.07,0.049,4584,15
"4276",160658,1991,1,0,"UNIVERSITY OF SOUTHWESTERN LOUISIANA",NA,NA,2383,1300,1083,88,26,62,0.048,0.037,0.024,1568,1705
"4277",160658,1992,1,0,"UNIVERSITY OF SOUTHWESTERN LOUISIANA",NA,NA,2563,1396,1167,77,25,52,0.037,0.03,0.021,1597,1797
"4278",160658,1993,1,0,"UNIVERSITY OF SOUTHWESTERN LOUISIANA",NA,NA,2524,1378,1146,110,32,78,0.057,0.044,0.028,1897,1787
"4279",160658,1995,1,0,"UNIVERSITY OF SOUTHWESTERN LOUISIANA",NA,NA,2609,1453,1156,110,24,86,0.059,0.042,0.021,1897,1799
"4280",160658,1996,1,0,"UNIVERSITY OF SOUTHWESTERN LOUISIANA",NA,NA,2674,1461,1213,161,41,120,0.082,0.06,0.034,1885,1801
"4281",160658,1997,1,0,"UNIVERSITY OF SOUTHWESTERN LOUISIANA",NA,NA,2764,1543,1221,169,44,125,0.081,0.061,0.036,1885,1796
"4282",160658,1998,1,0,"UNIVERSITY OF SOUTHWESTERN LOUISIANA",NA,NA,2931,1621,1310,249,69,180,0.111,0.085,0.053,2010,1962
"4283",160658,1999,1,0,"UNIVERSITY OF LOUISIANA AT LAFAYETTE",NA,NA,2402,1300,1102,298,94,204,0.157,0.124,0.085,2013,1777
"4284",160658,2000,1,0,"UNIVERSITY OF LOUISIANA AT LAFAYETTE",NA,NA,2291,1302,989,314,103,211,0.162,0.137,0.104,2277,1742
"4285",160658,2001,1,0,"UNIVERSITY OF LOUISIANA AT LAFAYETTE",NA,NA,2301,1306,995,322,93,229,0.175,0.14,0.093,2314,1775
"4286",160658,2002,1,0,"UNIVERSITY OF LOUISIANA AT LAFAYETTE",NA,NA,2385,1326,1059,293,77,216,0.163,0.123,0.073,2386,1817
"4287",160658,2003,1,0,"UNIVERSITY OF LOUISIANA AT LAFAYETTE",NA,NA,2576,1437,1139,333,86,247,0.172,0.129,0.076,2700,1976
"4288",160658,2004,1,0,"UNIVERSITY OF LOUISIANA AT LAFAYETTE",NA,NA,2643,1517,1126,345,101,244,0.161,0.131,0.09,3228,1974
"4289",160658,2005,1,0,"University of Louisiana at Lafayette",NA,NA,2730,1538,1192,329,102,227,0.148,0.121,0.086,3324,2027
"4290",160658,2006,1,0,"University of Louisiana at Lafayette",NA,NA,2799,1604,1195,362,108,254,0.158,0.129,0.09,3382,2053
"4291",160658,2007,1,0,"University of Louisiana at Lafayette",NA,NA,2691,1554,1137,361,111,250,0.161,0.134,0.098,3402,2026
"4292",160658,2008,1,0,"University of Louisiana at Lafayette",NA,NA,2566,1435,1131,373,128,245,0.171,0.145,0.113,3574,1927
"4293",160658,2009,1,0,"University of Louisiana at Lafayette",NA,NA,2553,1427,1126,373,126,247,0.173,0.146,0.112,4016,1818
"4294",160658,2010,1,0,"University of Louisiana-Lafayette",NA,NA,2914,1629,1285,465,141,324,0.199,0.16,0.11,4426,1997
"4295",161004,1991,1,0,"BOWDOIN COLLEGE",NA,NA,398,185,213,341,182,159,0.86,0.857,0.854,16070,335
"4296",161004,1992,1,0,"BOWDOIN COLLEGE",NA,NA,409,224,185,347,154,193,0.862,0.848,0.832,17035,350
"4297",161004,1993,1,0,"BOWDOIN COLLEGE",NA,NA,418,218,200,356,163,193,0.885,0.852,0.815,18300,347
"4298",161004,1995,1,0,"BOWDOIN COLLEGE",NA,NA,446,225,221,369,180,189,0.84,0.827,0.814,20555,328
"4299",161004,1996,1,0,"BOWDOIN COLLEGE",NA,NA,443,223,220,369,175,194,0.87,0.833,0.795,21750,374
"4300",161004,1997,1,0,"BOWDOIN COLLEGE",NA,NA,473,246,227,384,175,209,0.85,0.812,0.771,22460,314
"4301",161004,1998,1,0,"BOWDOIN COLLEGE",NA,NA,433,213,220,361,181,180,0.845,0.834,0.823,23895,352
"4302",161004,1999,1,0,"BOWDOIN COLLEGE",NA,NA,464,259,205,418,183,235,0.907,0.901,0.893,24435,389
"4303",161004,2000,1,0,"BOWDOIN COLLEGE",NA,NA,452,221,231,379,188,191,0.864,0.838,0.814,25345,347
"4304",161004,2001,1,0,"BOWDOIN COLLEGE",NA,NA,452,228,224,374,191,183,0.803,0.827,0.853,26700,344
"4305",161004,2002,1,0,"BOWDOIN COLLEGE",NA,NA,457,237,220,384,196,188,0.793,0.84,0.891,28070,321
"4306",161004,2003,1,0,"BOWDOIN COLLEGE",NA,NA,464,236,228,412,202,210,0.89,0.888,0.886,29470,333
"4307",161004,2004,1,0,"BOWDOIN COLLEGE",NA,NA,470,235,235,421,212,209,0.889,0.896,0.902,30944,312
"4308",161004,2005,1,0,"Bowdoin College",NA,NA,477,257,220,420,189,231,0.899,0.881,0.859,32650,327
"4309",161004,2006,1,0,"Bowdoin College",NA,NA,474,253,221,430,193,237,0.937,0.907,0.873,34280,334
"4310",161004,2007,1,0,"Bowdoin College",NA,NA,475,250,225,416,196,220,0.88,0.876,0.871,35990,314
"4311",161004,2008,1,0,"Bowdoin College",NA,NA,488,232,256,420,203,217,0.935,0.861,0.793,37790,312
"4312",161004,2009,1,0,"Bowdoin College",NA,NA,493,253,240,422,200,222,0.878,0.856,0.833,39605,320
"4313",161004,2010,1,0,"Bowdoin College",NA,NA,507,249,258,453,230,223,0.896,0.893,0.891,41150,320
"4314",161226,1991,1,0,"UNIVERSITY OF MAINE AT FARMINGTON",NA,NA,457,337,120,157,30,127,0.377,0.344,0.25,2340,444
"4315",161226,1992,1,0,"UNIVERSITY OF MAINE AT FARMINGTON",NA,NA,441,302,139,126,31,95,0.315,0.286,0.223,2670,423
"4316",161226,1993,1,0,"UNIVERSITY OF MAINE AT FARMINGTON",NA,NA,419,317,102,169,24,145,0.457,0.403,0.235,2910,408
"4317",161226,1995,1,0,"UNIVERSITY OF MAINE AT FARMINGTON",NA,NA,473,335,138,153,35,118,0.352,0.323,0.254,3220,451
"4318",161226,1996,1,0,"UNIVERSITY OF MAINE AT FARMINGTON",NA,NA,477,332,145,147,32,115,0.346,0.308,0.221,3370,435
"4319",161226,1997,1,0,"UNIVERSITY OF MAINE AT FARMINGTON",NA,NA,466,308,158,148,28,120,0.39,0.318,0.177,3520,440
"4320",161226,1998,1,0,"UNIVERSITY OF MAINE AT FARMINGTON",NA,NA,484,333,151,155,41,114,0.342,0.32,0.272,3686,435
"4321",161226,1999,1,0,"UNIVERSITY OF MAINE AT FARMINGTON",NA,NA,470,344,126,197,48,149,0.433,0.419,0.381,3390,368
"4322",161226,2000,1,0,"UNIVERSITY OF MAINE AT FARMINGTON",NA,NA,475,329,146,176,40,136,0.413,0.371,0.274,3540,412
"4323",161226,2001,1,0,"UNIVERSITY OF MAINE AT FARMINGTON",NA,NA,479,323,156,174,45,129,0.399,0.363,0.288,3735,423
"4324",161226,2002,1,0,"UNIVERSITY OF MAINE AT FARMINGTON",NA,NA,453,295,158,156,40,116,0.393,0.344,0.253,3990,437
"4325",161226,2003,1,0,"UNIVERSITY OF MAINE AT FARMINGTON",NA,NA,482,339,143,221,59,162,0.478,0.459,0.413,4290,454
"4326",161226,2004,1,0,"UNIVERSITY OF MAINE AT FARMINGTON",NA,NA,510,342,168,196,46,150,0.439,0.384,0.274,4650,494
"4327",161226,2005,1,0,"University of Maine at Farmington",NA,NA,559,387,172,229,60,169,0.437,0.41,0.349,5010,334
"4328",161226,2006,1,0,"University of Maine at Farmington",NA,NA,511,351,160,209,49,160,0.456,0.409,0.306,5824,454
"4329",161226,2007,1,0,"University of Maine at Farmington",NA,NA,479,327,152,181,45,136,0.416,0.378,0.296,6528,432
"4330",161226,2008,1,0,"University of Maine at Farmington",NA,NA,512,335,177,184,47,137,0.409,0.359,0.266,7296,431
"4331",161226,2009,1,0,"University of Maine at Farmington",NA,NA,487,312,175,210,64,146,0.468,0.431,0.366,7712,427
"4332",161226,2010,1,0,"University of Maine at Farmington",NA,NA,555,352,203,242,68,174,0.494,0.436,0.335,8032,488
"4333",161235,1991,1,0,"UNIVERSITY OF MAINE AT FORT KENT",NA,NA,86,53,33,11,3,8,0.151,0.128,0.091,2250,65
"4334",161235,1992,1,0,"UNIVERSITY OF MAINE AT FORT KENT",NA,NA,97,43,54,8,3,5,0.116,0.082,0.056,2580,95
"4335",161235,1993,1,0,"UNIVERSITY OF MAINE AT FORT KENT",NA,NA,81,46,35,6,0,6,0.13,0.074,0,2760,81
"4336",161235,1995,1,0,"UNIVERSITY OF MAINE AT FORT KENT",NA,NA,74,34,40,6,2,4,0.118,0.081,0.05,2930,72
"4337",161235,1996,1,0,"UNIVERSITY OF MAINE AT FORT KENT",NA,NA,84,49,35,9,1,8,0.163,0.107,0.029,2990,82
"4338",161235,1997,1,0,"UNIVERSITY OF MAINE AT FORT KENT",NA,NA,77,47,30,5,0,5,0.106,0.065,0,3140,77
"4339",161235,1998,1,0,"UNIVERSITY OF MAINE AT FORT KENT",NA,NA,93,40,53,9,1,8,0.2,0.097,0.019,3284,24
"4340",161235,1999,1,0,"UNIVERSITY OF MAINE AT FORT KENT",NA,NA,109,64,45,17,3,14,0.219,0.156,0.067,3090,19
"4341",161235,2000,1,0,"UNIVERSITY OF MAINE AT FORT KENT",NA,NA,82,38,44,4,1,3,0.079,0.049,0.023,3150,80
"4342",161235,2001,1,0,"UNIVERSITY OF MAINE AT FORT KENT",NA,NA,99,49,50,24,8,16,0.326,0.242,0.16,3270,89
"4343",161235,2002,1,0,"UNIVERSITY OF MAINE AT FORT KENT",NA,NA,130,61,69,30,15,15,0.246,0.231,0.217,3420,119
"4344",161235,2003,1,0,"UNIVERSITY OF MAINE AT FORT KENT",NA,NA,126,62,64,19,4,15,0.242,0.151,0.062,3690,112
"4345",161235,2004,1,0,"UNIVERSITY OF MAINE AT FORT KENT",NA,NA,166,85,81,17,2,15,0.176,0.102,0.025,3960,157
"4346",161235,2005,1,0,"University of Maine at Fort Kent",NA,NA,129,69,60,22,9,13,0.188,0.171,0.15,4290,121
"4347",161235,2006,1,0,"University of Maine at Fort Kent",NA,NA,116,67,49,2,1,1,0.015,0.017,0.02,4650,106
"4348",161235,2007,1,0,"University of Maine at Fort Kent",NA,NA,110,60,50,36,18,18,0.3,0.327,0.36,5100,89
"4349",161235,2008,1,0,"University of Maine at Fort Kent",NA,NA,111,60,51,27,14,13,0.217,0.243,0.275,5700,91
"4350",161235,2009,1,0,"University of Maine at Fort Kent",NA,NA,118,69,49,20,5,15,0.217,0.169,0.102,6030,101
"4351",161235,2010,1,0,"University of Maine at Fort Kent",NA,NA,153,94,59,27,6,21,0.223,0.176,0.102,6330,139
"4352",161244,1991,1,0,"UNIVERSITY OF MAINE AT MACHIAS",NA,NA,146,91,55,11,4,7,0.077,0.075,0.073,2275,139
"4353",161244,1992,1,0,"UNIVERSITY OF MAINE AT MACHIAS",NA,NA,139,98,41,12,3,9,0.092,0.086,0.073,2605,119
"4354",161244,1993,1,0,"UNIVERSITY OF MAINE AT MACHIAS",NA,NA,133,84,49,10,6,4,0.048,0.075,0.122,2785,115
"4355",161244,1995,1,0,"UNIVERSITY OF MAINE AT MACHIAS",NA,NA,129,73,56,10,5,5,0.068,0.078,0.089,2935,121
"4356",161244,1996,1,0,"UNIVERSITY OF MAINE AT MACHIAS",NA,NA,143,86,57,9,3,6,0.07,0.063,0.053,3035,123
"4357",161244,1997,1,0,"UNIVERSITY OF MAINE AT MACHIAS",NA,NA,121,63,58,9,3,6,0.095,0.074,0.052,3225,107
"4358",161244,1998,1,0,"UNIVERSITY OF MAINE AT MACHIAS",NA,NA,148,95,53,8,2,6,0.063,0.054,0.038,3345,135
"4359",161244,1999,1,0,"UNIVERSITY OF MAINE AT MACHIAS",NA,NA,121,83,38,15,4,11,0.132,0.124,0.105,3090,112
"4360",161244,2000,1,0,"UNIVERSITY OF MAINE AT MACHIAS",NA,NA,127,85,42,13,4,9,0.106,0.102,0.095,3150,116
"4361",161244,2001,1,0,"UNIVERSITY OF MAINE AT MACHIAS",NA,NA,155,105,50,32,6,26,0.248,0.206,0.12,3270,130
"4362",161244,2002,1,0,"UNIVERSITY OF MAINE AT MACHIAS",NA,NA,132,81,51,19,9,10,0.124,0.144,0.176,3420,124
"4363",161244,2003,1,0,"UNIVERSITY OF MAINE AT MACHIAS",NA,NA,142,92,50,17,1,16,0.174,0.12,0.02,3636,120
"4364",161244,2004,1,0,"UNIVERSITY OF MAINE AT MACHIAS",NA,NA,80,54,26,14,3,11,0.204,0.175,0.115,3960,71
"4365",161244,2005,1,0,"University of Maine at Machias",NA,NA,106,71,35,17,5,12,0.169,0.16,0.143,4290,92
"4366",161244,2006,1,0,"University of Maine at Machias",NA,NA,99,59,40,10,6,4,0.068,0.101,0.15,4650,96
"4367",161244,2007,1,0,"University of Maine at Machias",NA,NA,110,72,38,15,6,9,0.125,0.136,0.158,5100,100
"4368",161244,2008,1,0,"University of Maine at Machias",NA,NA,105,62,43,23,8,15,0.242,0.219,0.186,5700,91
"4369",161244,2009,1,0,"University of Maine at Machias",NA,NA,101,67,34,16,4,12,0.179,0.158,0.118,6030,83
"4370",161244,2010,1,0,"University of Maine at Machias",NA,NA,105,61,44,18,6,12,0.197,0.171,0.136,6330,83
"4371",161253,1991,1,0,"UNIVERSITY OF MAINE AT ORONO",NA,NA,1589,710,879,324,140,184,0.259,0.204,0.159,2718,1513
"4372",161253,1992,1,0,"UNIVERSITY OF MAINE",NA,NA,1413,630,783,293,128,165,0.262,0.207,0.163,3086,1317
"4373",161253,1993,1,0,"UNIVERSITY OF MAINE",NA,NA,1211,522,689,320,131,189,0.362,0.264,0.19,3406,1144
"4374",161253,1995,1,0,"UNIVERSITY OF MAINE",NA,NA,1118,526,592,322,148,174,0.331,0.288,0.25,3925,1054
"4375",161253,1996,1,0,"UNIVERSITY OF MAINE",NA,NA,1264,549,715,340,156,184,0.335,0.269,0.218,4139,1186
"4376",161253,1997,1,0,"UNIVERSITY OF MAINE",NA,NA,1091,513,578,327,144,183,0.357,0.3,0.249,4339,1008
"4377",161253,1998,1,0,"UNIVERSITY OF MAINE",NA,NA,1342,671,671,418,165,253,0.377,0.311,0.246,4551,1248
"4378",161253,1999,1,0,"UNIVERSITY OF MAINE",NA,NA,1521,718,803,430,176,254,0.354,0.283,0.219,3960,1411
"4379",161253,2000,1,0,"UNIVERSITY OF MAINE",NA,NA,1589,781,808,536,222,314,0.402,0.337,0.275,4050,1507
"4380",161253,2001,1,0,"UNIVERSITY OF MAINE",NA,NA,1545,737,808,495,214,281,0.381,0.32,0.265,5116,1436
"4381",161253,2002,1,0,"UNIVERSITY OF MAINE",NA,NA,1651,808,843,554,246,308,0.381,0.336,0.292,4380,1552
"4382",161253,2003,1,0,"UNIVERSITY OF MAINE",NA,NA,1599,812,787,538,235,303,0.373,0.336,0.299,4710,1399
"4383",161253,2004,1,0,"UNIVERSITY OF MAINE",NA,NA,1607,777,830,550,236,314,0.404,0.342,0.284,5040,1414
"4384",161253,2005,1,0,"University of Maine",NA,NA,1703,842,861,615,262,353,0.419,0.361,0.304,5520,1513
"4385",161253,2006,1,0,"University of Maine",NA,NA,1807,875,932,648,296,352,0.402,0.359,0.318,5970,1692
"4386",161253,2007,1,0,"University of Maine",NA,NA,1816,863,953,648,301,347,0.402,0.357,0.316,6540,1583
"4387",161253,2008,1,0,"University of Maine",NA,NA,1931,947,984,717,320,397,0.419,0.371,0.325,7170,1634
"4388",161253,2009,1,0,"University of Maine",NA,NA,1654,756,898,550,288,262,0.347,0.333,0.321,7590,1399
"4389",161253,2010,1,0,"University of Maine",NA,NA,1713,828,885,622,283,339,0.409,0.363,0.32,8010,1447
"4390",161554,1991,1,0,"UNIVERSITY OF SOUTHERN MAINE",NA,NA,763,419,344,68,23,45,0.107,0.089,0.067,2454,737
"4391",161554,1992,1,0,"UNIVERSITY OF SOUTHERN MAINE",NA,NA,682,365,317,51,17,34,0.093,0.075,0.054,2814,659
"4392",161554,1993,1,0,"UNIVERSITY OF SOUTHERN MAINE",NA,NA,732,390,342,48,18,30,0.077,0.066,0.053,3054,699
"4393",161554,1995,1,0,"UNIVERSITY OF SOUTHERN MAINE",NA,NA,620,358,262,66,23,43,0.12,0.106,0.088,3500,606
"4394",161554,1996,1,0,"UNIVERSITY OF SOUTHERN MAINE",NA,NA,683,383,300,56,17,39,0.102,0.082,0.057,3710,664
"4395",161554,1997,1,0,"UNIVERSITY OF SOUTHERN MAINE",NA,NA,760,450,310,90,31,59,0.131,0.118,0.1,3938,732
"4396",161554,1998,1,0,"UNIVERSITY OF SOUTHERN MAINE",NA,NA,789,463,326,66,18,48,0.104,0.084,0.055,4102,765
"4397",161554,1999,1,0,"UNIVERSITY OF SOUTHERN MAINE",NA,NA,815,477,338,96,24,72,0.151,0.118,0.071,3630,777
"4398",161554,2000,1,0,"UNIVERSITY OF SOUTHERN MAINE",NA,NA,855,489,366,81,21,60,0.123,0.095,0.057,3720,825
"4399",161554,2001,1,0,"UNIVERSITY OF SOUTHERN MAINE",NA,NA,922,538,384,93,26,67,0.124,0.101,0.068,3855,897
"4400",161554,2002,1,0,"UNIVERSITY OF SOUTHERN MAINE",NA,NA,895,519,376,118,39,79,0.152,0.132,0.104,4020,863
"4401",161554,2003,1,0,"UNIVERSITY OF SOUTHERN MAINE",NA,NA,851,496,355,106,24,82,0.165,0.125,0.068,4320,816
"4402",161554,2004,1,0,"UNIVERSITY OF SOUTHERN MAINE",NA,NA,871,524,347,146,39,107,0.204,0.168,0.112,4620,793
"4403",161554,2005,1,0,"University of Southern Maine",NA,NA,911,518,393,88,31,57,0.11,0.097,0.079,4980,622
"4404",161554,2006,1,0,"University of Southern Maine",NA,NA,888,511,377,84,25,59,0.116,0.095,0.066,5400,830
"4405",161554,2007,1,0,"University of Southern Maine",NA,NA,900,499,401,87,32,55,0.11,0.097,0.08,5940,738
"4406",161554,2008,1,0,"University of Southern Maine",NA,NA,991,531,460,126,53,73,0.138,0.127,0.115,6540,811
"4407",161554,2009,1,0,"University of Southern Maine",NA,NA,825,447,378,107,27,80,0.179,0.13,0.071,6930,685
"4408",161554,2010,1,0,"University of Southern Maine",NA,NA,763,394,369,104,43,61,0.155,0.136,0.117,7260,632
"4409",162007,1991,1,0,"BOWIE STATE UNIVERSITY",NA,NA,310,189,121,37,7,30,0.159,0.119,0.058,2254,20
"4410",162007,1992,1,0,"BOWIE STATE UNIVERSITY",NA,NA,329,199,130,35,6,29,0.146,0.106,0.046,2514,15
"4411",162007,1993,1,0,"BOWIE STATE UNIVERSITY",NA,NA,257,152,105,30,9,21,0.138,0.117,0.086,2736,6
"4412",162007,1995,1,0,"BOWIE STATE UNIVERSITY",NA,NA,435,260,175,62,11,51,0.196,0.143,0.063,3019,22
"4413",162007,1996,1,0,"BOWIE STATE UNIVERSITY",NA,NA,301,169,132,41,9,32,0.189,0.136,0.068,3103,21
"4414",162007,1997,1,0,"BOWIE STATE UNIVERSITY",NA,NA,357,190,167,44,8,36,0.19,0.123,0.048,3357,18
"4415",162007,1998,1,0,"BOWIE STATE UNIVERSITY",NA,NA,418,225,193,49,7,42,0.187,0.117,0.036,3467,23
"4416",162007,1999,1,0,"BOWIE STATE UNIVERSITY",NA,NA,343,189,154,45,12,33,0.175,0.131,0.078,2828,23
"4417",162007,2000,1,0,"BOWIE STATE UNIVERSITY",NA,NA,361,195,166,47,13,34,0.174,0.13,0.078,2940,10
"4418",162007,2001,1,0,"BOWIE STATE UNIVERSITY",NA,NA,594,356,238,89,21,68,0.191,0.15,0.088,2941,12
"4419",162007,2002,1,0,"BOWIE STATE UNIVERSITY",NA,NA,566,352,214,102,24,78,0.222,0.18,0.112,3102,15
"4420",162007,2003,1,0,"BOWIE STATE UNIVERSITY",NA,NA,762,479,283,98,18,80,0.167,0.129,0.064,3551,18
"4421",162007,2004,1,0,"BOWIE STATE UNIVERSITY",NA,NA,627,408,219,94,16,78,0.191,0.15,0.073,4047,18
"4422",162007,2005,1,0,"Bowie State University",NA,NA,923,567,356,203,53,150,0.265,0.22,0.149,4286,21
"4423",162007,2006,1,0,"Bowie State University",NA,NA,765,475,290,83,20,63,0.133,0.108,0.069,4286,6
"4424",162007,2007,1,0,"Bowie State University",NA,NA,820,506,314,106,19,87,0.172,0.129,0.061,4286,10
"4425",162007,2008,1,0,"Bowie State University",NA,NA,664,393,271,52,12,40,0.102,0.078,0.044,4286,11
"4426",162007,2009,1,0,"Bowie State University",NA,NA,635,401,234,71,18,53,0.132,0.112,0.077,4286,8
"4427",162007,2010,1,0,"Bowie State University",NA,NA,608,353,255,73,17,56,0.159,0.12,0.067,4415,9
"4428",162210,1991,1,0,"COLUMBIA UNION COLLEGE",NA,NA,78,45,33,19,6,13,0.289,0.244,0.182,8200,39
"4429",162210,1992,1,0,"COLUMBIA UNION COLLEGE",NA,NA,69,46,23,12,1,11,0.239,0.174,0.043,9180,24
"4430",162210,1993,1,0,"COLUMBIA UNION COLLEGE",NA,NA,94,52,42,17,7,10,0.192,0.181,0.167,9500,27
"4431",162210,1995,1,0,"COLUMBIA UNION COLLEGE",NA,NA,137,84,53,24,9,15,0.179,0.175,0.17,10775,82
"4432",162210,1996,1,0,"COLUMBIA UNION COLLEGE",NA,NA,154,79,75,20,6,14,0.177,0.13,0.08,11240,52
"4433",162210,1997,1,0,"COLUMBIA UNION COLLEGE",NA,NA,164,99,65,34,11,23,0.232,0.207,0.169,11790,67
"4434",162210,1998,1,0,"COLUMBIA UNION COLLEGE",NA,NA,140,67,73,17,7,10,0.149,0.121,0.096,12275,64
"4435",162210,1999,1,0,"COLUMBIA UNION COLLEGE",NA,NA,175,115,60,25,6,19,0.165,0.143,0.1,12200,63
"4436",162210,2000,1,0,"COLUMBIA UNION COLLEGE",NA,NA,158,89,69,22,4,18,0.202,0.139,0.058,12810,41
"4437",162210,2001,1,0,"COLUMBIA UNION COLLEGE",NA,NA,153,95,58,26,3,23,0.242,0.17,0.052,13450,52
"4438",162210,2002,1,0,"COLUMBIA UNION COLLEGE",NA,NA,176,104,72,17,2,15,0.144,0.097,0.028,13998,36
"4439",162210,2003,1,0,"COLUMBIA UNION COLLEGE",NA,NA,187,120,67,24,6,18,0.15,0.128,0.09,14698,30
"4440",162210,2004,1,0,"COLUMBIA UNION COLLEGE",NA,NA,208,130,78,26,4,22,0.169,0.125,0.051,15433,37
"4441",162210,2005,1,0,"Columbia Union College",NA,NA,172,113,59,23,9,14,0.124,0.134,0.153,16514,23
"4442",162210,2006,1,0,"Columbia Union College",NA,NA,144,84,60,18,5,13,0.155,0.125,0.083,17339,23
"4443",162210,2007,1,0,"Columbia Union College",NA,NA,126,83,43,22,5,17,0.205,0.175,0.116,18200,17
"4444",162210,2008,1,0,"Columbia Union College",NA,NA,98,61,37,16,4,12,0.197,0.163,0.108,18200,9
"4445",162210,2009,1,0,"Washington Adventist University",NA,NA,144,83,61,21,7,14,0.169,0.146,0.115,18200,16
"4446",162210,2010,1,0,"Washington Adventist University",NA,NA,123,83,40,21,2,19,0.229,0.171,0.05,18900,19
"4447",162283,1991,1,0,"COPPIN STATE COLLEGE",NA,NA,311,195,116,29,6,23,0.118,0.093,0.052,2281,19
"4448",162283,1992,1,0,"COPPIN STATE COLLEGE",NA,NA,350,183,167,14,1,13,0.071,0.04,0.006,2533,12
"4449",162283,1993,1,0,"COPPIN STATE COLLEGE",NA,NA,500,264,236,26,6,20,0.076,0.052,0.025,2605,33
"4450",162283,1995,1,0,"COPPIN STATE COLLEGE",NA,NA,439,303,136,31,8,23,0.076,0.071,0.059,2749,1
"4451",162283,1996,1,0,"COPPIN STATE COLLEGE",NA,NA,513,357,156,33,11,22,0.062,0.064,0.071,2867,8
"4452",162283,1997,1,0,"COPPIN STATE COLLEGE",NA,NA,382,268,114,17,3,14,0.052,0.045,0.026,3012,7
"4453",162283,1998,1,0,"COPPIN STATE COLLEGE",NA,NA,457,337,120,32,10,22,0.065,0.07,0.083,3164,7
"4454",162283,1999,1,0,"COPPIN STATE COLLEGE",NA,NA,441,306,135,39,12,27,0.088,0.088,0.089,3261,2
"4455",162283,2000,1,0,"COPPIN STATE COLLEGE",NA,NA,417,289,128,20,4,16,0.055,0.048,0.031,2503,1
"4456",162283,2001,1,0,"COPPIN STATE COLLEGE",NA,NA,540,384,156,36,4,32,0.083,0.067,0.026,2856,4
"4457",162283,2002,1,0,"COPPIN STATE COLLEGE",NA,NA,578,430,148,30,3,27,0.063,0.052,0.02,2877,1
"4458",162283,2003,1,0,"COPPIN STATE COLLEGE",NA,NA,571,432,139,29,9,20,0.046,0.051,0.065,3142,4
"4459",162283,2004,1,0,"COPPIN STATE UNIVERSITY",NA,NA,588,446,142,27,5,22,0.049,0.046,0.035,3330,2
"4460",162283,2005,1,0,"Coppin State University",NA,NA,661,502,159,24,4,20,0.04,0.036,0.025,4530,0
"4461",162283,2006,1,0,"Coppin State University",NA,NA,494,390,104,28,3,25,0.064,0.057,0.029,3527,2
"4462",162283,2007,1,0,"Coppin State University",NA,NA,555,421,134,23,9,14,0.033,0.041,0.067,3527,0
"4463",162283,2008,1,0,"Coppin State University",NA,NA,570,428,142,28,6,22,0.051,0.049,0.042,3527,0
"4464",162283,2009,1,0,"Coppin State University",NA,NA,541,392,149,29,2,27,0.069,0.054,0.013,3527,1
"4465",162283,2010,1,0,"Coppin State University",NA,NA,511,357,154,29,7,22,0.062,0.057,0.045,3633,9
"4466",162584,1991,1,0,"FROSTBURG STATE UNIVERSITY",NA,NA,762,381,381,187,67,120,0.315,0.245,0.176,2247,654
"4467",162584,1992,1,0,"FROSTBURG STATE UNIVERSITY",NA,NA,839,454,385,236,68,168,0.37,0.281,0.177,2396,735
"4468",162584,1993,1,0,"FROSTBURG STATE UNIVERSITY",NA,NA,910,433,477,210,87,123,0.284,0.231,0.182,2666,779
"4469",162584,1995,1,0,"FROSTBURG STATE UNIVERSITY",NA,NA,909,433,476,194,68,126,0.291,0.213,0.143,3072,783
"4470",162584,1996,1,0,"FROSTBURG STATE UNIVERSITY",NA,NA,975,482,493,195,70,125,0.259,0.2,0.142,3290,793
"4471",162584,1997,1,0,"FROSTBURG STATE UNIVERSITY",NA,NA,865,444,421,210,71,139,0.313,0.243,0.169,3544,720
"4472",162584,1998,1,0,"FROSTBURG STATE UNIVERSITY",NA,NA,932,486,446,181,66,115,0.237,0.194,0.148,3776,721
"4473",162584,1999,1,0,"FROSTBURG STATE UNIVERSITY",NA,NA,932,508,424,165,52,113,0.222,0.177,0.123,3216,714
"4474",162584,2000,1,0,"FROSTBURG STATE UNIVERSITY",NA,NA,1028,499,529,199,64,135,0.27,0.194,0.121,3342,796
"4475",162584,2001,1,0,"FROSTBURG STATE UNIVERSITY",NA,NA,923,471,452,204,65,139,0.295,0.221,0.144,3444,740
"4476",162584,2002,1,0,"FROSTBURG STATE UNIVERSITY",NA,NA,999,492,507,220,67,153,0.311,0.22,0.132,3632,800
"4477",162584,2003,1,0,"FROSTBURG STATE UNIVERSITY",NA,NA,988,450,538,216,85,131,0.291,0.219,0.158,4316,781
"4478",162584,2004,1,0,"FROSTBURG STATE UNIVERSITY",NA,NA,955,427,528,207,78,129,0.302,0.217,0.148,4720,739
"4479",162584,2005,1,0,"Frostburg State University",NA,NA,928,448,480,181,60,121,0.27,0.195,0.125,5000,654
"4480",162584,2006,1,0,"Frostburg State University",NA,NA,1011,459,552,175,65,110,0.24,0.173,0.118,5000,702
"4481",162584,2007,1,0,"Frostburg State University",NA,NA,1057,520,537,233,92,141,0.271,0.22,0.171,5000,680
"4482",162584,2008,1,0,"Frostburg State University",NA,NA,1030,478,552,201,86,115,0.241,0.195,0.156,5000,653
"4483",162584,2009,1,0,"Frostburg State University",NA,NA,1028,505,523,217,67,150,0.297,0.211,0.128,5000,606
"4484",162584,2010,1,0,"Frostburg State University",NA,NA,1028,472,556,223,93,130,0.275,0.217,0.167,5150,649
"4485",162654,1991,1,0,"GOUCHER COLLEGE",NA,NA,203,142,61,121,31,90,0.634,0.596,0.508,12685,167
"4486",162654,1992,1,0,"GOUCHER COLLEGE",NA,NA,223,155,68,131,27,104,0.671,0.587,0.397,13446,184
"4487",162654,1993,1,0,"GOUCHER COLLEGE",NA,NA,242,168,74,138,34,104,0.619,0.57,0.459,14300,177
"4488",162654,1995,1,0,"GOUCHER COLLEGE",NA,NA,277,193,84,154,41,113,0.586,0.556,0.488,16630,196
"4489",162654,1996,1,0,"GOUCHER COLLEGE",NA,NA,268,188,80,165,38,127,0.675,0.616,0.475,17635,194
"4490",162654,1997,1,0,"GOUCHER COLLEGE",NA,NA,335,255,80,212,49,163,0.639,0.633,0.613,18525,250
"4491",162654,1998,1,0,"GOUCHER COLLEGE",NA,NA,302,213,89,169,36,133,0.624,0.56,0.404,19565,233
"4492",162654,1999,1,0,"GOUCHER COLLEGE",NA,NA,322,224,98,176,54,122,0.545,0.547,0.551,20200,222
"4493",162654,2000,1,0,"GOUCHER COLLEGE",NA,NA,365,258,107,227,57,170,0.659,0.622,0.533,21000,218
"4494",162654,2001,1,0,"GOUCHER COLLEGE",NA,NA,341,247,94,197,45,152,0.615,0.578,0.479,22000,203
"4495",162654,2002,1,0,"GOUCHER COLLEGE",NA,NA,365,265,100,208,48,160,0.604,0.57,0.48,22950,211
"4496",162654,2003,1,0,"GOUCHER COLLEGE",NA,NA,342,207,135,207,60,147,0.71,0.605,0.444,24150,246
"4497",162654,2004,1,0,"GOUCHER COLLEGE",NA,NA,401,270,131,241,62,179,0.663,0.601,0.473,25570,282
"4498",162654,2005,1,0,"Goucher College",NA,NA,340,217,123,210,68,142,0.654,0.618,0.553,27100,241
"4499",162654,2006,1,0,"Goucher College",NA,NA,450,303,147,255,70,185,0.611,0.567,0.476,28900,324
"4500",162654,2007,1,0,"Goucher College",NA,NA,399,277,122,236,67,169,0.61,0.591,0.549,30636,299
"4501",162654,2008,1,0,"Goucher College",NA,NA,360,262,98,205,54,151,0.576,0.569,0.551,32168,225
"4502",162654,2009,1,0,"Goucher College",NA,NA,398,276,122,227,53,174,0.63,0.57,0.434,33294,255
"4503",162654,2010,1,0,"Goucher College",NA,NA,388,259,129,185,50,135,0.521,0.477,0.388,34626,271
"4504",162760,1991,1,0,"HOOD COLLEGE",NA,NA,145,143,2,70,1,69,0.482,0.483,0.5,12208,85
"4505",162760,1992,1,0,"HOOD COLLEGE",NA,NA,150,143,7,91,4,87,0.608,0.607,0.571,12208,92
"4506",162760,1993,1,0,"HOOD COLLEGE",NA,NA,163,161,2,102,0,102,0.634,0.626,0,13258,108
"4507",162760,1995,1,0,"HOOD COLLEGE",NA,NA,177,172,5,103,2,101,0.587,0.582,0.4,14930,117
"4508",162760,1996,1,0,"HOOD COLLEGE",NA,NA,129,128,1,73,0,73,0.57,0.566,0,15522,74
"4509",162760,1997,1,0,"HOOD COLLEGE",NA,NA,162,158,4,109,3,106,0.671,0.673,0.75,16418,105
"4510",162760,1998,1,0,"HOOD COLLEGE",NA,NA,149,144,5,97,2,95,0.66,0.651,0.4,17010,80
"4511",162760,1999,1,0,"HOOD COLLEGE",NA,NA,156,152,4,100,1,99,0.651,0.641,0.25,17275,85
"4512",162760,2000,1,0,"HOOD COLLEGE",NA,NA,131,128,3,90,3,87,0.68,0.687,1,18295,85
"4513",162760,2001,1,0,"HOOD COLLEGE",NA,NA,112,110,2,76,2,74,0.673,0.679,1,18795,83
"4514",162760,2002,1,0,"HOOD COLLEGE",NA,NA,179,172,7,108,3,105,0.61,0.603,0.429,19360,114
"4515",162760,2003,1,0,"HOOD COLLEGE",NA,NA,181,143,38,110,20,90,0.629,0.608,0.526,19940,113
"4516",162760,2004,1,0,"HOOD COLLEGE",NA,NA,242,189,53,160,31,129,0.682,0.661,0.585,20940,183
"4517",162760,2005,1,0,"Hood College",NA,NA,236,156,80,142,44,98,0.628,0.602,0.55,22000,169
"4518",162760,2006,1,0,"Hood College",NA,NA,278,185,93,137,38,99,0.535,0.493,0.409,23320,201
"4519",162760,2007,1,0,"Hood College",NA,NA,295,193,102,163,48,115,0.596,0.553,0.471,24720,211
"4520",162760,2008,1,0,"Hood College",NA,NA,308,200,108,179,57,122,0.61,0.581,0.528,26200,220
"4521",162760,2009,1,0,"Hood College",NA,NA,251,168,83,136,46,90,0.536,0.542,0.554,27770,164
"4522",162760,2010,1,0,"Hood College",NA,NA,327,210,117,165,52,113,0.538,0.505,0.444,29440,217
"4523",162928,1991,1,0,"JOHNS HOPKINS UNIVERSITY",NA,NA,846,304,542,707,444,263,0.865,0.836,0.819,16400,582
"4524",162928,1992,1,0,"JOHNS HOPKINS UNIVERSITY",NA,NA,847,325,522,685,402,283,0.871,0.809,0.77,17420,586
"4525",162928,1993,1,0,"JOHNS HOPKINS UNIVERSITY",NA,NA,64,32,32,37,16,21,0.656,0.578,0.5,17900,43
"4526",162928,1995,1,0,"JOHNS HOPKINS UNIVERSITY",NA,NA,873,332,541,683,401,282,0.849,0.782,0.741,19750,584
"4527",162928,1996,1,0,"JOHNS HOPKINS UNIVERSITY",NA,NA,1018,408,610,826,483,343,0.841,0.811,0.792,20740,646
"4528",162928,1997,1,0,"JOHNS HOPKINS UNIVERSITY",NA,NA,941,411,530,749,411,338,0.822,0.796,0.775,21700,620
"4529",162928,1998,1,0,"JOHNS HOPKINS UNIVERSITY",NA,NA,1077,467,610,864,469,395,0.846,0.802,0.769,22680,719
"4530",162928,1999,1,0,"JOHNS HOPKINS UNIVERSITY",NA,NA,1098,441,657,868,503,365,0.828,0.791,0.766,23660,760
"4531",162928,2000,1,0,"JOHNS HOPKINS UNIVERSITY",NA,NA,1067,456,611,876,483,393,0.862,0.821,0.791,24930,684
"4532",162928,2001,1,0,"JOHNS HOPKINS UNIVERSITY",NA,NA,1077,435,642,884,510,374,0.86,0.821,0.794,26210,729
"4533",162928,2002,1,0,"JOHNS HOPKINS UNIVERSITY",NA,NA,1203,539,664,960,501,459,0.852,0.798,0.755,27390,766
"4534",162928,2003,1,0,"JOHNS HOPKINS UNIVERSITY",NA,NA,1122,499,623,919,488,431,0.864,0.819,0.783,28730,706
"4535",162928,2004,1,0,"JOHNS HOPKINS UNIVERSITY",NA,NA,1127,525,602,928,480,448,0.853,0.823,0.797,30140,661
"4536",162928,2005,1,0,"Johns Hopkins University",NA,NA,1228,587,641,1036,523,513,0.874,0.844,0.816,31620,774
"4537",162928,2006,1,0,"Johns Hopkins University",NA,NA,1304,643,661,1127,563,564,0.877,0.864,0.852,33900,786
"4538",162928,2007,1,0,"Johns Hopkins University",NA,NA,1260,607,653,1095,545,550,0.906,0.869,0.835,35900,675
"4539",162928,2008,1,0,"Johns Hopkins University",NA,NA,1315,612,703,1140,587,553,0.904,0.867,0.835,37700,693
"4540",162928,2009,1,0,"Johns Hopkins University",NA,NA,1427,663,764,1240,643,597,0.9,0.869,0.842,39150,703
"4541",162928,2010,1,0,"Johns Hopkins University",NA,NA,1322,646,676,1150,577,573,0.887,0.87,0.854,40680,744
"4542",163046,1991,1,0,"LOYOLA COLLEGE",NA,NA,700,400,300,475,171,304,0.76,0.679,0.57,10490,617
"4543",163046,1992,1,0,"LOYOLA COLLEGE",NA,NA,792,452,340,565,229,336,0.743,0.713,0.674,11270,690
"4544",163046,1993,1,0,"LOYOLA COLLEGE",NA,NA,739,436,303,515,181,334,0.766,0.697,0.597,12165,672
"4545",163046,1995,1,0,"LOYOLA COLLEGE",NA,NA,798,450,348,581,240,341,0.758,0.728,0.69,14260,687
"4546",163046,1996,1,0,"LOYOLA COLLEGE",NA,NA,812,443,369,592,245,347,0.783,0.729,0.664,15460,707
"4547",163046,1997,1,0,"LOYOLA COLLEGE",NA,NA,833,478,355,650,258,392,0.82,0.78,0.727,16560,734
"4548",163046,1998,1,0,"LOYOLA COLLEGE",NA,NA,854,485,369,668,276,392,0.808,0.782,0.748,18460,741
"4549",163046,1999,1,0,"LOYOLA COLLEGE",NA,NA,941,530,411,734,292,442,0.834,0.78,0.71,19660,853
"4550",163046,2000,1,0,"LOYOLA COLLEGE",NA,NA,909,520,389,699,277,422,0.812,0.769,0.712,21230,818
"4551",163046,2001,1,0,"LOYOLA COLLEGE",NA,NA,880,517,363,679,252,427,0.826,0.772,0.694,21462,796
"4552",163046,2002,1,0,"LOYOLA COLLEGE",NA,NA,901,527,374,733,295,438,0.831,0.814,0.789,23200,781
"4553",163046,2003,1,0,"LOYOLA COLLEGE IN MARYLAND",NA,NA,915,545,370,704,277,427,0.783,0.769,0.749,25140,796
"4554",163046,2004,1,0,"LOYOLA COLLEGE IN MARYLAND",NA,NA,951,579,372,726,277,449,0.775,0.763,0.745,26803,825
"4555",163046,2005,1,0,"Loyola College in Maryland",NA,NA,898,526,372,711,291,420,0.798,0.792,0.782,28683,757
"4556",163046,2006,1,0,"Loyola College in Maryland",NA,NA,946,596,350,749,263,486,0.815,0.792,0.751,30615,818
"4557",163046,2007,1,0,"Loyola College in Maryland",NA,NA,979,545,434,777,320,457,0.838,0.794,0.737,32838,823
"4558",163046,2008,1,0,"Loyola College in Maryland",NA,NA,1066,637,429,825,307,518,0.813,0.774,0.716,35055,896
"4559",163046,2009,1,0,"Loyola University Maryland",NA,NA,968,592,376,740,275,465,0.785,0.764,0.731,36510,831
"4560",163046,2010,1,0,"Loyola University-Baltimore",NA,NA,1019,630,389,818,311,507,0.805,0.803,0.799,37950,838
"4561",163268,1991,1,0,"UNIVERSITY OF MARYLAND BALTIMORE COUNTY CAMPUS",NA,NA,910,467,443,185,71,114,0.244,0.203,0.16,2672,558
"4562",163268,1992,1,0,"UNIVERSITY OF MARYLAND BALTIMORE COUNTY CAMPUS",NA,NA,884,437,447,200,79,121,0.277,0.226,0.177,2856,599
"4563",163268,1993,1,0,"UNIVERSITY OF MARYLAND BALTIMORE COUNTY",NA,NA,929,419,510,215,97,118,0.282,0.231,0.19,3338,646
"4564",163268,1995,1,0,"UNIVERSITY OF MARYLAND-BALTIMORE COUNTY",NA,NA,968,485,483,295,115,180,0.371,0.305,0.238,3852,601
"4565",163268,1996,1,0,"UNIVERSITY OF MARYLAND-BALTIMORE COUNTY",NA,NA,1005,505,500,280,106,174,0.345,0.279,0.212,4136,638
"4566",163268,1997,1,0,"UNIVERSITY OF MARYLAND-BALTIMORE COUNTY",NA,NA,1135,605,530,343,133,210,0.347,0.302,0.251,4570,658
"4567",163268,1998,1,0,"UNIVERSITY OF MARYLAND-BALTIMORE COUNTY",NA,NA,1246,609,637,347,138,209,0.343,0.278,0.217,4846,746
"4568",163268,1999,1,0,"UNIVERSITY OF MARYLAND-BALTIMORE COUNTY",NA,NA,1396,638,758,417,188,229,0.359,0.299,0.248,4046,855
"4569",163268,2000,1,0,"UNIVERSITY OF MARYLAND-BALTIMORE COUNTY",NA,NA,1307,601,706,362,150,212,0.353,0.277,0.212,4206,794
"4570",163268,2001,1,0,"UNIVERSITY OF MARYLAND-BALTIMORE COUNTY",NA,NA,1332,603,729,461,204,257,0.426,0.346,0.28,4374,827
"4571",163268,2002,1,0,"UNIVERSITY OF MARYLAND-BALTIMORE COUNTY",NA,NA,1356,572,784,437,210,227,0.397,0.322,0.268,4614,856
"4572",163268,2003,1,0,"UNIVERSITY OF MARYLAND-BALTIMORE COUNTY",NA,NA,1487,657,830,506,215,291,0.443,0.34,0.259,5570,881
"4573",163268,2004,1,0,"UNIVERSITY OF MARYLAND-BALTIMORE COUNTY",NA,NA,1403,560,843,472,249,223,0.398,0.336,0.295,6120,864
"4574",163268,2005,1,0,"University of Maryland-Baltimore County",NA,NA,1414,584,830,466,237,229,0.392,0.33,0.286,6484,818
"4575",163268,2006,1,0,"University of Maryland-Baltimore County",NA,NA,1419,626,793,523,233,290,0.463,0.369,0.294,6484,756
"4576",163268,2007,1,0,"University of Maryland-Baltimore County",NA,NA,1423,655,768,523,230,293,0.447,0.368,0.299,6484,740
"4577",163268,2008,1,0,"University of Maryland-Baltimore County",NA,NA,1555,650,905,531,237,294,0.452,0.341,0.262,6484,774
"4578",163268,2009,1,0,"University of Maryland-Baltimore County",NA,NA,1522,656,866,574,257,317,0.483,0.377,0.297,6484,797
"4579",163268,2010,1,0,"University of Maryland-Baltimore County",NA,NA,1484,599,885,558,275,283,0.473,0.376,0.311,6679,735
"4580",163286,1991,1,0,"UNIVERSITY OF MARYLAND COLLEGE PARK CAMPUS",NA,NA,3069,1406,1663,928,361,567,0.403,0.302,0.217,2429,2003
"4581",163286,1992,1,0,"UNIVERSITY OF MARYLAND COLLEGE PARK CAMPUS",NA,NA,3032,1470,1562,966,379,587,0.399,0.319,0.243,2778,2002
"4582",163286,1993,1,0,"UNIVERSITY OF MARYLAND COLLEGE PARK CAMPUS",NA,NA,3153,1461,1692,1051,447,604,0.413,0.333,0.264,3179,1920
"4583",163286,1995,1,0,"UNIVERSITY OF MARYLAND COLLEGE PARK CAMPUS",NA,NA,3577,1722,1855,1343,539,804,0.467,0.375,0.291,3794,2188
"4584",163286,1996,1,0,"UNIVERSITY OF MARYLAND COLLEGE PARK CAMPUS",NA,NA,3539,1720,1819,1449,585,864,0.502,0.409,0.322,4169,2198
"4585",163286,1997,1,0,"UNIVERSITY OF MARYLAND-COLLEGE PARK",NA,NA,3950,1873,2077,1699,731,968,0.517,0.43,0.352,4460,2449
"4586",163286,1998,1,0,"UNIVERSITY OF MARYLAND-COLLEGE PARK",NA,NA,4039,2007,2032,1858,801,1057,0.527,0.46,0.394,4699,2528
"4587",163286,1999,1,0,"UNIVERSITY OF MARYLAND-COLLEGE PARK",NA,NA,3871,1796,2075,1943,884,1059,0.59,0.502,0.426,4050,2447
"4588",163286,2000,1,0,"UNIVERSITY OF MARYLAND-COLLEGE PARK",NA,NA,3929,1896,2033,2141,933,1208,0.637,0.545,0.459,4172,2463
"4589",163286,2001,1,0,"UNIVERSITY OF MARYLAND-COLLEGE PARK",NA,NA,4341,2063,2278,2535,1169,1366,0.662,0.584,0.513,4334,2755
"4590",163286,2002,1,0,"UNIVERSITY OF MARYLAND-COLLEGE PARK",NA,NA,3886,1961,1925,2452,1128,1324,0.675,0.631,0.586,4572,2493
"4591",163286,2003,1,0,"UNIVERSITY OF MARYLAND-COLLEGE PARK",NA,NA,4045,2031,2014,2539,1158,1381,0.68,0.628,0.575,5568,2444
"4592",163286,2004,1,0,"UNIVERSITY OF MARYLAND-COLLEGE PARK",NA,NA,4174,2055,2119,2607,1173,1434,0.698,0.625,0.554,6200,2435
"4593",163286,2005,1,0,"University of Maryland-College Park",NA,NA,4192,2081,2111,2769,1273,1496,0.719,0.661,0.603,6566,2421
"4594",163286,2006,1,0,"University of Maryland-College Park",NA,NA,3944,1896,2048,2493,1179,1314,0.693,0.632,0.576,6566,2189
"4595",163286,2007,1,0,"University of Maryland-College Park",NA,NA,4229,2028,2201,2772,1300,1472,0.726,0.655,0.591,6566,2566
"4596",163286,2008,1,0,"University of Maryland-College Park",NA,NA,3907,1824,2083,2610,1298,1312,0.719,0.668,0.623,6566,2287
"4597",163286,2009,1,0,"University of Maryland-College Park",NA,NA,4199,1953,2246,2912,1448,1464,0.75,0.693,0.645,6566,2630
"4598",163286,2010,1,0,"University of Maryland-College Park",NA,NA,3930,1856,2074,2700,1314,1386,0.747,0.687,0.634,6763,2175
"4599",163453,1991,1,0,"MORGAN STATE UNIVERSITY",NA,NA,919,552,367,139,29,110,0.199,0.151,0.079,2198,6
"4600",163453,1992,1,0,"MORGAN STATE UNIVERSITY",NA,NA,967,572,395,168,37,131,0.229,0.174,0.094,2438,7
"4601",163453,1993,1,0,"MORGAN STATE UNIVERSITY",NA,NA,944,567,377,138,26,112,0.198,0.146,0.069,2526,12
"4602",163453,1995,1,0,"MORGAN STATE UNIVERSITY",NA,NA,959,580,379,166,30,136,0.234,0.173,0.079,2832,9
"4603",163453,1996,1,0,"MORGAN STATE UNIVERSITY",NA,NA,917,546,371,162,27,135,0.247,0.177,0.073,3126,5
"4604",163453,1997,1,0,"MORGAN STATE UNIVERSITY",NA,NA,1016,588,428,176,30,146,0.248,0.173,0.07,3412,7
"4605",163453,1998,1,0,"MORGAN STATE UNIVERSITY",NA,NA,1136,674,462,166,42,124,0.184,0.146,0.091,3706,6
"4606",163453,1999,1,0,"MORGAN STATE UNIVERSITY",NA,NA,1152,661,491,208,41,167,0.253,0.181,0.084,2906,6
"4607",163453,2000,1,0,"MORGAN STATE UNIVERSITY",NA,NA,1107,689,418,204,60,144,0.209,0.184,0.144,3030,4
"4608",163453,2001,1,0,"MORGAN STATE UNIVERSITY",NA,NA,1125,663,462,172,39,133,0.201,0.153,0.084,3150,2
"4609",163453,2002,1,0,"MORGAN STATE UNIVERSITY",NA,NA,1247,741,506,139,26,113,0.152,0.111,0.051,4698,6
"4610",163453,2003,1,0,"MORGAN STATE UNIVERSITY",NA,NA,1220,699,521,138,34,104,0.149,0.113,0.065,5078,5
"4611",163453,2004,1,0,"MORGAN STATE UNIVERSITY",NA,NA,1336,750,586,153,32,121,0.161,0.115,0.055,4000,10
"4612",163453,2005,1,0,"Morgan State University",NA,NA,764,408,356,89,22,67,0.164,0.116,0.062,4280,8
"4613",163453,2006,1,0,"Morgan State University",NA,NA,1368,773,595,165,46,119,0.154,0.121,0.077,4280,13
"4614",163453,2007,1,0,"Morgan State University",NA,NA,1286,698,588,143,42,101,0.145,0.111,0.071,4280,10
"4615",163453,2008,1,0,"Morgan State University",NA,NA,1430,808,622,169,46,123,0.152,0.118,0.074,4280,14
"4616",163453,2009,1,0,"Morgan State University",NA,NA,1261,715,546,121,35,86,0.12,0.096,0.064,4280,11
"4617",163453,2010,1,0,"Morgan State University",NA,NA,1208,663,545,115,32,83,0.125,0.095,0.059,4408,5
"4618",163462,1991,1,0,"MOUNT SAINT MARYS COLLEGE",NA,NA,320,170,150,195,85,110,0.647,0.609,0.567,9875,289
"4619",163462,1992,1,0,"MOUNT SAINT MARYS COLLEGE",NA,NA,346,190,156,209,89,120,0.632,0.604,0.571,10675,310
"4620",163462,1993,1,0,"MOUNT SAINT MARYS COLLEGE",NA,NA,325,166,159,218,99,119,0.717,0.671,0.623,11725,287
"4621",163462,1995,1,0,"MOUNT SAINT MARYS COLLEGE",NA,NA,315,169,146,205,95,110,0.651,0.651,0.651,14120,272
"4622",163462,1996,1,0,"MOUNT SAINT MARYS COLLEGE",NA,NA,367,207,160,214,80,134,0.647,0.583,0.5,14885,307
"4623",163462,1997,1,0,"MOUNT SAINT MARYS COLLEGE",NA,NA,325,179,146,221,95,126,0.704,0.68,0.651,15650,277
"4624",163462,1998,1,0,"MOUNT SAINT MARYS COLLEGE",NA,NA,410,213,197,249,113,136,0.639,0.607,0.574,16100,345
"4625",163462,1999,1,0,"MOUNT SAINT MARYS COLLEGE",NA,NA,369,221,148,238,94,144,0.652,0.645,0.635,16520,319
"4626",163462,2000,1,0,"MOUNT SAINT MARYS COLLEGE",NA,NA,383,223,160,255,109,146,0.655,0.666,0.681,17200,326
"4627",163462,2001,1,0,"MOUNT SAINT MARYS COLLEGE",NA,NA,355,197,158,230,105,125,0.635,0.648,0.665,18480,316
"4628",163462,2002,1,0,"MOUNT SAINT MARYS COLLEGE",NA,NA,399,211,188,233,97,136,0.645,0.584,0.516,19700,346
"4629",163462,2003,1,0,"MOUNT SAINT MARYS COLLEGE",NA,NA,395,237,158,279,110,169,0.713,0.706,0.696,20800,347
"4630",163462,2004,1,0,"MOUNT ST MARY'S UNIVERSITY",NA,NA,391,243,148,270,99,171,0.704,0.691,0.669,21430,323
"4631",163462,2005,1,0,"Mount St Mary's University",NA,NA,437,267,170,315,127,188,0.704,0.721,0.747,22500,363
"4632",163462,2006,1,0,"Mount St Mary's University",NA,NA,426,244,182,265,97,168,0.689,0.622,0.533,23630,347
"4633",163462,2007,1,0,"Mount St Mary's University",NA,NA,448,256,192,275,114,161,0.629,0.614,0.594,25290,363
"4634",163462,2008,1,0,"Mount St Mary's University",NA,NA,410,218,192,236,99,137,0.628,0.576,0.516,26960,325
"4635",163462,2009,1,0,"Mount St. Mary's University",NA,NA,464,268,196,298,126,172,0.642,0.642,0.643,28420,353
"4636",163462,2010,1,0,"Mount St Mary's University",NA,NA,424,241,183,275,101,174,0.722,0.649,0.552,29650,307
"4637",163851,1991,1,0,"SALISBURY STATE UNIVERSITY",NA,NA,711,387,324,293,99,194,0.501,0.412,0.306,2544,658
"4638",163851,1992,1,0,"SALISBURY STATE UNIVERSITY",NA,NA,634,372,262,264,78,186,0.5,0.416,0.298,2754,569
"4639",163851,1993,1,0,"SALISBURY STATE UNIVERSITY",NA,NA,726,405,321,297,92,205,0.506,0.409,0.287,3026,653
"4640",163851,1995,1,0,"SALISBURY STATE UNIVERSITY",NA,NA,642,412,230,322,101,221,0.536,0.502,0.439,3440,591
"4641",163851,1996,1,0,"SALISBURY STATE UNIVERSITY",NA,NA,689,393,296,311,98,213,0.542,0.451,0.331,3608,611
"4642",163851,1997,1,0,"SALISBURY STATE UNIVERSITY",NA,NA,886,515,371,418,133,285,0.553,0.472,0.358,3842,818
"4643",163851,1998,1,0,"SALISBURY STATE UNIVERSITY",NA,NA,935,534,401,438,139,299,0.56,0.468,0.347,4002,778
"4644",163851,1999,1,0,"SALISBURY STATE UNIVERSITY",NA,NA,877,537,340,458,149,309,0.575,0.522,0.438,2856,765
"4645",163851,2000,1,0,"SALISBURY STATE UNIVERSITY",NA,NA,939,546,393,488,163,325,0.595,0.52,0.415,3092,827
"4646",163851,2001,1,0,"SALISBURY UNIVERSITY",NA,NA,945,542,403,429,135,294,0.542,0.454,0.335,3216,749
"4647",163851,2002,1,0,"SALISBURY UNIVERSITY",NA,NA,908,529,379,417,121,296,0.559,0.459,0.319,3394,722
"4648",163851,2003,1,0,"SALISBURY UNIVERSITY",NA,NA,947,531,416,433,142,291,0.548,0.457,0.341,4134,714
"4649",163851,2004,1,0,"SALISBURY UNIVERSITY",NA,NA,981,536,445,457,148,309,0.577,0.466,0.333,4546,797
"4650",163851,2005,1,0,"Salisbury University",NA,NA,952,525,427,442,146,296,0.564,0.464,0.342,4814,786
"4651",163851,2006,1,0,"Salisbury University",NA,NA,1028,588,440,502,171,331,0.563,0.488,0.389,4814,822
"4652",163851,2007,1,0,"Salisbury University",NA,NA,1142,646,496,533,172,361,0.559,0.467,0.347,4814,926
"4653",163851,2008,1,0,"Salisbury University",NA,NA,1198,694,504,533,151,382,0.55,0.445,0.3,4814,994
"4654",163851,2009,1,0,"Salisbury University",NA,NA,1273,738,535,577,169,408,0.553,0.453,0.316,4814,1032
"4655",163851,2010,1,0,"Salisbury University",NA,NA,1248,770,478,595,176,419,0.544,0.477,0.368,4960,949
"4656",163912,1991,1,0,"SAINT MARYS COLLEGE OF MARYLAND",NA,NA,227,132,95,147,51,96,0.727,0.648,0.537,3210,178
"4657",163912,1992,1,0,"SAINT MARYS COLLEGE OF MARYLAND",NA,NA,234,133,101,129,53,76,0.571,0.551,0.525,3880,185
"4658",163912,1993,1,0,"SAINT MARYS COLLEGE OF MARYLAND",NA,NA,284,153,131,166,68,98,0.64,0.585,0.519,4400,225
"4659",163912,1995,1,0,"SAINT MARYS COLLEGE OF MARYLAND",NA,NA,352,201,151,207,81,126,0.627,0.588,0.536,5435,289
"4660",163912,1996,1,0,"SAINT MARYS COLLEGE OF MARYLAND",NA,NA,312,180,132,221,93,128,0.711,0.708,0.705,6005,253
"4661",163912,1997,1,0,"SAINT MARYS COLLEGE OF MARYLAND",NA,NA,345,194,151,232,92,140,0.722,0.672,0.609,6575,286
"4662",163912,1998,1,0,"SAINT MARYS COLLEGE OF MARYLAND",NA,NA,331,181,150,211,77,134,0.74,0.637,0.513,6875,264
"4663",163912,1999,1,0,"ST MARY'S COLLEGE OF MARYLAND",NA,NA,276,157,119,176,70,106,0.675,0.638,0.588,6100,221
"4664",163912,2000,1,0,"ST MARY'S COLLEGE OF MARYLAND",NA,NA,375,220,155,262,94,168,0.764,0.699,0.606,6285,318
"4665",163912,2001,1,0,"ST MARY'S COLLEGE OF MARYLAND",NA,NA,457,287,170,344,114,230,0.801,0.753,0.671,6474,372
"4666",163912,2002,1,0,"ST MARY'S COLLEGE OF MARYLAND",NA,NA,425,243,182,286,113,173,0.712,0.673,0.621,6925,338
"4667",163912,2003,1,0,"ST MARY'S COLLEGE OF MARYLAND",NA,NA,421,249,172,300,106,194,0.779,0.713,0.616,7550,322
"4668",163912,2004,1,0,"ST MARY'S COLLEGE OF MARYLAND",NA,NA,431,233,198,303,122,181,0.777,0.703,0.616,8092,338
"4669",163912,2005,1,0,"St Mary's College of Maryland",NA,NA,488,295,193,341,130,211,0.715,0.699,0.674,9063,369
"4670",163912,2006,1,0,"St Mary's College of Maryland",NA,NA,428,249,179,309,118,191,0.767,0.722,0.659,9498,320
"4671",163912,2007,1,0,"St Mary's College of Maryland",NA,NA,464,256,208,331,134,197,0.77,0.713,0.644,9973,360
"4672",163912,2008,1,0,"St Mary's College of Maryland",NA,NA,458,279,179,332,119,213,0.763,0.725,0.665,10472,361
"4673",163912,2009,1,0,"St. Mary's College of Maryland",NA,NA,486,273,213,327,121,206,0.755,0.673,0.568,10995,384
"4674",163912,2010,1,0,"St Mary's College of Maryland",NA,NA,443,277,166,289,96,193,0.697,0.652,0.578,11325,333
"4675",164076,1991,1,0,"TOWSON STATE UNIVERSITY",NA,NA,1237,735,502,335,78,257,0.35,0.271,0.155,2458,1014
"4676",164076,1992,1,0,"TOWSON STATE UNIVERSITY",NA,NA,1336,824,512,365,99,266,0.323,0.273,0.193,2828,1131
"4677",164076,1993,1,0,"TOWSON STATE UNIVERSITY",NA,NA,1215,721,494,348,90,258,0.358,0.286,0.182,3122,990
"4678",164076,1995,1,0,"TOWSON STATE UNIVERSITY",NA,NA,1488,934,554,468,121,347,0.372,0.315,0.218,3530,1237
"4679",164076,1996,1,0,"TOWSON STATE UNIVERSITY",NA,NA,1851,1127,724,513,127,386,0.342,0.277,0.175,3822,1550
"4680",164076,1997,1,0,"TOWSON UNIVERSITY",NA,NA,1808,1079,729,557,166,391,0.362,0.308,0.228,4120,1480
"4681",164076,1998,1,0,"TOWSON UNIVERSITY",NA,NA,1923,1175,748,573,183,390,0.332,0.298,0.245,4336,1570
"4682",164076,1999,1,0,"TOWSON UNIVERSITY",NA,NA,2103,1277,826,610,170,440,0.345,0.29,0.206,3332,1692
"4683",164076,2000,1,0,"TOWSON UNIVERSITY",NA,NA,1981,1198,783,630,190,440,0.367,0.318,0.243,3466,1613
"4684",164076,2001,1,0,"TOWSON UNIVERSITY",NA,NA,1910,1245,665,681,169,512,0.411,0.357,0.254,3605,1505
"4685",164076,2002,1,0,"TOWSON UNIVERSITY",NA,NA,2198,1385,813,815,229,586,0.423,0.371,0.282,3804,1765
"4686",164076,2003,1,0,"TOWSON UNIVERSITY",NA,NA,1756,1192,564,763,181,582,0.488,0.435,0.321,4528,1262
"4687",164076,2004,1,0,"TOWSON UNIVERSITY",NA,NA,2082,1376,706,835,229,606,0.44,0.401,0.324,4890,1485
"4688",164076,2005,1,0,"Towson University",NA,NA,2314,1455,859,910,270,640,0.44,0.393,0.314,5180,1688
"4689",164076,2006,1,0,"Towson University",NA,NA,2688,1697,991,1047,307,740,0.436,0.39,0.31,5180,1905
"4690",164076,2007,1,0,"Towson University",NA,NA,2649,1670,979,1069,314,755,0.452,0.404,0.321,5180,2027
"4691",164076,2008,1,0,"Towson University",NA,NA,2825,1786,1039,1210,385,825,0.462,0.428,0.371,5180,2052
"4692",164076,2009,1,0,"Towson University",NA,NA,2395,1564,831,1076,275,801,0.512,0.449,0.331,5180,1693
"4693",164076,2010,1,0,"Towson University",NA,NA,2427,1593,834,1125,310,815,0.512,0.464,0.372,5336,1786
"4694",164173,1991,1,0,"VILLA JULIE COLLEGE",NA,NA,269,233,36,44,6,38,0.163,0.164,0.167,5770,211
"4695",164173,1992,1,0,"VILLA JULIE COLLEGE",NA,NA,200,154,46,44,7,37,0.24,0.22,0.152,6320,172
"4696",164173,1993,1,0,"VILLA JULIE COLLEGE",NA,NA,218,171,47,53,10,43,0.252,0.243,0.213,6880,164
"4697",164173,1995,1,0,"VILLA JULIE COLLEGE",NA,NA,253,180,73,94,26,68,0.378,0.372,0.356,8200,210
"4698",164173,1996,1,0,"VILLA JULIE COLLEGE",NA,NA,286,205,81,89,20,69,0.337,0.311,0.247,8610,214
"4699",164173,1997,1,0,"VILLA JULIE COLLEGE",NA,NA,367,259,108,122,21,101,0.39,0.332,0.194,9240,312
"4700",164173,1998,1,0,"VILLA JULIE COLLEGE",NA,NA,443,305,138,163,46,117,0.384,0.368,0.333,9976,394
"4701",164173,1999,1,0,"VILLA JULIE COLLEGE",NA,NA,421,288,133,211,60,151,0.524,0.501,0.451,10250,373
"4702",164173,2000,1,0,"VILLA JULIE COLLEGE",NA,NA,425,313,112,220,51,169,0.54,0.518,0.455,10750,345
"4703",164173,2001,1,0,"VILLA JULIE COLLEGE",NA,NA,512,374,138,246,56,190,0.508,0.48,0.406,11300,412
"4704",164173,2002,1,0,"VILLA JULIE COLLEGE",NA,NA,487,365,122,281,63,218,0.597,0.577,0.516,11978,406
"4705",164173,2003,1,0,"VILLA JULIE COLLEGE",NA,NA,539,384,155,247,63,184,0.479,0.458,0.406,12816,422
"4706",164173,2004,1,0,"VILLA JULIE COLLEGE",NA,NA,561,378,183,252,81,171,0.452,0.449,0.443,13715,428
"4707",164173,2005,1,0,"Villa Julie College",NA,NA,537,373,164,236,61,175,0.469,0.439,0.372,14674,395
"4708",164173,2006,1,0,"Villa Julie College",NA,NA,643,454,189,315,85,230,0.507,0.49,0.45,15700,455
"4709",164173,2007,1,0,"Villa Julie College",NA,NA,604,436,168,254,61,193,0.443,0.421,0.363,16800,444
"4710",164173,2008,1,0,"Stevenson University",NA,NA,626,436,190,301,81,220,0.505,0.481,0.426,17976,473
"4711",164173,2009,1,0,"Stevenson University",NA,NA,522,346,176,220,62,158,0.457,0.421,0.352,19234,338
"4712",164173,2010,1,0,"Stevenson University",NA,NA,877,535,342,331,98,233,0.436,0.377,0.287,20580,481
"4713",164216,1991,1,0,"WASHINGTON COLLEGE",NA,NA,182,99,83,105,40,65,0.657,0.577,0.482,12312,161
"4714",164216,1992,1,0,"WASHINGTON COLLEGE",NA,NA,276,145,131,160,70,90,0.621,0.58,0.534,13226,237
"4715",164216,1993,1,0,"WASHINGTON COLLEGE",NA,NA,213,123,90,132,46,86,0.699,0.62,0.511,13952,178
"4716",164216,1995,1,0,"WASHINGTON COLLEGE",NA,NA,241,134,107,144,60,84,0.627,0.598,0.561,16440,197
"4717",164216,1996,1,0,"WASHINGTON COLLEGE",NA,NA,312,198,114,203,67,136,0.687,0.651,0.588,16800,261
"4718",164216,1997,1,0,"WASHINGTON COLLEGE",NA,NA,290,162,128,182,79,103,0.636,0.628,0.617,17800,244
"4719",164216,1998,1,0,"WASHINGTON COLLEGE",NA,NA,278,174,104,163,53,110,0.632,0.586,0.51,18750,234
"4720",164216,1999,1,0,"WASHINGTON COLLEGE",NA,NA,282,175,107,175,54,121,0.691,0.621,0.505,19750,235
"4721",164216,2000,1,0,"WASHINGTON COLLEGE",NA,NA,374,236,138,255,80,175,0.742,0.682,0.58,20750,328
"4722",164216,2001,1,0,"WASHINGTON COLLEGE",NA,NA,338,204,134,234,89,145,0.711,0.692,0.664,21750,263
"4723",164216,2002,1,0,"WASHINGTON COLLEGE",NA,NA,368,243,125,276,88,188,0.774,0.75,0.704,22740,309
"4724",164216,2003,1,0,"WASHINGTON COLLEGE",NA,NA,361,228,133,272,93,179,0.785,0.753,0.699,24240,308
"4725",164216,2004,1,0,"WASHINGTON COLLEGE",NA,NA,304,185,119,205,71,134,0.724,0.674,0.597,25990,262
"4726",164216,2005,1,0,"Washington College",NA,NA,345,201,144,247,90,157,0.781,0.716,0.625,28230,297
"4727",164216,2006,1,0,"Washington College",NA,NA,312,179,133,202,80,122,0.682,0.647,0.602,29640,266
"4728",164216,2007,1,0,"Washington College",NA,NA,324,197,127,210,69,141,0.716,0.648,0.543,31570,270
"4729",164216,2008,1,0,"Washington College",NA,NA,415,248,167,291,108,183,0.738,0.701,0.647,33385,354
"4730",164216,2009,1,0,"Washington College",NA,NA,378,215,163,269,111,158,0.735,0.712,0.681,34690,329
"4731",164216,2010,1,0,"Washington College",NA,NA,421,238,183,293,109,184,0.773,0.696,0.596,36078,353
"4732",164270,1991,1,0,"WESTERN MARYLAND COLLEGE",NA,NA,278,132,146,160,71,89,0.674,0.576,0.486,12505,234
"4733",164270,1992,1,0,"WESTERN MARYLAND COLLEGE",NA,NA,300,160,140,164,62,102,0.638,0.547,0.443,13130,270
"4734",164270,1993,1,0,"WESTERN MARYLAND COLLEGE",NA,NA,258,132,126,145,62,83,0.629,0.562,0.492,13750,225
"4735",164270,1995,1,0,"WESTERN MARYLAND COLLEGE",NA,NA,316,163,153,206,80,126,0.773,0.652,0.523,15300,294
"4736",164270,1996,1,0,"WESTERN MARYLAND COLLEGE",NA,NA,385,199,186,236,100,136,0.683,0.613,0.538,16125,340
"4737",164270,1997,1,0,"WESTERN MARYLAND COLLEGE",NA,NA,427,241,186,274,98,176,0.73,0.642,0.527,16850,363
"4738",164270,1998,1,0,"WESTERN MARYLAND COLLEGE",NA,NA,331,173,158,210,86,124,0.717,0.634,0.544,17730,274
"4739",164270,1999,1,0,"WESTERN MARYLAND COLLEGE",NA,NA,412,204,208,261,107,154,0.755,0.633,0.514,18650,338
"4740",164270,2000,1,0,"WESTERN MARYLAND COLLEGE",NA,NA,442,247,195,293,109,184,0.745,0.663,0.559,19600,376
"4741",164270,2001,1,0,"WESTERN MARYLAND COLLEGE",NA,NA,368,209,159,244,88,156,0.746,0.663,0.553,20550,293
"4742",164270,2002,1,0,"MCDANIEL COLLEGE",NA,NA,440,253,187,307,124,183,0.723,0.698,0.663,21760,342
"4743",164270,2003,1,0,"MCDANIEL COLLEGE",NA,NA,451,249,202,274,94,180,0.723,0.608,0.465,22860,383
"4744",164270,2004,1,0,"MCDANIEL COLLEGE",NA,NA,357,196,161,237,100,137,0.699,0.664,0.621,24500,296
"4745",164270,2005,1,0,"McDaniel College",NA,NA,447,246,201,314,136,178,0.724,0.702,0.677,25710,379
"4746",164270,2006,1,0,"McDaniel College",NA,NA,476,260,216,324,126,198,0.762,0.681,0.583,26980,404
"4747",164270,2007,1,0,"McDaniel College",NA,NA,439,226,213,279,118,161,0.712,0.636,0.554,28640,378
"4748",164270,2008,1,0,"McDaniel College",NA,NA,426,223,203,263,117,146,0.655,0.617,0.576,30780,345
"4749",164270,2009,1,0,"McDaniel College",NA,NA,420,195,225,266,124,142,0.728,0.633,0.551,32000,329
"4750",164270,2010,1,0,"McDaniel College",NA,NA,408,213,195,250,93,157,0.737,0.613,0.477,33280,319
"4751",164447,1991,1,0,"AMERICAN INTERNATIONAL COLLEGE",NA,NA,250,110,140,84,43,41,0.373,0.336,0.307,8117,196
"4752",164447,1992,1,0,"AMERICAN INTERNATIONAL COLLEGE",NA,NA,225,95,130,71,38,33,0.347,0.316,0.292,8298,164
"4753",164447,1993,1,0,"AMERICAN INTERNATIONAL COLLEGE",NA,NA,240,110,130,68,32,36,0.327,0.283,0.246,8690,165
"4754",164447,1995,1,0,"AMERICAN INTERNATIONAL COLLEGE",NA,NA,260,104,156,84,37,47,0.452,0.323,0.237,9714,176
"4755",164447,1996,1,0,"AMERICAN INTERNATIONAL COLLEGE",NA,NA,253,133,120,79,30,49,0.368,0.312,0.25,10276,165
"4756",164447,1997,1,0,"AMERICAN INTERNATIONAL COLLEGE",NA,NA,253,133,120,79,30,49,0.368,0.312,0.25,11244,165
"4757",164447,1998,1,0,"AMERICAN INTERNATIONAL COLLEGE",NA,NA,226,96,130,57,22,35,0.365,0.252,0.169,11800,149
"4758",164447,1999,1,0,"AMERICAN INTERNATIONAL COLLEGE",NA,NA,240,92,148,77,33,44,0.478,0.321,0.223,12338,106
"4759",164447,2000,1,0,"AMERICAN INTERNATIONAL COLLEGE",NA,NA,239,123,116,112,63,49,0.398,0.469,0.543,13600,115
"4760",164447,2001,1,0,"AMERICAN INTERNATIONAL COLLEGE",NA,NA,197,98,99,91,34,57,0.582,0.462,0.343,14800,105
"4761",164447,2002,1,0,"AMERICAN INTERNATIONAL COLLEGE",NA,NA,256,117,139,55,21,34,0.291,0.215,0.151,15700,116
"4762",164447,2003,1,0,"AMERICAN INTERNATIONAL COLLEGE",NA,NA,327,174,153,105,45,60,0.345,0.321,0.294,16700,172
"4763",164447,2004,1,0,"AMERICAN INTERNATIONAL COLLEGE",NA,NA,321,167,154,83,35,48,0.287,0.259,0.227,18000,174
"4764",164447,2005,1,0,"American International College",NA,NA,328,160,168,65,32,33,0.206,0.198,0.19,19800,177
"4765",164447,2006,1,0,"American International College",NA,NA,282,148,134,81,29,52,0.351,0.287,0.216,20990,130
"4766",164447,2007,1,0,"American International College",NA,NA,390,202,188,111,55,56,0.277,0.285,0.293,22500,167
"4767",164447,2008,1,0,"American International College",NA,NA,371,185,186,102,46,56,0.303,0.275,0.247,24100,145
"4768",164447,2009,1,0,"American International College",NA,NA,354,165,189,88,40,48,0.291,0.249,0.212,25550,112
"4769",164447,2010,1,0,"American International College",NA,NA,367,168,199,107,47,60,0.357,0.292,0.236,26700,143
"4770",164492,1991,1,0,"ANNA MARIA COLLEGE",NA,NA,116,87,29,54,9,45,0.517,0.466,0.31,9880,100
"4771",164492,1992,1,0,"ANNA MARIA COLLEGE",NA,NA,80,48,32,35,16,19,0.396,0.438,0.5,10380,71
"4772",164492,1993,1,0,"ANNA MARIA COLLEGE",NA,NA,94,62,32,50,17,33,0.532,0.532,0.531,10800,86
"4773",164492,1995,1,0,"ANNA MARIA COLLEGE",NA,NA,69,43,26,28,7,21,0.488,0.406,0.269,11780,55
"4774",164492,1996,1,0,"ANNA MARIA COLLEGE",NA,NA,112,69,43,53,24,29,0.42,0.473,0.558,11780,105
"4775",164492,1997,1,0,"ANNA MARIA COLLEGE",NA,NA,135,90,45,54,19,35,0.389,0.4,0.422,12240,119
"4776",164492,1998,1,0,"ANNA MARIA COLLEGE",NA,NA,153,116,37,70,19,51,0.44,0.458,0.514,12690,123
"4777",164492,1999,1,0,"ANNA MARIA COLLEGE",NA,NA,134,90,44,64,23,41,0.456,0.478,0.523,12200,110
"4778",164492,2000,1,0,"ANNA MARIA COLLEGE",NA,NA,149,110,39,81,18,63,0.573,0.544,0.462,13495,128
"4779",164492,2001,1,0,"ANNA MARIA COLLEGE",NA,NA,140,97,43,69,24,45,0.464,0.493,0.558,15250,119
"4780",164492,2002,1,0,"ANNA MARIA COLLEGE",NA,NA,159,108,51,82,29,53,0.491,0.516,0.569,16410,142
"4781",164492,2003,1,0,"ANNA MARIA COLLEGE",NA,NA,154,102,52,76,19,57,0.559,0.494,0.365,17495,131
"4782",164492,2004,1,0,"ANNA MARIA COLLEGE",NA,NA,189,107,82,69,32,37,0.346,0.365,0.39,18545,152
"4783",164492,2005,1,0,"Anna Maria College",NA,NA,156,79,77,58,27,31,0.392,0.372,0.351,19900,127
"4784",164492,2006,1,0,"Anna Maria College",NA,NA,181,105,76,71,24,47,0.448,0.392,0.316,21094,145
"4785",164492,2007,1,0,"Anna Maria College",NA,NA,258,137,121,112,45,67,0.489,0.434,0.372,22360,195
"4786",164492,2008,1,0,"Anna Maria College",NA,NA,245,135,110,81,38,43,0.318,0.331,0.345,23500,190
"4787",164492,2009,1,0,"Anna Maria College",NA,NA,373,172,201,95,46,49,0.285,0.255,0.229,24192,245
"4788",164492,2010,1,0,"Anna Maria College",NA,NA,287,140,147,95,43,52,0.371,0.331,0.293,25632,165
"4789",164562,1991,1,0,"ASSUMPTION COLLEGE",NA,NA,447,286,161,298,110,188,0.657,0.667,0.683,9835,440
"4790",164562,1992,1,0,"ASSUMPTION COLLEGE",NA,NA,446,287,159,304,102,202,0.704,0.682,0.642,10320,428
"4791",164562,1993,1,0,"ASSUMPTION COLLEGE",NA,NA,491,302,189,299,108,191,0.633,0.609,0.571,11595,478
"4792",164562,1995,1,0,"ASSUMPTION COLLEGE",NA,NA,446,262,184,295,119,176,0.672,0.661,0.647,12825,354
"4793",164562,1996,1,0,"ASSUMPTION COLLEGE",NA,NA,431,266,165,296,112,184,0.692,0.687,0.679,13845,391
"4794",164562,1997,1,0,"ASSUMPTION COLLEGE",NA,NA,582,365,217,386,137,249,0.682,0.663,0.631,14845,515
"4795",164562,1998,1,0,"ASSUMPTION COLLEGE",NA,NA,522,334,188,402,138,264,0.79,0.77,0.734,15905,474
"4796",164562,1999,1,0,"ASSUMPTION COLLEGE",NA,NA,592,361,231,404,150,254,0.704,0.682,0.649,17320,482
"4797",164562,2000,1,0,"ASSUMPTION COLLEGE",NA,NA,593,367,226,409,114,295,0.804,0.69,0.504,17950,518
"4798",164562,2001,1,0,"ASSUMPTION COLLEGE",NA,NA,604,369,235,402,148,254,0.688,0.666,0.63,18800,418
"4799",164562,2002,1,0,"ASSUMPTION COLLEGE",NA,NA,618,381,237,451,168,283,0.743,0.73,0.709,19835,534
"4800",164562,2003,1,0,"ASSUMPTION COLLEGE",NA,NA,640,408,232,409,140,269,0.659,0.639,0.603,21000,535
"4801",164562,2004,1,0,"ASSUMPTION COLLEGE",NA,NA,633,364,269,447,170,277,0.761,0.706,0.632,22260,536
"4802",164562,2005,1,0,"Assumption College",NA,NA,565,328,237,369,132,237,0.723,0.653,0.557,23930,426
"4803",164562,2006,1,0,"Assumption College",NA,NA,675,397,278,484,183,301,0.758,0.717,0.658,25985,533
"4804",164562,2007,1,0,"Assumption College",NA,NA,594,331,263,417,176,241,0.728,0.702,0.669,27320,460
"4805",164562,2008,1,0,"Assumption College",NA,NA,606,357,249,402,151,251,0.703,0.663,0.606,28686,439
"4806",164562,2009,1,0,"Assumption College",NA,NA,515,294,221,363,135,228,0.775,0.705,0.611,29806,379
"4807",164562,2010,1,0,"Assumption College",NA,NA,590,369,221,423,141,282,0.764,0.717,0.638,30940,449
"4808",165015,1991,1,0,"BRANDEIS UNIVERSITY",NA,NA,745,392,353,546,247,299,0.763,0.733,0.7,16475,585
"4809",165015,1992,1,0,"BRANDEIS UNIVERSITY",NA,NA,757,413,344,556,250,306,0.741,0.734,0.727,17726,597
"4810",165015,1993,1,0,"BRANDEIS UNIVERSITY",NA,NA,704,379,325,531,238,293,0.773,0.754,0.732,18955,547
"4811",165015,1995,1,0,"BRANDEIS UNIVERSITY",NA,NA,874,483,391,702,306,396,0.82,0.803,0.783,20935,697
"4812",165015,1996,1,0,"BRANDEIS UNIVERSITY",NA,NA,761,393,368,608,275,333,0.847,0.799,0.747,21917,617
"4813",165015,1997,1,0,"BRANDEIS UNIVERSITY",NA,NA,794,470,324,633,250,383,0.815,0.797,0.772,22360,628
"4814",165015,1998,1,0,"BRANDEIS UNIVERSITY",NA,NA,850,477,373,715,293,422,0.885,0.841,0.786,23360,662
"4815",165015,1999,1,0,"BRANDEIS UNIVERSITY",NA,NA,793,446,347,663,275,388,0.87,0.836,0.793,24421,569
"4816",165015,2000,1,0,"BRANDEIS UNIVERSITY",NA,NA,858,475,383,714,301,413,0.87,0.832,0.786,25392,568
"4817",165015,2001,1,0,"BRANDEIS UNIVERSITY",NA,NA,735,416,319,629,261,368,0.885,0.856,0.818,26281,499
"4818",165015,2002,1,0,"BRANDEIS UNIVERSITY",NA,NA,837,456,381,708,316,392,0.86,0.846,0.829,27345,591
"4819",165015,2003,1,0,"BRANDEIS UNIVERSITY",NA,NA,824,486,338,692,285,407,0.837,0.84,0.843,28999,541
"4820",165015,2004,1,0,"BRANDEIS UNIVERSITY",NA,NA,761,417,344,655,287,368,0.883,0.861,0.834,30160,496
"4821",165015,2005,1,0,"Brandeis University",NA,NA,737,397,340,647,287,360,0.907,0.878,0.844,31532,453
"4822",165015,2006,1,0,"Brandeis University",NA,NA,764,416,348,656,291,365,0.877,0.859,0.836,32951,407
"4823",165015,2007,1,0,"Brandeis University",NA,NA,701,391,310,604,264,340,0.87,0.862,0.852,34566,377
"4824",165015,2008,1,0,"Brandeis University",NA,NA,754,426,328,643,274,369,0.866,0.853,0.835,36122,341
"4825",165015,2009,1,0,"Brandeis University",NA,NA,775,434,341,621,255,366,0.843,0.801,0.748,37530,331
"4826",165015,2010,1,0,"Brandeis University",NA,NA,686,370,316,569,247,322,0.87,0.829,0.782,38994,354
"4827",165024,1991,1,0,"BRIDGEWATER STATE COLLEGE",NA,NA,982,568,414,265,67,198,0.349,0.27,0.162,2882,910
"4828",165024,1992,1,0,"BRIDGEWATER STATE COLLEGE",NA,NA,963,567,396,213,54,159,0.28,0.221,0.136,2952,857
"4829",165024,1993,1,0,"BRIDGEWATER STATE COLLEGE",NA,NA,1045,590,455,196,68,128,0.217,0.188,0.149,3373,927
"4830",165024,1995,1,0,"BRIDGEWATER STATE COLLEGE",NA,NA,1087,620,467,211,57,154,0.248,0.194,0.122,3462,928
"4831",165024,1996,1,0,"BRIDGEWATER STATE COLLEGE",NA,NA,1155,697,458,222,52,170,0.244,0.192,0.114,3392,972
"4832",165024,1997,1,0,"BRIDGEWATER STATE COLLEGE",NA,NA,1147,672,475,206,46,160,0.238,0.18,0.097,3324,964
"4833",165024,1998,1,0,"BRIDGEWATER STATE COLLEGE",NA,NA,1128,695,433,260,75,185,0.266,0.23,0.173,3134,967
"4834",165024,1999,1,0,"BRIDGEWATER STATE COLLEGE",NA,NA,1079,657,422,208,43,165,0.251,0.193,0.102,1032,897
"4835",165024,2000,1,0,"BRIDGEWATER STATE COLLEGE",NA,NA,1244,760,484,290,87,203,0.267,0.233,0.18,1030,1030
"4836",165024,2001,1,0,"BRIDGEWATER STATE COLLEGE",NA,NA,1139,695,444,255,59,196,0.282,0.224,0.133,910,961
"4837",165024,2002,1,0,"BRIDGEWATER STATE COLLEGE",NA,NA,1272,769,503,277,72,205,0.267,0.218,0.143,910,1031
"4838",165024,2003,1,0,"BRIDGEWATER STATE COLLEGE",NA,NA,1285,745,540,320,93,227,0.305,0.249,0.172,910,1078
"4839",165024,2004,1,0,"BRIDGEWATER STATE COLLEGE",NA,NA,1266,713,553,306,99,207,0.29,0.242,0.179,910,1040
"4840",165024,2005,1,0,"Bridgewater State College",NA,NA,1314,746,568,339,113,226,0.303,0.258,0.199,910,1066
"4841",165024,2006,1,0,"Bridgewater State College",NA,NA,1321,737,584,368,135,233,0.316,0.279,0.231,910,1099
"4842",165024,2007,1,0,"Bridgewater State College",NA,NA,1551,935,616,445,139,306,0.327,0.287,0.226,910,1272
"4843",165024,2008,1,0,"Bridgewater State College",NA,NA,1464,915,549,412,134,278,0.304,0.281,0.244,910,1239
"4844",165024,2009,1,0,"Bridgewater State College",NA,NA,1453,866,587,420,162,258,0.298,0.289,0.276,910,1194
"4845",165024,2010,1,0,"Bridgewater State University",NA,NA,1431,812,619,458,174,284,0.35,0.32,0.281,910,1208
"4846",165334,1991,1,0,"CLARK UNIVERSITY",NA,NA,561,307,254,344,137,207,0.674,0.613,0.539,15380,322
"4847",165334,1992,1,0,"CLARK UNIVERSITY",NA,NA,527,317,210,280,106,174,0.549,0.531,0.505,16200,344
"4848",165334,1993,1,0,"CLARK UNIVERSITY",NA,NA,443,257,186,251,102,149,0.58,0.567,0.548,17000,273
"4849",165334,1995,1,0,"CLARK UNIVERSITY",NA,NA,505,318,187,311,103,208,0.654,0.616,0.551,19140,299
"4850",165334,1996,1,0,"CLARK UNIVERSITY",NA,NA,527,301,226,336,128,208,0.691,0.638,0.566,20040,350
"4851",165334,1997,1,0,"CLARK UNIVERSITY",NA,NA,520,313,207,313,110,203,0.649,0.602,0.531,20940,351
"4852",165334,1998,1,0,"CLARK UNIVERSITY",NA,NA,501,305,196,323,119,204,0.669,0.645,0.607,21740,321
"4853",165334,1999,1,0,"CLARK UNIVERSITY",NA,NA,486,304,182,308,112,196,0.645,0.634,0.615,22400,315
"4854",165334,2000,1,0,"CLARK UNIVERSITY",NA,NA,497,292,205,315,120,195,0.668,0.634,0.585,23300,329
"4855",165334,2001,1,0,"CLARK UNIVERSITY",NA,NA,511,330,181,354,123,231,0.7,0.693,0.68,24400,342
"4856",165334,2002,1,0,"CLARK UNIVERSITY",NA,NA,576,357,219,387,148,239,0.67,0.672,0.676,25600,379
"4857",165334,2003,1,0,"CLARK UNIVERSITY",NA,NA,537,324,213,391,150,241,0.744,0.728,0.704,26700,342
"4858",165334,2004,1,0,"CLARK UNIVERSITY",NA,NA,523,328,195,383,137,246,0.75,0.732,0.703,28000,327
"4859",165334,2005,1,0,"Clark University",NA,NA,557,338,219,422,161,261,0.772,0.758,0.735,29300,383
"4860",165334,2006,1,0,"Clark University",NA,NA,563,345,218,425,159,266,0.771,0.755,0.729,31200,399
"4861",165334,2007,1,0,"Clark University",NA,NA,572,361,211,432,157,275,0.762,0.755,0.744,32600,402
"4862",165334,2008,1,0,"Clark University",NA,NA,586,348,238,424,162,262,0.753,0.724,0.681,33900,408
"4863",165334,2009,1,0,"Clark University",NA,NA,548,356,192,422,144,278,0.781,0.77,0.75,34900,401
"4864",165334,2010,1,0,"Clark University",NA,NA,575,328,247,411,172,239,0.729,0.715,0.696,36100,404
"4865",165662,1991,1,0,"EMERSON COLLEGE",NA,NA,399,269,130,217,89,128,0.476,0.544,0.685,13273,345
"4866",165662,1992,1,0,"EMERSON COLLEGE",NA,NA,408,276,132,198,70,128,0.464,0.485,0.53,13817,348
"4867",165662,1993,1,0,"EMERSON COLLEGE",NA,NA,427,263,164,256,100,156,0.593,0.6,0.61,14743,369
"4868",165662,1995,1,0,"EMERSON COLLEGE",NA,NA,526,313,213,310,121,189,0.604,0.589,0.568,16259,405
"4869",165662,1996,1,0,"EMERSON COLLEGE",NA,NA,547,318,229,358,161,197,0.62,0.654,0.703,17085,423
"4870",165662,1997,1,0,"EMERSON COLLEGE",NA,NA,547,333,214,343,130,213,0.64,0.627,0.607,18242,447
"4871",165662,1998,1,0,"EMERSON COLLEGE",NA,NA,612,368,244,377,150,227,0.617,0.616,0.615,19028,517
"4872",165662,1999,1,0,"EMERSON COLLEGE",NA,NA,653,361,292,433,192,241,0.668,0.663,0.658,18816,495
"4873",165662,2000,1,0,"EMERSON COLLEGE",NA,NA,641,396,245,461,179,282,0.712,0.719,0.731,19520,550
"4874",165662,2001,1,0,"EMERSON COLLEGE",NA,NA,643,406,237,440,163,277,0.682,0.684,0.688,20224,490
"4875",165662,2002,1,0,"EMERSON COLLEGE",NA,NA,656,419,237,473,179,294,0.702,0.721,0.755,21120,513
"4876",165662,2003,1,0,"EMERSON COLLEGE",NA,NA,706,413,293,525,229,296,0.717,0.744,0.782,22144,554
"4877",165662,2004,1,0,"EMERSON COLLEGE",NA,NA,700,402,298,533,242,291,0.724,0.761,0.812,22976,523
"4878",165662,2005,1,0,"Emerson College",NA,NA,715,417,298,571,243,328,0.787,0.799,0.815,24064,557
"4879",165662,2006,1,0,"Emerson College",NA,NA,728,409,319,578,254,324,0.792,0.794,0.796,25248,540
"4880",165662,2007,1,0,"Emerson College",NA,NA,842,477,365,671,274,397,0.832,0.797,0.751,26880,651
"4881",165662,2008,1,0,"Emerson College",NA,NA,772,466,306,598,243,355,0.762,0.775,0.794,28352,429
"4882",165662,2009,1,0,"Emerson College",NA,NA,764,486,278,593,215,378,0.778,0.776,0.773,29408,376
"4883",165662,2010,1,0,"Emerson College",NA,NA,824,529,295,634,219,415,0.785,0.769,0.742,30752,499
"4884",165671,1991,1,0,"EMMANUEL COLLEGE",NA,NA,138,138,0,51,0,51,0.37,0.37,NA,10070,90
"4885",165671,1992,1,0,"EMMANUEL COLLEGE",NA,NA,149,149,0,52,0,52,0.349,0.349,NA,10966,96
"4886",165671,1993,1,0,"EMMANUEL COLLEGE",NA,NA,133,133,0,59,0,59,0.444,0.444,NA,11973,84
"4887",165671,1995,1,0,"EMMANUEL COLLEGE",NA,NA,100,100,0,43,0,43,0.43,0.43,NA,14055,65
"4888",165671,1996,1,0,"EMMANUEL COLLEGE",NA,NA,86,86,0,45,0,45,0.523,0.523,NA,14523,42
"4889",165671,1997,1,0,"EMMANUEL COLLEGE",NA,NA,112,112,0,59,0,59,0.527,0.527,NA,15094,50
"4890",165671,1998,1,0,"EMMANUEL COLLEGE",NA,NA,151,151,0,80,0,80,0.53,0.53,NA,15786,85
"4891",165671,1999,1,0,"EMMANUEL COLLEGE",NA,NA,133,133,0,60,0,60,0.451,0.451,NA,15488,85
"4892",165671,2000,1,0,"EMMANUEL COLLEGE",NA,NA,165,165,0,82,0,82,0.497,0.497,NA,16112,87
"4893",165671,2001,1,0,"EMMANUEL COLLEGE",NA,NA,277,189,88,128,32,96,0.508,0.462,0.364,16800,136
"4894",165671,2002,1,0,"EMMANUEL COLLEGE",NA,NA,322,258,64,179,31,148,0.574,0.556,0.484,17800,215
"4895",165671,2003,1,0,"EMMANUEL COLLEGE",NA,NA,406,299,107,222,47,175,0.585,0.547,0.439,18900,270
"4896",165671,2004,1,0,"EMMANUEL COLLEGE",NA,NA,455,332,123,237,58,179,0.539,0.521,0.472,20100,288
"4897",165671,2005,1,0,"Emmanuel College",NA,NA,438,327,111,237,63,174,0.532,0.541,0.568,21900,318
"4898",165671,2006,1,0,"Emmanuel College",NA,NA,467,344,123,233,55,178,0.517,0.499,0.447,23800,368
"4899",165671,2007,1,0,"Emmanuel College",NA,NA,582,436,146,299,74,225,0.516,0.514,0.507,26100,421
"4900",165671,2008,1,0,"Emmanuel College",NA,NA,480,346,134,268,73,195,0.564,0.558,0.545,28200,344
"4901",165671,2009,1,0,"Emmanuel College",NA,NA,423,308,115,235,60,175,0.568,0.556,0.522,29200,322
"4902",165671,2010,1,0,"Emmanuel College",NA,NA,528,386,142,318,81,237,0.614,0.602,0.57,30600,326
"4903",165820,1991,1,0,"FITCHBURG STATE COLLEGE",NA,NA,759,462,297,183,55,128,0.277,0.241,0.185,3134,706
"4904",165820,1992,1,0,"FITCHBURG STATE COLLEGE",NA,NA,538,297,241,128,32,96,0.323,0.238,0.133,3206,463
"4905",165820,1993,1,0,"FITCHBURG STATE COLLEGE",NA,NA,550,304,246,97,18,79,0.26,0.176,0.073,3234,499
"4906",165820,1995,1,0,"FITCHBURG STATE COLLEGE",NA,NA,574,329,245,106,20,86,0.261,0.185,0.082,3316,468
"4907",165820,1996,1,0,"FITCHBURG STATE COLLEGE",NA,NA,436,265,171,95,19,76,0.287,0.218,0.111,3246,360
"4908",165820,1997,1,0,"FITCHBURG STATE COLLEGE",NA,NA,488,270,218,104,29,75,0.278,0.213,0.133,3346,310
"4909",165820,1998,1,0,"FITCHBURG STATE COLLEGE",NA,NA,503,281,222,81,24,57,0.203,0.161,0.108,3198,369
"4910",165820,1999,1,0,"FITCHBURG STATE COLLEGE",NA,NA,345,202,143,73,23,50,0.248,0.212,0.161,1090,295
"4911",165820,2000,1,0,"FITCHBURG STATE COLLEGE",NA,NA,448,275,173,119,30,89,0.324,0.266,0.173,1030,383
"4912",165820,2001,1,0,"FITCHBURG STATE COLLEGE",NA,NA,405,220,185,91,29,62,0.282,0.225,0.157,970,352
"4913",165820,2002,1,0,"FITCHBURG STATE COLLEGE",NA,NA,496,292,204,119,41,78,0.267,0.24,0.201,970,432
"4914",165820,2003,1,0,"FITCHBURG STATE COLLEGE",NA,NA,585,320,265,144,50,94,0.294,0.246,0.189,970,516
"4915",165820,2004,1,0,"FITCHBURG STATE COLLEGE",NA,NA,713,386,327,153,52,101,0.262,0.215,0.159,970,592
"4916",165820,2005,1,0,"Fitchburg State College",NA,NA,599,297,302,125,54,71,0.239,0.209,0.179,970,525
"4917",165820,2006,1,0,"Fitchburg State College",NA,NA,728,383,345,172,63,109,0.285,0.236,0.183,970,611
"4918",165820,2007,1,0,"Fitchburg State College",NA,NA,698,366,332,142,56,86,0.235,0.203,0.169,970,570
"4919",165820,2008,1,0,"Fitchburg State College",NA,NA,763,421,342,227,76,151,0.359,0.298,0.222,970,646
"4920",165820,2009,1,0,"Fitchburg State College",NA,NA,781,410,371,217,89,128,0.312,0.278,0.24,970,682
"4921",165820,2010,1,0,"Fitchburg State University",NA,NA,721,413,308,246,86,160,0.387,0.341,0.279,970,491
"4922",165866,1991,1,0,"FRAMINGHAM STATE COLLEGE",NA,NA,385,251,134,114,22,92,0.366,0.296,0.164,2889,347
"4923",165866,1992,1,0,"FRAMINGHAM STATE COLLEGE",NA,NA,577,382,195,154,35,119,0.312,0.267,0.179,2995,515
"4924",165866,1993,1,0,"FRAMINGHAM STATE COLLEGE",NA,NA,517,339,178,117,21,96,0.283,0.226,0.118,3154,450
"4925",165866,1995,1,0,"FRAMINGHAM STATE COLLEGE",NA,NA,600,404,196,122,28,94,0.233,0.203,0.143,3308,500
"4926",165866,1996,1,0,"FRAMINGHAM STATE COLLEGE",NA,NA,644,429,215,127,26,101,0.235,0.197,0.121,3238,570
"4927",165866,1997,1,0,"FRAMINGHAM STATE COLLEGE",NA,NA,590,397,193,120,25,95,0.239,0.203,0.13,3160,512
"4928",165866,1998,1,0,"FRAMINGHAM STATE COLLEGE",NA,NA,601,381,220,136,27,109,0.286,0.226,0.123,3070,514
"4929",165866,1999,1,0,"FRAMINGHAM STATE COLLEGE",NA,NA,559,402,157,130,27,103,0.256,0.233,0.172,1090,469
"4930",165866,2000,1,0,"FRAMINGHAM STATE COLLEGE",NA,NA,612,434,178,153,30,123,0.283,0.25,0.169,1030,506
"4931",165866,2001,1,0,"FRAMINGHAM STATE COLLEGE",NA,NA,645,455,190,145,28,117,0.257,0.225,0.147,970,557
"4932",165866,2002,1,0,"FRAMINGHAM STATE COLLEGE",NA,NA,716,500,216,193,38,155,0.31,0.27,0.176,970,622
"4933",165866,2003,1,0,"FRAMINGHAM STATE COLLEGE",NA,NA,617,441,176,202,45,157,0.356,0.327,0.256,970,526
"4934",165866,2004,1,0,"FRAMINGHAM STATE COLLEGE",NA,NA,642,434,208,187,49,138,0.318,0.291,0.236,970,546
"4935",165866,2005,1,0,"Framingham State College",NA,NA,666,461,205,210,44,166,0.36,0.315,0.215,970,563
"4936",165866,2006,1,0,"Framingham State College",NA,NA,714,496,218,242,57,185,0.373,0.339,0.261,970,583
"4937",165866,2007,1,0,"Framingham State College",NA,NA,633,420,213,212,52,160,0.381,0.335,0.244,970,517
"4938",165866,2008,1,0,"Framingham State College",NA,NA,644,450,194,213,49,164,0.364,0.331,0.253,970,551
"4939",165866,2009,1,0,"Framingham State College",NA,NA,719,520,199,261,59,202,0.388,0.363,0.296,970,609
"4940",165866,2010,1,0,"Framingham State University",NA,NA,719,481,238,245,59,186,0.387,0.341,0.248,970,565
"4941",165936,1991,1,0,"GORDON COLLEGE",NA,NA,282,171,111,122,41,81,0.474,0.433,0.369,11400,236
"4942",165936,1992,1,0,"GORDON COLLEGE",NA,NA,292,193,99,140,39,101,0.523,0.479,0.394,12090,253
"4943",165936,1993,1,0,"GORDON COLLEGE",NA,NA,298,186,112,98,27,71,0.382,0.329,0.241,12720,270
"4944",165936,1995,1,0,"GORDON COLLEGE",NA,NA,330,226,104,152,43,109,0.482,0.461,0.413,13950,303
"4945",165936,1996,1,0,"GORDON COLLEGE",NA,NA,326,210,116,152,41,111,0.529,0.466,0.353,14690,301
"4946",165936,1997,1,0,"GORDON COLLEGE",NA,NA,406,279,127,206,68,138,0.495,0.507,0.535,15150,381
"4947",165936,1998,1,0,"GORDON COLLEGE",NA,NA,417,289,128,214,65,149,0.516,0.513,0.508,15760,391
"4948",165936,1999,1,0,"GORDON COLLEGE",NA,NA,382,243,139,205,61,144,0.593,0.537,0.439,15740,356
"4949",165936,2000,1,0,"GORDON COLLEGE",NA,NA,411,274,137,233,71,162,0.591,0.567,0.518,16550,389
"4950",165936,2001,1,0,"GORDON COLLEGE",NA,NA,441,313,128,246,63,183,0.585,0.558,0.492,17378,407
"4951",165936,2002,1,0,"GORDON COLLEGE",NA,NA,400,266,134,248,77,171,0.643,0.62,0.575,18230,353
"4952",165936,2003,1,0,"GORDON COLLEGE",NA,NA,427,274,153,260,86,174,0.635,0.609,0.562,19334,382
"4953",165936,2004,1,0,"GORDON COLLEGE",NA,NA,401,264,137,235,75,160,0.606,0.586,0.547,20494,343
"4954",165936,2005,1,0,"Gordon College",NA,NA,414,259,155,254,79,175,0.676,0.614,0.51,21930,368
"4955",165936,2006,1,0,"Gordon College",NA,NA,380,250,130,225,71,154,0.616,0.592,0.546,23224,340
"4956",165936,2007,1,0,"Gordon College",NA,NA,454,286,168,264,95,169,0.591,0.581,0.565,24652,392
"4957",165936,2008,1,0,"Gordon College",NA,NA,419,260,159,256,91,165,0.635,0.611,0.572,26132,354
"4958",165936,2009,1,0,"Gordon College",NA,NA,381,237,144,233,71,162,0.683,0.612,0.493,27152,313
"4959",165936,2010,1,0,"Gordon College",NA,NA,348,212,136,212,80,132,0.623,0.609,0.588,28210,276
"4960",166027,1991,1,0,"HARVARD UNIVERSITY",NA,NA,1601,669,932,1347,759,588,0.879,0.841,0.814,15410,925
"4961",166027,1992,1,0,"HARVARD UNIVERSITY",NA,NA,1603,686,917,1380,782,598,0.872,0.861,0.853,16454,667
"4962",166027,1993,1,0,"HARVARD UNIVERSITY",NA,NA,1601,715,886,1358,743,615,0.86,0.848,0.839,17470,669
"4963",166027,1995,1,0,"HARVARD UNIVERSITY",NA,NA,1606,738,868,1343,705,638,0.865,0.836,0.812,19472,779
"4964",166027,1996,1,0,"HARVARD UNIVERSITY",NA,NA,1611,721,890,1390,754,636,0.882,0.863,0.847,20424,685
"4965",166027,1997,1,0,"HARVARD UNIVERSITY",NA,NA,1642,782,860,1436,744,692,0.885,0.875,0.865,21266,629
"4966",166027,1998,1,0,"HARVARD UNIVERSITY",NA,NA,1650,772,878,1423,748,675,0.874,0.862,0.852,22028,711
"4967",166027,1999,1,0,"HARVARD UNIVERSITY",NA,NA,1647,775,872,1429,757,672,0.867,0.868,0.868,22054,770
"4968",166027,2000,1,0,"HARVARD UNIVERSITY",NA,NA,1638,755,883,1431,757,674,0.893,0.874,0.857,22694,731
"4969",166027,2001,1,0,"HARVARD UNIVERSITY",NA,NA,1637,786,851,1448,742,706,0.898,0.885,0.872,23457,749
"4970",166027,2002,1,0,"HARVARD UNIVERSITY",NA,NA,1619,783,836,1422,710,712,0.909,0.878,0.849,24630,838
"4971",166027,2003,1,0,"HARVARD UNIVERSITY",NA,NA,1633,782,851,1433,726,707,0.904,0.878,0.853,26066,803
"4972",166027,2004,1,0,"HARVARD UNIVERSITY",NA,NA,1638,823,815,1427,688,739,0.898,0.871,0.844,27448,757
"4973",166027,2005,1,0,"Harvard University",NA,NA,1637,819,818,1421,698,723,0.883,0.868,0.853,28752,776
"4974",166027,2006,1,0,"Harvard University",NA,NA,1679,878,801,1448,664,784,0.893,0.862,0.829,30275,739
"4975",166027,2007,1,0,"Harvard University",NA,NA,1657,839,818,1434,695,739,0.881,0.865,0.85,31456,694
"4976",166027,2008,1,0,"Harvard University",NA,NA,1656,836,820,1420,677,743,0.889,0.857,0.826,32557,741
"4977",166027,2009,1,0,"Harvard University",NA,NA,1662,837,825,1425,673,752,0.898,0.857,0.816,33696,742
"4978",166027,2010,1,0,"Harvard University",NA,NA,1663,827,836,1434,708,726,0.878,0.862,0.847,34976,767
"4979",166124,1991,1,0,"COLLEGE OF THE HOLY CROSS",NA,NA,728,344,384,631,329,302,0.878,0.867,0.857,15530,653
"4980",166124,1992,1,0,"COLLEGE OF THE HOLY CROSS",NA,NA,765,428,337,698,308,390,0.911,0.912,0.914,16300,724
"4981",166124,1993,1,0,"COLLEGE OF THE HOLY CROSS",NA,NA,658,350,308,598,277,321,0.917,0.909,0.899,17200,625
"4982",166124,1995,1,0,"COLLEGE OF THE HOLY CROSS",NA,NA,710,384,326,618,287,331,0.862,0.87,0.88,18900,612
"4983",166124,1996,1,0,"COLLEGE OF THE HOLY CROSS",NA,NA,688,349,339,611,287,324,0.928,0.888,0.847,19700,567
"4984",166124,1997,1,0,"COLLEGE OF THE HOLY CROSS",NA,NA,726,409,317,635,270,365,0.892,0.875,0.852,21080,584
"4985",166124,1998,1,0,"COLLEGE OF THE HOLY CROSS",NA,NA,723,354,369,623,305,318,0.898,0.862,0.827,22005,561
"4986",166124,1999,1,0,"COLLEGE OF THE HOLY CROSS",NA,NA,722,383,339,645,298,347,0.906,0.893,0.879,22500,566
"4987",166124,2000,1,0,"COLLEGE OF THE HOLY CROSS",NA,NA,706,376,330,626,284,342,0.91,0.887,0.861,23400,551
"4988",166124,2001,1,0,"COLLEGE OF THE HOLY CROSS",NA,NA,691,366,325,609,274,335,0.915,0.881,0.843,24600,533
"4989",166124,2002,1,0,"COLLEGE OF THE HOLY CROSS",NA,NA,669,348,321,644,300,344,0.988,0.963,0.935,26000,508
"4990",166124,2003,1,0,"COLLEGE OF THE HOLY CROSS",NA,NA,698,378,320,607,270,337,0.892,0.87,0.844,27560,546
"4991",166124,2004,1,0,"COLLEGE OF THE HOLY CROSS",NA,NA,703,389,314,635,274,361,0.928,0.903,0.873,29220,524
"4992",166124,2005,1,0,"College of the Holy Cross",NA,NA,723,399,324,645,281,364,0.912,0.892,0.867,30960,505
"4993",166124,2006,1,0,"College of the Holy Cross",NA,NA,751,415,336,675,293,382,0.92,0.899,0.872,32820,538
"4994",166124,2007,1,0,"College of the Holy Cross",NA,NA,718,398,320,639,272,367,0.922,0.89,0.85,34630,460
"4995",166124,2008,1,0,"College of the Holy Cross",NA,NA,737,420,317,664,285,379,0.902,0.901,0.899,36710,448
"4996",166124,2009,1,0,"College of the Holy Cross",NA,NA,746,379,367,666,320,346,0.913,0.893,0.872,38180,539
"4997",166124,2010,1,0,"College of the Holy Cross",NA,NA,727,379,348,645,298,347,0.916,0.887,0.856,39330,464
"4998",166513,1991,1,0,"UNIVERSITY OF MASSACHUSETTS AT LOWELL",NA,NA,1075,386,689,276,146,130,0.337,0.257,0.212,4337,902
"4999",166513,1992,1,0,"UNIVERSITY OF MASSACHUSETTS AT LOWELL",NA,NA,964,340,624,239,134,105,0.309,0.248,0.215,4513,806
"5000",166513,1993,1,0,"UNIVERSITY OF MASSACHUSETTS-LOWELL",NA,NA,1033,392,641,217,108,109,0.278,0.21,0.168,4602,886
"5001",166513,1995,1,0,"UNIVERSITY OF MASSACHUSETTS-LOWELL",NA,NA,1102,422,680,195,90,105,0.249,0.177,0.132,4606,874
"5002",166513,1996,1,0,"UNIVERSITY OF MASSACHUSETTS-LOWELL",NA,NA,1022,428,594,228,96,132,0.308,0.223,0.162,4512,811
"5003",166513,1997,1,0,"UNIVERSITY OF MASSACHUSETTS-LOWELL",NA,NA,989,367,622,232,104,128,0.349,0.235,0.167,4422,768
"5004",166513,1998,1,0,"UNIVERSITY OF MASSACHUSETTS-LOWELL",NA,NA,997,366,631,235,116,119,0.325,0.236,0.184,4337,792
"5005",166513,1999,1,0,"UNIVERSITY OF MASSACHUSETTS-LOWELL",NA,NA,935,368,567,230,91,139,0.378,0.246,0.16,1454,587
"5006",166513,2000,1,0,"UNIVERSITY OF MASSACHUSETTS-LOWELL",NA,NA,996,373,623,299,140,159,0.426,0.3,0.225,1454,670
"5007",166513,2001,1,0,"UNIVERSITY OF MASSACHUSETTS-LOWELL",NA,NA,967,349,618,269,128,141,0.404,0.278,0.207,1454,568
"5008",166513,2002,1,0,"UNIVERSITY OF MASSACHUSETTS-LOWELL",NA,NA,1013,371,642,289,138,151,0.407,0.285,0.215,1454,716
"5009",166513,2003,1,0,"UNIVERSITY OF MASSACHUSETTS-LOWELL",NA,NA,1008,393,615,291,145,146,0.372,0.289,0.236,1454,842
"5010",166513,2004,1,0,"UNIVERSITY OF MASSACHUSETTS-LOWELL",NA,NA,996,333,663,286,134,152,0.456,0.287,0.202,1454,791
"5011",166513,2005,1,0,"University of Massachusetts-Lowell",NA,NA,1062,390,672,318,160,158,0.405,0.299,0.238,1454,840
"5012",166513,2006,1,0,"University of Massachusetts-Lowell",NA,NA,1208,451,757,355,190,165,0.366,0.294,0.251,1454,908
"5013",166513,2007,1,0,"University of Massachusetts-Lowell",NA,NA,1220,424,796,346,179,167,0.394,0.284,0.225,1454,971
"5014",166513,2008,1,0,"University of Massachusetts-Lowell",NA,NA,1514,540,974,411,213,198,0.367,0.271,0.219,1454,1139
"5015",166513,2009,1,0,"University of Massachusetts-Lowell",NA,NA,1499,548,951,465,243,222,0.405,0.31,0.256,1454,1102
"5016",166513,2010,1,0,"University of Massachusetts-Lowell",NA,NA,1601,575,1026,514,272,242,0.421,0.321,0.265,1454,1196
"5017",166629,1991,1,0,"UNIVERSITY OF MASSACHUSETTS AT AMHERST",NA,NA,3435,1665,1770,1271,511,760,0.456,0.37,0.289,4863,2863
"5018",166629,1992,1,0,"UNIVERSITY OF MASSACHUSETTS AT AMHERST",NA,NA,3993,1940,2053,1329,538,791,0.408,0.333,0.262,5062,3239
"5019",166629,1993,1,0,"UNIVERSITY OF MASSACHUSETTS-AMHERST",NA,NA,3926,1908,2018,1436,577,859,0.45,0.366,0.286,5467,3187
"5020",166629,1995,1,0,"UNIVERSITY OF MASSACHUSETTS-AMHERST",NA,NA,3959,1946,2013,1429,583,846,0.435,0.361,0.29,5514,3166
"5021",166629,1996,1,0,"UNIVERSITY OF MASSACHUSETTS-AMHERST",NA,NA,4073,1964,2109,1577,660,917,0.467,0.387,0.313,5413,2951
"5022",166629,1997,1,0,"UNIVERSITY OF MASSACHUSETTS-AMHERST",NA,NA,3831,2012,1819,1635,614,1021,0.508,0.427,0.338,5329,2729
"5023",166629,1998,1,0,"UNIVERSITY OF MASSACHUSETTS-AMHERST",NA,NA,3953,2021,1932,1651,625,1026,0.508,0.418,0.323,5229,2840
"5024",166629,1999,1,0,"UNIVERSITY OF MASSACHUSETTS-AMHERST",NA,NA,4144,2199,1945,1824,701,1123,0.511,0.44,0.36,1714,3065
"5025",166629,2000,1,0,"UNIVERSITY OF MASSACHUSETTS-AMHERST",NA,NA,3803,2086,1717,1768,667,1101,0.528,0.465,0.388,1714,2933
"5026",166629,2001,1,0,"UNIVERSITY OF MASSACHUSETTS-AMHERST",NA,NA,4289,2298,1991,2046,783,1263,0.55,0.477,0.393,1714,3316
"5027",166629,2002,1,0,"UNIVERSITY OF MASSACHUSETTS-AMHERST",NA,NA,3411,1799,1612,1682,707,975,0.542,0.493,0.439,1714,2678
"5028",166629,2003,1,0,"UNIVERSITY OF MASSACHUSETTS-AMHERST",NA,NA,4149,2060,2089,1958,850,1108,0.538,0.472,0.407,1714,3237
"5029",166629,2004,1,0,"UNIVERSITY OF MASSACHUSETTS-AMHERST",NA,NA,4311,2126,2185,2196,968,1228,0.578,0.509,0.443,1714,3325
"5030",166629,2005,1,0,"University of Massachusetts-Amherst",NA,NA,4510,2316,2194,2268,970,1298,0.56,0.503,0.442,1714,3541
"5031",166629,2006,1,0,"University of Massachusetts-Amherst",NA,NA,4265,2174,2091,2259,1002,1257,0.578,0.53,0.479,1714,3116
"5032",166629,2007,1,0,"University of Massachusetts Amherst",NA,NA,4374,2321,2053,2504,1060,1444,0.622,0.572,0.516,1714,3165
"5033",166629,2008,1,0,"University of Massachusetts Amherst",NA,NA,4256,2200,2056,2594,1140,1454,0.661,0.609,0.554,1714,2869
"5034",166629,2009,1,0,"University of Massachusetts Amherst",NA,NA,4215,2175,2040,2703,1192,1511,0.695,0.641,0.584,1714,2653
"5035",166629,2010,1,0,"University of Massachusetts Amherst",NA,NA,4543,2296,2247,2986,1336,1650,0.719,0.657,0.595,1714,2958
"5036",166638,1991,1,0,"UNIVERSITY OF MASSACHUSETTS AT BOSTON",NA,NA,529,270,259,68,27,41,0.152,0.129,0.104,3937,296
"5037",166638,1992,1,0,"UNIVERSITY OF MASSACHUSETTS AT BOSTON",NA,NA,534,256,278,48,18,30,0.117,0.09,0.065,4094,280
"5038",166638,1993,1,0,"UNIVERSITY OF MASSACHUSETTS-BOSTON",NA,NA,546,253,293,44,15,29,0.115,0.081,0.051,4253,275
"5039",166638,1995,1,0,"UNIVERSITY OF MASSACHUSETTS-BOSTON",NA,NA,502,222,280,38,17,21,0.095,0.076,0.061,4405,229
"5040",166638,1996,1,0,"UNIVERSITY OF MASSACHUSETTS-BOSTON",NA,NA,538,274,264,55,14,41,0.15,0.102,0.053,4348,260
"5041",166638,1997,1,0,"UNIVERSITY OF MASSACHUSETTS-BOSTON",NA,NA,533,284,249,65,25,40,0.141,0.122,0.1,4290,232
"5042",166638,1998,1,0,"UNIVERSITY OF MASSACHUSETTS-BOSTON",NA,NA,579,307,272,69,29,40,0.13,0.119,0.107,4197,256
"5043",166638,1999,1,0,"UNIVERSITY OF MASSACHUSETTS-BOSTON",NA,NA,671,368,303,102,33,69,0.188,0.152,0.109,1714,287
"5044",166638,2000,1,0,"UNIVERSITY OF MASSACHUSETTS-BOSTON",NA,NA,593,326,267,91,14,77,0.236,0.153,0.052,1714,271
"5045",166638,2001,1,0,"UNIVERSITY OF MASSACHUSETTS-BOSTON",NA,NA,676,359,317,67,22,45,0.125,0.099,0.069,1714,277
"5046",166638,2002,1,0,"UNIVERSITY OF MASSACHUSETTS-BOSTON",NA,NA,534,307,227,64,16,48,0.156,0.12,0.07,1714,218
"5047",166638,2003,1,0,"UNIVERSITY OF MASSACHUSETTS-BOSTON",NA,NA,602,353,249,60,21,39,0.111,0.1,0.084,1714,260
"5048",166638,2004,1,0,"UNIVERSITY OF MASSACHUSETTS-BOSTON",NA,NA,543,323,220,61,12,49,0.152,0.112,0.055,1714,216
"5049",166638,2005,1,0,"University of Massachusetts-Boston",NA,NA,723,419,304,100,34,66,0.158,0.138,0.112,1714,328
"5050",166638,2006,1,0,"University of Massachusetts-Boston",NA,NA,846,484,362,109,29,80,0.165,0.129,0.08,1714,388
"5051",166638,2007,1,0,"University of Massachusetts-Boston",NA,NA,950,558,392,144,42,102,0.183,0.152,0.107,1714,419
"5052",166638,2008,1,0,"University of Massachusetts-Boston",NA,NA,972,570,402,154,60,94,0.165,0.158,0.149,1714,441
"5053",166638,2009,1,0,"University of Massachusetts-Boston",NA,NA,934,545,389,154,53,101,0.185,0.165,0.136,1714,429
"5054",166638,2010,1,0,"University of Massachusetts-Boston",NA,NA,1067,595,472,194,55,139,0.234,0.182,0.117,1714,459
"5055",166683,1991,1,0,"MASSACHUSETTS INSTITUTE OF TECHNOLOGY",NA,NA,1048,367,681,825,516,309,0.842,0.787,0.758,16900,511
"5056",166683,1992,1,0,"MASSACHUSETTS INSTITUTE OF TECHNOLOGY",NA,NA,1137,398,739,919,583,336,0.844,0.808,0.789,18000,549
"5057",166683,1993,1,0,"MASSACHUSETTS INSTITUTE OF TECHNOLOGY",NA,NA,1074,366,708,874,546,328,0.896,0.814,0.771,19000,492
"5058",166683,1995,1,0,"MASSACHUSETTS INSTITUTE OF TECHNOLOGY",NA,NA,1115,468,647,921,517,404,0.863,0.826,0.799,21000,546
"5059",166683,1996,1,0,"MASSACHUSETTS INSTITUTE OF TECHNOLOGY",NA,NA,1065,446,619,875,498,377,0.845,0.822,0.805,22000,359
"5060",166683,1997,1,0,"MASSACHUSETTS INSTITUTE OF TECHNOLOGY",NA,NA,1066,405,661,861,521,340,0.84,0.808,0.788,23100,370
"5061",166683,1998,1,0,"MASSACHUSETTS INSTITUTE OF TECHNOLOGY",NA,NA,1042,446,596,840,466,374,0.839,0.806,0.782,24050,364
"5062",166683,1999,1,0,"MASSACHUSETTS INSTITUTE OF TECHNOLOGY",NA,NA,1049,448,601,863,473,390,0.87,0.823,0.787,25000,369
"5063",166683,2000,1,0,"MASSACHUSETTS INSTITUTE OF TECHNOLOGY",NA,NA,1010,425,585,825,468,357,0.84,0.817,0.8,26050,347
"5064",166683,2001,1,0,"MASSACHUSETTS INSTITUTE OF TECHNOLOGY",NA,NA,1027,426,601,857,479,378,0.887,0.834,0.797,26960,383
"5065",166683,2002,1,0,"MASSACHUSETTS INSTITUTE OF TECHNOLOGY",NA,NA,977,420,557,806,446,360,0.857,0.825,0.801,28030,340
"5066",166683,2003,1,0,"MASSACHUSETTS INSTITUTE OF TECHNOLOGY",NA,NA,1018,459,559,842,450,392,0.854,0.827,0.805,29400,368
"5067",166683,2004,1,0,"MASSACHUSETTS INSTITUTE OF TECHNOLOGY",NA,NA,1076,457,619,909,507,402,0.88,0.845,0.819,30600,388
"5068",166683,2005,1,0,"Massachusetts Institute of Technology",NA,NA,995,465,530,847,436,411,0.884,0.851,0.823,32100,393
"5069",166683,2006,1,0,"Massachusetts Institute of Technology",NA,NA,1001,447,554,837,457,380,0.85,0.836,0.825,33400,373
"5070",166683,2007,1,0,"Massachusetts Institute of Technology",NA,NA,1068,492,576,892,463,429,0.872,0.835,0.804,34750,412
"5071",166683,2008,1,0,"Massachusetts Institute of Technology",NA,NA,1046,487,559,849,441,408,0.838,0.812,0.789,36140,359
"5072",166683,2009,1,0,"Massachusetts Institute of Technology",NA,NA,1066,477,589,874,462,412,0.864,0.82,0.784,37510,390
"5073",166683,2010,1,0,"Massachusetts Institute of Technology",NA,NA,1063,479,584,898,478,420,0.877,0.845,0.818,38940,416
"5074",167288,1991,1,0,"NORTH ADAMS STATE COLLEGE",NA,NA,423,211,212,81,26,55,0.261,0.191,0.123,3218,397
"5075",167288,1992,1,0,"NORTH ADAMS STATE COLLEGE",NA,NA,203,105,98,49,18,31,0.295,0.241,0.184,3345,187
"5076",167288,1993,1,0,"NORTH ADAMS STATE COLLEGE",NA,NA,228,107,121,39,11,28,0.262,0.171,0.091,3493,205
"5077",167288,1995,1,0,"NORTH ADAMS STATE COLLEGE",NA,NA,290,171,119,80,15,65,0.38,0.276,0.126,3555,272
"5078",167288,1996,1,0,"NORTH ADAMS STATE COLLEGE",NA,NA,311,176,135,101,35,66,0.375,0.325,0.259,3485,283
"5079",167288,1997,1,0,"MASSACHUSETTS COLLEGE OF LIBERAL ARTS",NA,NA,274,152,122,89,30,59,0.388,0.325,0.246,3437,241
"5080",167288,1998,1,0,"MASSACHUSETTS COLLEGE OF LIBERAL ARTS",NA,NA,209,131,78,66,17,49,0.374,0.316,0.218,3377,172
"5081",167288,1999,1,0,"MASSACHUSETTS COLLEGE OF LIBERAL ARTS",NA,NA,220,135,85,78,27,51,0.378,0.355,0.318,1090,181
"5082",167288,2000,1,0,"MASSACHUSETTS COLLEGE OF LIBERAL ARTS",NA,NA,224,126,98,80,32,48,0.381,0.357,0.327,1090,202
"5083",167288,2001,1,0,"MASSACHUSETTS COLLEGE OF LIBERAL ARTS",NA,NA,268,171,97,85,26,59,0.345,0.317,0.268,1030,232
"5084",167288,2002,1,0,"MASSACHUSETTS COLLEGE OF LIBERAL ARTS",NA,NA,265,159,106,106,38,68,0.428,0.4,0.358,1030,240
"5085",167288,2003,1,0,"MASSACHUSETTS COLLEGE OF LIBERAL ARTS",NA,NA,244,149,95,91,28,63,0.423,0.373,0.295,1030,221
"5086",167288,2004,1,0,"MASSACHUSETTS COLLEGE OF LIBERAL ARTS",NA,NA,263,161,102,99,28,71,0.441,0.376,0.275,1030,231
"5087",167288,2005,1,0,"Massachusetts College of Liberal Arts",NA,NA,271,177,94,104,36,68,0.384,0.384,0.383,1030,238
"5088",167288,2006,1,0,"Massachusetts College of Liberal Arts",NA,NA,299,175,124,94,33,61,0.349,0.314,0.266,1030,246
"5089",167288,2007,1,0,"Massachusetts College of Liberal Arts",NA,NA,334,207,127,128,37,91,0.44,0.383,0.291,1030,285
"5090",167288,2008,1,0,"Massachusetts College of Liberal Arts",NA,NA,325,193,132,109,38,71,0.368,0.335,0.288,1030,265
"5091",167288,2009,1,0,"Massachusetts College of Liberal Arts",NA,NA,347,229,118,119,40,79,0.345,0.343,0.339,1030,265
"5092",167288,2010,1,0,"Massachusetts College of Liberal Arts",NA,NA,351,225,126,133,41,92,0.409,0.379,0.325,1030,249
"5093",167987,1991,1,0,"UNIVERSITY OF MASSACHUSETTS AT DARTMOUTH",NA,NA,989,515,474,285,109,176,0.342,0.288,0.23,3053,878
"5094",167987,1992,1,0,"UNIVERSITY OF MASSACHUSETTS DARTMOUTH",NA,NA,869,453,416,223,75,148,0.327,0.257,0.18,3163,800
"5095",167987,1993,1,0,"UNIVERSITY OF MASSACHUSETTS-DARTMOUTH",NA,NA,985,489,496,234,87,147,0.301,0.238,0.175,3568,853
"5096",167987,1995,1,0,"UNIVERSITY OF MASSACHUSETTS-DARTMOUTH",NA,NA,886,420,466,253,90,163,0.388,0.286,0.193,4122,709
"5097",167987,1996,1,0,"UNIVERSITY OF MASSACHUSETTS-DARTMOUTH",NA,NA,825,429,396,240,71,169,0.394,0.291,0.179,4151,619
"5098",167987,1997,1,0,"UNIVERSITY OF MASSACHUSETTS-DARTMOUTH",NA,NA,835,440,395,217,72,145,0.33,0.26,0.182,4254,638
"5099",167987,1998,1,0,"UNIVERSITY OF MASSACHUSETTS-DARTMOUTH",NA,NA,1086,535,551,284,102,182,0.34,0.262,0.185,4171,853
"5100",167987,1999,1,0,"UNIVERSITY OF MASSACHUSETTS-DARTMOUTH",NA,NA,1131,556,575,316,126,190,0.342,0.279,0.219,1417,891
"5101",167987,2000,1,0,"UNIVERSITY OF MASSACHUSETTS-DARTMOUTH",NA,NA,1300,642,658,363,142,221,0.344,0.279,0.216,1417,1040
"5102",167987,2001,1,0,"UNIVERSITY OF MASSACHUSETTS-DARTMOUTH",NA,NA,1148,575,573,310,125,185,0.322,0.27,0.218,1417,924
"5103",167987,2002,1,0,"UNIVERSITY OF MASSACHUSETTS-DARTMOUTH",NA,NA,1699,825,874,452,191,261,0.316,0.266,0.219,1417,1351
"5104",167987,2003,1,0,"UNIVERSITY OF MASSACHUSETTS-DARTMOUTH",NA,NA,1510,764,746,489,187,302,0.395,0.324,0.251,1417,1215
"5105",167987,2004,1,0,"UNIVERSITY OF MASSACHUSETTS-DARTMOUTH",NA,NA,1456,715,741,416,147,269,0.376,0.286,0.198,1417,1173
"5106",167987,2005,1,0,"University of Massachusetts-Dartmouth",NA,NA,1703,816,887,505,212,293,0.359,0.297,0.239,1417,1394
"5107",167987,2006,1,0,"University of Massachusetts-Dartmouth",NA,NA,1763,866,897,559,248,311,0.359,0.317,0.276,1417,1460
"5108",167987,2007,1,0,"University of Massachusetts-Dartmouth",NA,NA,1901,859,1042,575,262,313,0.364,0.302,0.251,1417,1590
"5109",167987,2008,1,0,"University of Massachusetts-Dartmouth",NA,NA,1768,837,931,485,210,275,0.329,0.274,0.226,1417,1447
"5110",167987,2009,1,0,"University of Massachusetts-Dartmouth",NA,NA,1780,822,958,494,212,282,0.343,0.278,0.221,1417,1400
"5111",167987,2010,1,0,"University of Massachusetts-Dartmouth",NA,NA,1667,765,902,471,208,263,0.344,0.283,0.231,1417,1085
"5112",167996,1991,1,0,"STONEHILL COLLEGE",NA,NA,518,279,239,359,160,199,0.713,0.693,0.669,10240,494
"5113",167996,1992,1,0,"STONEHILL COLLEGE",NA,NA,514,314,200,387,135,252,0.802,0.753,0.675,10820,494
"5114",167996,1993,1,0,"STONEHILL COLLEGE",NA,NA,585,331,254,411,159,252,0.761,0.703,0.626,11420,552
"5115",167996,1995,1,0,"STONEHILL COLLEGE",NA,NA,547,328,219,443,166,277,0.845,0.81,0.758,13284,499
"5116",167996,1996,1,0,"STONEHILL COLLEGE",NA,NA,551,310,241,419,169,250,0.807,0.76,0.701,14170,509
"5117",167996,1997,1,0,"STONEHILL COLLEGE",NA,NA,530,287,243,429,185,244,0.85,0.809,0.761,14856,486
"5118",167996,1998,1,0,"STONEHILL COLLEGE",NA,NA,531,313,218,421,168,253,0.808,0.793,0.771,15730,495
"5119",167996,1999,1,0,"STONEHILL COLLEGE",NA,NA,572,333,239,458,185,273,0.82,0.801,0.774,15736,522
"5120",167996,2000,1,0,"STONEHILL COLLEGE",NA,NA,629,363,266,517,210,307,0.846,0.822,0.789,16680,582
"5121",167996,2001,1,0,"STONEHILL COLLEGE",NA,NA,586,328,258,479,203,276,0.842,0.817,0.787,17680,522
"5122",167996,2002,1,0,"STONEHILL COLLEGE",NA,NA,566,342,224,448,160,288,0.842,0.792,0.714,19094,517
"5123",167996,2003,1,0,"STONEHILL COLLEGE",NA,NA,565,307,258,451,193,258,0.84,0.798,0.748,20432,496
"5124",167996,2004,1,0,"STONEHILL COLLEGE",NA,NA,614,384,230,494,171,323,0.841,0.805,0.743,22068,554
"5125",167996,2005,1,0,"Stonehill College",NA,NA,616,354,262,478,190,288,0.814,0.776,0.725,24160,557
"5126",167996,2006,1,0,"Stonehill College",NA,NA,594,363,231,469,173,296,0.815,0.79,0.749,26345,542
"5127",167996,2007,1,0,"Stonehill College",NA,NA,659,409,250,539,199,340,0.831,0.818,0.796,28065,615
"5128",167996,2008,1,0,"Stonehill College",NA,NA,634,384,250,503,185,318,0.828,0.793,0.74,30150,570
"5129",167996,2009,1,0,"Stonehill College",NA,NA,683,397,286,564,219,345,0.869,0.826,0.766,31210,611
"5130",167996,2010,1,0,"Stonehill College",NA,NA,727,469,258,556,180,376,0.802,0.765,0.698,32620,629
"5131",168005,1991,1,0,"SUFFOLK UNIVERSITY",NA,NA,421,214,207,137,55,82,0.383,0.325,0.266,8535,299
"5132",168005,1992,1,0,"SUFFOLK UNIVERSITY",NA,NA,382,190,192,113,43,70,0.368,0.296,0.224,9150,274
"5133",168005,1993,1,0,"SUFFOLK UNIVERSITY",NA,NA,357,185,172,114,43,71,0.384,0.319,0.25,9940,207
"5134",168005,1995,1,0,"SUFFOLK UNIVERSITY",NA,NA,386,214,172,110,39,71,0.332,0.285,0.227,11450,231
"5135",168005,1996,1,0,"SUFFOLK UNIVERSITY",NA,NA,507,288,219,140,46,94,0.326,0.276,0.21,12200,314
"5136",168005,1997,1,0,"SUFFOLK UNIVERSITY",NA,NA,525,299,226,198,70,128,0.428,0.377,0.31,12900,340
"5137",168005,1998,1,0,"SUFFOLK UNIVERSITY",NA,NA,620,355,265,208,75,133,0.375,0.335,0.283,13740,385
"5138",168005,1999,1,0,"SUFFOLK UNIVERSITY",NA,NA,672,381,291,240,72,168,0.441,0.357,0.247,14580,423
"5139",168005,2000,1,0,"SUFFOLK UNIVERSITY",NA,NA,645,371,274,243,87,156,0.42,0.377,0.318,15538,417
"5140",168005,2001,1,0,"SUFFOLK UNIVERSITY",NA,NA,710,393,317,285,116,169,0.43,0.401,0.366,16536,433
"5141",168005,2002,1,0,"SUFFOLK UNIVERSITY",NA,NA,787,481,306,307,88,219,0.455,0.39,0.288,17610,497
"5142",168005,2003,1,0,"SUFFOLK UNIVERSITY",NA,NA,914,542,372,320,117,203,0.375,0.35,0.315,18670,614
"5143",168005,2004,1,0,"SUFFOLK UNIVERSITY",NA,NA,1014,589,425,350,123,227,0.385,0.345,0.289,19790,643
"5144",168005,2005,1,0,"Suffolk University",NA,NA,1127,682,445,416,143,273,0.4,0.369,0.321,21140,768
"5145",168005,2006,1,0,"Suffolk University",NA,NA,1286,735,551,520,197,323,0.44,0.404,0.358,22610,861
"5146",168005,2007,1,0,"Suffolk University",NA,NA,1308,752,556,531,218,313,0.416,0.406,0.392,24190,821
"5147",168005,2008,1,0,"Suffolk University",NA,NA,1557,920,637,607,215,392,0.426,0.39,0.338,25850,884
"5148",168005,2009,1,0,"Suffolk University",NA,NA,1257,736,521,510,182,328,0.446,0.406,0.349,27100,588
"5149",168005,2010,1,0,"Suffolk University",NA,NA,1307,739,568,582,221,361,0.489,0.445,0.389,28414,727
"5150",168148,1991,1,0,"TUFTS UNIVERSITY",NA,NA,1155,640,515,870,378,492,0.769,0.753,0.734,16755,729
"5151",168148,1992,1,0,"TUFTS UNIVERSITY",NA,NA,1211,638,573,921,426,495,0.776,0.761,0.743,17897,782
"5152",168148,1993,1,0,"TUFTS UNIVERSITY",NA,NA,1193,632,561,923,422,501,0.793,0.774,0.752,18793,750
"5153",168148,1995,1,0,"TUFTS UNIVERSITY",NA,NA,1147,594,553,944,439,505,0.85,0.823,0.794,21086,650
"5154",168148,1996,1,0,"TUFTS UNIVERSITY",NA,NA,1179,597,582,950,452,498,0.834,0.806,0.777,21957,639
"5155",168148,1997,1,0,"TUFTS UNIVERSITY",NA,NA,1270,659,611,1063,498,565,0.857,0.837,0.815,22811,695
"5156",168148,1998,1,0,"TUFTS UNIVERSITY",NA,NA,1236,668,568,1040,466,574,0.859,0.841,0.82,23709,684
"5157",168148,1999,1,0,"TUFTS UNIVERSITY",NA,NA,1345,741,604,1134,497,637,0.86,0.843,0.823,24126,758
"5158",168148,2000,1,0,"TUFTS UNIVERSITY",NA,NA,1181,637,544,1022,464,558,0.876,0.865,0.853,25062,618
"5159",168148,2001,1,0,"TUFTS UNIVERSITY",NA,NA,1163,640,523,970,426,544,0.85,0.834,0.815,26213,601
"5160",168148,2002,1,0,"TUFTS UNIVERSITY",NA,NA,1276,736,540,1094,455,639,0.868,0.857,0.843,27450,676
"5161",168148,2003,1,0,"TUFTS UNIVERSITY",NA,NA,1281,664,617,1087,507,580,0.873,0.849,0.822,28896,696
"5162",168148,2004,1,0,"TUFTS UNIVERSITY",NA,NA,1273,635,638,1101,537,564,0.888,0.865,0.842,30377,748
"5163",168148,2005,1,0,"Tufts University",NA,NA,1364,682,682,1159,559,600,0.88,0.85,0.82,31828,806
"5164",168148,2006,1,0,"Tufts University",NA,NA,1280,648,632,1120,543,577,0.89,0.875,0.859,33906,779
"5165",168148,2007,1,0,"Tufts University",NA,NA,1370,703,667,1194,570,624,0.888,0.872,0.855,35842,791
"5166",168148,2008,1,0,"Tufts University",NA,NA,1298,702,596,1141,511,630,0.897,0.879,0.857,37952,758
"5167",168148,2009,1,0,"Tufts University",NA,NA,1302,669,633,1141,542,599,0.895,0.876,0.856,39432,789
"5168",168148,2010,1,0,"Tufts University",NA,NA,1313,649,664,1138,560,578,0.891,0.867,0.843,40664,772
"5169",168254,1991,1,0,"WESTERN NEW ENGLAND COLLEGE",NA,NA,428,166,262,165,81,84,0.506,0.386,0.309,7962,404
"5170",168254,1992,1,0,"WESTERN NEW ENGLAND COLLEGE",NA,NA,431,182,249,145,82,63,0.346,0.336,0.329,8426,395
"5171",168254,1993,1,0,"WESTERN NEW ENGLAND COLLEGE",NA,NA,392,149,243,120,64,56,0.376,0.306,0.263,9314,356
"5172",168254,1995,1,0,"WESTERN NEW ENGLAND COLLEGE",NA,NA,580,222,358,223,116,107,0.482,0.384,0.324,10310,484
"5173",168254,1996,1,0,"WESTERN NEW ENGLAND COLLEGE",NA,NA,478,174,304,173,104,69,0.397,0.362,0.342,10810,391
"5174",168254,1997,1,0,"WESTERN NEW ENGLAND COLLEGE",NA,NA,526,220,306,210,98,112,0.509,0.399,0.32,11448,418
"5175",168254,1998,1,0,"WESTERN NEW ENGLAND COLLEGE",NA,NA,535,238,297,231,119,112,0.471,0.432,0.401,12130,456
"5176",168254,1999,1,0,"WESTERN NEW ENGLAND COLLEGE",NA,NA,618,271,347,268,145,123,0.454,0.434,0.418,11954,568
"5177",168254,2000,1,0,"WESTERN NEW ENGLAND COLLEGE",NA,NA,560,262,298,268,140,128,0.489,0.479,0.47,14354,498
"5178",168254,2001,1,0,"WESTERN NEW ENGLAND COLLEGE",NA,NA,654,287,367,346,176,170,0.592,0.529,0.48,14567,562
"5179",168254,2002,1,0,"WESTERN NEW ENGLAND COLLEGE",NA,NA,682,301,381,298,151,147,0.488,0.437,0.396,16144,586
"5180",168254,2003,1,0,"WESTERN NEW ENGLAND COLLEGE",NA,NA,672,279,393,275,148,127,0.455,0.409,0.377,19460,583
"5181",168254,2004,1,0,"WESTERN NEW ENGLAND COLLEGE",NA,NA,798,302,496,353,197,156,0.517,0.442,0.397,20570,700
"5182",168254,2005,1,0,"Western New England College",NA,NA,662,244,418,341,188,153,0.627,0.515,0.45,21600,575
"5183",168254,2006,1,0,"Western New England College",NA,NA,719,259,460,367,211,156,0.602,0.51,0.459,22982,645
"5184",168254,2007,1,0,"Western New England College",NA,NA,713,293,420,372,193,179,0.611,0.522,0.46,24224,628
"5185",168254,2008,1,0,"Western New England College",NA,NA,735,281,454,370,206,164,0.584,0.503,0.454,25556,642
"5186",168254,2009,1,0,"Western New England College",NA,NA,683,257,426,322,187,135,0.525,0.471,0.439,26822,558
"5187",168254,2010,1,0,"Western New England University",NA,NA,736,303,433,373,213,160,0.528,0.507,0.492,27762,589
"5188",168281,1991,1,0,"WHEATON COLLEGE",NA,NA,319,210,109,222,62,160,0.762,0.696,0.569,15650,269
"5189",168281,1992,1,0,"WHEATON COLLEGE",NA,NA,412,274,138,265,87,178,0.65,0.643,0.63,16650,349
"5190",168281,1993,1,0,"WHEATON COLLEGE",NA,NA,417,300,117,263,71,192,0.64,0.631,0.607,17670,341
"5191",168281,1995,1,0,"WHEATON COLLEGE",NA,NA,359,249,110,241,72,169,0.679,0.671,0.655,19020,312
"5192",168281,1996,1,0,"WHEATON COLLEGE",NA,NA,445,315,130,295,82,213,0.676,0.663,0.631,19740,369
"5193",168281,1997,1,0,"WHEATON COLLEGE",NA,NA,438,277,161,298,97,201,0.726,0.68,0.602,20820,364
"5194",168281,1998,1,0,"WHEATON COLLEGE",NA,NA,435,294,141,291,79,212,0.721,0.669,0.56,21840,347
"5195",168281,1999,1,0,"WHEATON COLLEGE",NA,NA,427,281,146,298,85,213,0.758,0.698,0.582,22950,351
"5196",168281,2000,1,0,"WHEATON COLLEGE",NA,NA,450,286,164,318,104,214,0.748,0.707,0.634,24225,378
"5197",168281,2001,1,0,"WHEATON COLLEGE",NA,NA,494,328,166,364,114,250,0.762,0.737,0.687,25565,397
"5198",168281,2002,1,0,"WHEATON COLLEGE",NA,NA,411,255,156,316,106,210,0.824,0.769,0.679,27105,335
"5199",168281,2003,1,0,"WHEATON COLLEGE",NA,NA,445,286,159,324,104,220,0.769,0.728,0.654,28675,338
"5200",168281,2004,1,0,"WHEATON COLLEGE",NA,NA,443,280,163,310,114,196,0.7,0.7,0.699,30355,343
"5201",168281,2005,1,0,"Wheaton College",NA,NA,467,301,166,341,119,222,0.738,0.73,0.717,32115,371
"5202",168281,2006,1,0,"Wheaton College",NA,NA,410,239,171,317,125,192,0.803,0.773,0.731,34365,332
"5203",168281,2007,1,0,"Wheaton College",NA,NA,418,262,156,297,98,199,0.76,0.711,0.628,36430,301
"5204",168281,2008,1,0,"Wheaton College",NA,NA,420,259,161,313,116,197,0.761,0.745,0.72,38585,319
"5205",168281,2009,1,0,"Wheaton College",NA,NA,423,261,162,322,118,204,0.782,0.761,0.728,39565,296
"5206",168281,2010,1,0,"Wheaton College",NA,NA,450,306,144,342,103,239,0.781,0.76,0.715,40790,301
"5207",168342,1991,1,0,"WILLIAMS COLLEGE",NA,NA,517,246,271,467,238,229,0.931,0.903,0.878,16785,365
"5208",168342,1992,1,0,"WILLIAMS COLLEGE",NA,NA,518,258,260,454,225,229,0.888,0.876,0.865,17840,377
"5209",168342,1993,1,0,"WILLIAMS COLLEGE",NA,NA,527,269,258,467,222,245,0.911,0.886,0.86,18795,376
"5210",168342,1995,1,0,"WILLIAMS COLLEGE",NA,NA,524,243,281,453,237,216,0.889,0.865,0.843,20790,383
"5211",168342,1996,1,0,"WILLIAMS COLLEGE",NA,NA,553,276,277,507,248,259,0.938,0.917,0.895,21910,410
"5212",168342,1997,1,0,"WILLIAMS COLLEGE",NA,NA,544,266,278,499,253,246,0.925,0.917,0.91,23050,386
"5213",168342,1998,1,0,"WILLIAMS COLLEGE",NA,NA,537,265,272,492,252,240,0.906,0.916,0.926,23860,386
"5214",168342,1999,1,0,"WILLIAMS COLLEGE",NA,NA,544,264,280,487,244,243,0.92,0.895,0.871,24619,384
"5215",168342,2000,1,0,"WILLIAMS COLLEGE",NA,NA,528,260,268,483,240,243,0.935,0.915,0.896,24619,387
"5216",168342,2001,1,0,"WILLIAMS COLLEGE",NA,NA,520,257,263,475,236,239,0.93,0.913,0.897,25352,372
"5217",168342,2002,1,0,"WILLIAMS COLLEGE",NA,NA,539,291,248,492,226,266,0.914,0.913,0.911,26326,360
"5218",168342,2003,1,0,"WILLIAMS COLLEGE",NA,NA,533,272,261,497,245,252,0.927,0.932,0.939,27890,344
"5219",168342,2004,1,0,"WILLIAMS COLLEGE",NA,NA,532,272,260,484,234,250,0.919,0.91,0.9,29786,349
"5220",168342,2005,1,0,"Williams College",NA,NA,536,280,256,477,226,251,0.896,0.89,0.883,31548,343
"5221",168342,2006,1,0,"Williams College",NA,NA,533,280,253,484,223,261,0.932,0.908,0.881,33478,342
"5222",168342,2007,1,0,"Williams College",NA,NA,539,258,281,483,248,235,0.911,0.896,0.883,35438,336
"5223",168342,2008,1,0,"Williams College",NA,NA,538,284,254,476,222,254,0.894,0.885,0.874,37400,316
"5224",168342,2009,1,0,"Williams College",NA,NA,545,293,252,481,216,265,0.904,0.883,0.857,39250,330
"5225",168342,2010,1,0,"Williams College",NA,NA,548,288,260,471,215,256,0.889,0.859,0.827,41190,324
"5226",168546,1991,1,0,"ALBION COLLEGE",NA,NA,548,266,282,349,179,170,0.639,0.637,0.635,11064,504
"5227",168546,1992,1,0,"ALBION COLLEGE",NA,NA,508,242,266,330,173,157,0.649,0.65,0.65,12294,470
"5228",168546,1993,1,0,"ALBION COLLEGE",NA,NA,488,251,237,270,145,125,0.498,0.553,0.612,13676,411
"5229",168546,1995,1,0,"ALBION COLLEGE",NA,NA,473,238,235,334,150,184,0.773,0.706,0.638,15478,400
"5230",168546,1996,1,0,"ALBION COLLEGE",NA,NA,433,227,206,278,120,158,0.696,0.642,0.583,16160,358
"5231",168546,1997,1,0,"ALBION COLLEGE",NA,NA,474,260,214,301,114,187,0.719,0.635,0.533,16806,391
"5232",168546,1998,1,0,"ALBION COLLEGE",NA,NA,448,248,200,298,126,172,0.694,0.665,0.63,17712,380
"5233",168546,1999,1,0,"ALBION COLLEGE",NA,NA,411,219,192,275,110,165,0.753,0.669,0.573,18234,345
"5234",168546,2000,1,0,"ALBION COLLEGE",NA,NA,405,253,152,270,86,184,0.727,0.667,0.566,18690,328
"5235",168546,2001,1,0,"ALBION COLLEGE",NA,NA,450,226,224,267,115,152,0.673,0.593,0.513,19390,390
"5236",168546,2002,1,0,"ALBION COLLEGE",NA,NA,525,293,232,330,129,201,0.686,0.629,0.556,20458,472
"5237",168546,2003,1,0,"ALBION COLLEGE",NA,NA,486,263,223,306,118,188,0.715,0.63,0.529,21692,443
"5238",168546,2004,1,0,"ALBION COLLEGE",NA,NA,559,310,249,358,149,209,0.674,0.64,0.598,22650,490
"5239",168546,2005,1,0,"Albion College",NA,NA,571,315,256,372,160,212,0.673,0.651,0.625,24012,512
"5240",168546,2006,1,0,"Albion College",NA,NA,480,260,220,297,118,179,0.689,0.619,0.536,25668,413
"5241",168546,2007,1,0,"Albion College",NA,NA,500,258,242,322,144,178,0.69,0.644,0.595,27054,444
"5242",168546,2008,1,0,"Albion College",NA,NA,485,242,243,297,137,160,0.661,0.612,0.564,28380,423
"5243",168546,2009,1,0,"Albion College",NA,NA,434,218,216,241,106,135,0.619,0.555,0.491,29488,345
"5244",168546,2010,1,0,"Albion College",NA,NA,383,196,187,235,102,133,0.679,0.614,0.545,30650,322
"5245",168786,1991,1,0,"AQUINAS COLLEGE",NA,NA,231,134,97,65,26,39,0.291,0.281,0.268,8960,197
"5246",168786,1992,1,0,"AQUINAS COLLEGE",NA,NA,233,162,71,50,14,36,0.222,0.215,0.197,9722,191
"5247",168786,1993,1,0,"AQUINAS COLLEGE",NA,NA,219,152,67,67,14,53,0.349,0.306,0.209,10402,195
"5248",168786,1995,1,0,"AQUINAS COLLEGE",NA,NA,241,139,102,69,28,41,0.295,0.286,0.275,11852,222
"5249",168786,1996,1,0,"AQUINAS COLLEGE",NA,NA,283,177,106,92,28,64,0.362,0.325,0.264,12534,251
"5250",168786,1997,1,0,"AQUINAS COLLEGE",NA,NA,329,204,125,79,30,49,0.24,0.24,0.24,12910,310
"5251",168786,1998,1,0,"AQUINAS COLLEGE",NA,NA,346,213,133,75,23,52,0.244,0.217,0.173,13168,317
"5252",168786,1999,1,0,"AQUINAS COLLEGE",NA,NA,347,227,120,93,32,61,0.269,0.268,0.267,13366,318
"5253",168786,2000,1,0,"AQUINAS COLLEGE",NA,NA,362,244,118,89,24,65,0.266,0.246,0.203,14034,337
"5254",168786,2001,1,0,"AQUINAS COLLEGE",NA,NA,321,227,94,107,29,78,0.344,0.333,0.309,14876,304
"5255",168786,2002,1,0,"AQUINAS COLLEGE",NA,NA,346,216,130,85,25,60,0.278,0.246,0.192,15620,310
"5256",168786,2003,1,0,"AQUINAS COLLEGE",NA,NA,284,182,102,94,31,63,0.346,0.331,0.304,16400,264
"5257",168786,2004,1,0,"AQUINAS COLLEGE",NA,NA,316,199,117,119,45,74,0.372,0.377,0.385,16992,284
"5258",168786,2005,1,0,"Aquinas College",NA,NA,364,240,124,160,49,111,0.462,0.44,0.395,17926,317
"5259",168786,2006,1,0,"Aquinas College",NA,NA,387,252,135,192,67,125,0.496,0.496,0.496,19000,332
"5260",168786,2007,1,0,"Aquinas College",NA,NA,410,269,141,124,35,89,0.331,0.302,0.248,20048,361
"5261",168786,2008,1,0,"Aquinas College",NA,NA,456,283,173,138,43,95,0.336,0.303,0.249,21150,401
"5262",168786,2009,1,0,"Aquinas College",NA,NA,402,271,131,158,46,112,0.413,0.393,0.351,22314,349
"5263",168786,2010,1,0,"Aquinas College",NA,NA,428,255,173,140,53,87,0.341,0.327,0.306,23206,365
"5264",169080,1991,1,0,"CALVIN COLLEGE",NA,NA,858,489,369,412,168,244,0.499,0.48,0.455,8100,751
"5265",169080,1992,1,0,"CALVIN COLLEGE",NA,NA,803,474,329,369,145,224,0.473,0.46,0.441,8630,716
"5266",169080,1993,1,0,"CALVIN COLLEGE",NA,NA,908,524,384,471,194,277,0.529,0.519,0.505,9450,785
"5267",169080,1995,1,0,"CALVIN COLLEGE",NA,NA,1013,571,442,506,215,291,0.51,0.5,0.486,10995,915
"5268",169080,1996,1,0,"CALVIN COLLEGE",NA,NA,960,565,395,545,209,336,0.595,0.568,0.529,11655,846
"5269",169080,1997,1,0,"CALVIN COLLEGE",NA,NA,1053,614,439,595,243,352,0.573,0.565,0.554,12225,940
"5270",169080,1998,1,0,"CALVIN COLLEGE",NA,NA,974,536,438,559,236,323,0.603,0.574,0.539,12915,847
"5271",169080,1999,1,0,"CALVIN COLLEGE",NA,NA,1059,591,468,574,225,349,0.591,0.542,0.481,13420,914
"5272",169080,2000,1,0,"CALVIN COLLEGE",NA,NA,1050,594,456,585,241,344,0.579,0.557,0.529,14040,893
"5273",169080,2001,1,0,"CALVIN COLLEGE",NA,NA,1026,601,425,571,214,357,0.594,0.557,0.504,14870,863
"5274",169080,2002,1,0,"CALVIN COLLEGE",NA,NA,1045,577,468,586,228,358,0.62,0.561,0.487,15750,905
"5275",169080,2003,1,0,"CALVIN COLLEGE",NA,NA,1041,577,464,572,230,342,0.593,0.549,0.496,16775,876
"5276",169080,2004,1,0,"CALVIN COLLEGE",NA,NA,899,467,432,524,245,279,0.597,0.583,0.567,17770,766
"5277",169080,2005,1,0,"Calvin College",NA,NA,1000,564,436,598,232,366,0.649,0.598,0.532,18925,866
"5278",169080,2006,1,0,"Calvin College",NA,NA,1020,551,469,615,268,347,0.63,0.603,0.571,20245,867
"5279",169080,2007,1,0,"Calvin College",NA,NA,1034,556,478,590,246,344,0.619,0.571,0.515,21460,846
"5280",169080,2008,1,0,"Calvin College",NA,NA,935,500,435,539,235,304,0.608,0.576,0.54,22940,751
"5281",169080,2009,1,0,"Calvin College",NA,NA,943,492,451,540,244,296,0.602,0.573,0.541,23810,749
"5282",169080,2010,1,0,"Calvin College",NA,NA,929,469,460,573,250,323,0.689,0.617,0.543,24645,719
"5283",169798,1991,1,0,"EASTERN MICHIGAN UNIVERSITY",NA,NA,2232,1255,977,176,65,111,0.088,0.079,0.067,2347,1785
"5284",169798,1992,1,0,"EASTERN MICHIGAN UNIVERSITY",NA,NA,2149,1200,949,174,50,124,0.103,0.081,0.053,2471,1681
"5285",169798,1993,1,0,"EASTERN MICHIGAN UNIVERSITY",NA,NA,2242,1217,1025,180,67,113,0.093,0.08,0.065,2804,1675
"5286",169798,1995,1,0,"EASTERN MICHIGAN UNIVERSITY",NA,NA,2172,1230,942,198,65,133,0.108,0.091,0.069,3314,1642
"5287",169798,1996,1,0,"EASTERN MICHIGAN UNIVERSITY",NA,NA,2298,1371,927,225,77,148,0.108,0.098,0.083,3399,1720
"5288",169798,1997,1,0,"EASTERN MICHIGAN UNIVERSITY",NA,NA,2314,1372,942,260,80,180,0.131,0.112,0.085,3529,1706
"5289",169798,1998,1,0,"EASTERN MICHIGAN UNIVERSITY",NA,NA,2349,1426,923,244,79,165,0.116,0.104,0.086,3645,1749
"5290",169798,1999,1,0,"EASTERN MICHIGAN UNIVERSITY",NA,NA,2767,1627,1140,298,93,205,0.126,0.108,0.082,3146,1927
"5291",169798,2000,1,0,"EASTERN MICHIGAN UNIVERSITY",NA,NA,2664,1619,1045,327,109,218,0.135,0.123,0.104,3097,1885
"5292",169798,2001,1,0,"EASTERN MICHIGAN UNIVERSITY",NA,NA,2706,1627,1079,284,92,192,0.118,0.105,0.085,3622,1855
"5293",169798,2002,1,0,"EASTERN MICHIGAN UNIVERSITY",NA,NA,2601,1564,1037,272,91,181,0.116,0.105,0.088,4047,1785
"5294",169798,2003,1,0,"EASTERN MICHIGAN UNIVERSITY",NA,NA,2479,1510,969,295,85,210,0.139,0.119,0.088,4594,1676
"5295",169798,2004,1,0,"EASTERN MICHIGAN UNIVERSITY",NA,NA,2281,1329,952,280,85,195,0.147,0.123,0.089,4707,1508
"5296",169798,2005,1,0,"Eastern Michigan University",NA,NA,2301,1416,885,297,89,208,0.147,0.129,0.101,5463,1544
"5297",169798,2006,1,0,"Eastern Michigan University",NA,NA,2272,1315,957,276,97,179,0.136,0.121,0.101,5835,1463
"5298",169798,2007,1,0,"Eastern Michigan University",NA,NA,2365,1345,1020,294,109,185,0.138,0.124,0.107,6390,1437
"5299",169798,2008,1,0,"Eastern Michigan University",NA,NA,2167,1283,884,269,84,185,0.144,0.124,0.095,6885,1176
"5300",169798,2009,1,0,"Eastern Michigan University",NA,NA,2196,1308,888,288,84,204,0.156,0.131,0.095,7148,1298
"5301",169798,2010,1,0,"Eastern Michigan University",NA,NA,1955,1152,803,254,75,179,0.155,0.13,0.093,7148,1080
"5302",169910,1991,0,1,"FERRIS STATE UNIVERSITY",1993,0,2377,889,1488,90,47,43,0.048,0.038,0.032,2565,1994
"5303",169910,1992,0,1,"FERRIS STATE UNIVERSITY",1993,0,2051,835,1216,57,28,29,0.035,0.028,0.023,2970,1617
"5304",169910,1993,1,0,"FERRIS STATE UNIVERSITY",1993,1,2114,810,1304,51,26,25,0.031,0.024,0.02,3222,1681
"5305",169910,1995,1,0,"FERRIS STATE UNIVERSITY",1993,1,1893,752,1141,55,28,27,0.036,0.029,0.025,3532,1439
"5306",169910,1996,1,0,"FERRIS STATE UNIVERSITY",1993,1,1831,731,1100,48,28,20,0.027,0.026,0.025,3630,1413
"5307",169910,1997,1,0,"FERRIS STATE UNIVERSITY",1993,1,1906,763,1143,46,21,25,0.033,0.024,0.018,3808,1504
"5308",169910,1998,1,0,"FERRIS STATE UNIVERSITY",1993,1,1946,812,1134,53,25,28,0.034,0.027,0.022,3998,1472
"5309",169910,1999,1,0,"FERRIS STATE UNIVERSITY",1993,1,1916,798,1118,78,44,34,0.043,0.041,0.039,4118,1511
"5310",169910,2000,1,0,"FERRIS STATE UNIVERSITY",1993,1,2147,883,1264,94,47,47,0.053,0.044,0.037,4284,1667
"5311",169910,2001,1,0,"FERRIS STATE UNIVERSITY",1993,1,2128,901,1227,123,66,57,0.063,0.058,0.054,4670,1671
"5312",169910,2002,1,0,"FERRIS STATE UNIVERSITY",1993,1,2035,882,1153,138,67,71,0.08,0.068,0.058,5334,1653
"5313",169910,2003,1,0,"FERRIS STATE UNIVERSITY",1993,1,2205,960,1245,137,67,70,0.073,0.062,0.054,6044,1821
"5314",169910,2004,1,0,"FERRIS STATE UNIVERSITY",1993,1,1924,834,1090,127,60,67,0.08,0.066,0.055,6190,1559
"5315",169910,2005,1,0,"Ferris State University",1993,1,2189,1003,1186,140,59,81,0.081,0.064,0.05,6740,1744
"5316",169910,2006,1,0,"Ferris State University",1993,1,1895,860,1035,167,82,85,0.099,0.088,0.079,7200,1660
"5317",169910,2007,1,0,"Ferris State University",1993,1,2035,933,1102,182,79,103,0.11,0.089,0.072,8460,1645
"5318",169910,2008,1,0,"Ferris State University",1993,1,2103,992,1111,169,75,94,0.095,0.08,0.068,9000,1680
"5319",169910,2009,1,0,"Ferris State University",1993,1,1958,980,978,152,58,94,0.096,0.078,0.059,9480,1529
"5320",169910,2010,1,0,"Ferris State University",1993,1,1960,976,984,143,59,84,0.086,0.073,0.06,9930,1533
"5321",170082,1991,1,0,"GRAND VALLEY STATE UNIVERSITY",NA,NA,1545,941,604,240,63,177,0.188,0.155,0.104,2306,1377
"5322",170082,1992,1,0,"GRAND VALLEY STATE UNIVERSITY",NA,NA,1557,982,575,289,91,198,0.202,0.186,0.158,2508,1378
"5323",170082,1993,1,0,"GRAND VALLEY STATE UNIVERSITY",NA,NA,1511,916,595,262,79,183,0.2,0.173,0.133,2742,1341
"5324",170082,1995,1,0,"GRAND VALLEY STATE UNIVERSITY",NA,NA,1773,1087,686,287,95,192,0.177,0.162,0.138,3140,1575
"5325",170082,1996,1,0,"GRAND VALLEY STATE UNIVERSITY",NA,NA,2039,1200,839,356,112,244,0.203,0.175,0.133,3226,1835
"5326",170082,1997,1,0,"GRAND VALLEY STATE UNIVERSITY",NA,NA,2406,1494,912,410,120,290,0.194,0.17,0.132,3288,2187
"5327",170082,1998,1,0,"GRAND VALLEY STATE UNIVERSITY",NA,NA,2482,1544,938,469,153,316,0.205,0.189,0.163,3362,2235
"5328",170082,1999,1,0,"GRAND VALLEY STATE UNIVERSITY",NA,NA,2528,1553,975,512,163,349,0.225,0.203,0.167,4048,2283
"5329",170082,2000,1,0,"GRAND VALLEY STATE UNIVERSITY",NA,NA,2831,1732,1099,548,166,382,0.221,0.194,0.151,4230,2577
"5330",170082,2001,1,0,"GRAND VALLEY STATE UNIVERSITY",NA,NA,2977,1826,1151,569,189,380,0.208,0.191,0.164,4660,2642
"5331",170082,2002,1,0,"GRAND VALLEY STATE UNIVERSITY",NA,NA,2868,1801,1067,634,188,446,0.248,0.221,0.176,5056,2573
"5332",170082,2003,1,0,"GRAND VALLEY STATE UNIVERSITY",NA,NA,3270,2096,1174,851,257,594,0.283,0.26,0.219,5254,2842
"5333",170082,2004,1,0,"GRAND VALLEY STATE UNIVERSITY",NA,NA,3324,2123,1201,875,270,605,0.285,0.263,0.225,5782,2881
"5334",170082,2005,1,0,"Grand Valley State University",NA,NA,3407,2220,1187,1011,308,703,0.317,0.297,0.259,6220,2864
"5335",170082,2006,1,0,"Grand Valley State University",NA,NA,3556,2276,1280,1116,346,770,0.338,0.314,0.27,6588,2948
"5336",170082,2007,1,0,"Grand Valley State University",NA,NA,3446,2201,1245,1137,346,791,0.359,0.33,0.278,7240,2850
"5337",170082,2008,1,0,"Grand Valley State University",NA,NA,3879,2413,1466,1216,403,813,0.337,0.313,0.275,8196,3464
"5338",170082,2009,1,0,"Grand Valley State University",NA,NA,3716,2278,1438,1363,461,902,0.396,0.367,0.321,8630,3271
"5339",170082,2010,1,0,"Grand Valley State University",NA,NA,3414,2084,1330,1165,413,752,0.361,0.341,0.311,9088,2900
"5340",170301,1991,1,0,"HOPE COLLEGE",NA,NA,554,317,237,278,99,179,0.565,0.502,0.418,10086,515
"5341",170301,1992,1,0,"HOPE COLLEGE",NA,NA,687,408,279,371,134,237,0.581,0.54,0.48,10792,640
"5342",170301,1993,1,0,"HOPE COLLEGE",NA,NA,657,360,297,360,157,203,0.564,0.548,0.529,11542,599
"5343",170301,1995,1,0,"HOPE COLLEGE",NA,NA,709,418,291,412,143,269,0.643,0.581,0.491,13234,660
"5344",170301,1996,1,0,"HOPE COLLEGE",NA,NA,695,415,280,474,166,308,0.742,0.682,0.593,14310,657
"5345",170301,1997,1,0,"HOPE COLLEGE",NA,NA,721,432,289,450,164,286,0.662,0.624,0.567,14878,673
"5346",170301,1998,1,0,"HOPE COLLEGE",NA,NA,747,462,285,446,148,298,0.645,0.597,0.519,15470,708
"5347",170301,1999,1,0,"HOPE COLLEGE",NA,NA,755,455,300,485,184,301,0.662,0.642,0.613,15934,709
"5348",170301,2000,1,0,"HOPE COLLEGE",NA,NA,754,468,286,480,170,310,0.662,0.637,0.594,16554,683
"5349",170301,2001,1,0,"HOPE COLLEGE",NA,NA,763,468,295,474,158,316,0.675,0.621,0.536,17348,718
"5350",170301,2002,1,0,"HOPE COLLEGE",NA,NA,725,465,260,457,139,318,0.684,0.63,0.535,18158,676
"5351",170301,2003,1,0,"HOPE COLLEGE",NA,NA,810,515,295,531,167,364,0.707,0.656,0.566,19212,760
"5352",170301,2004,1,0,"HOPE COLLEGE",NA,NA,780,463,317,531,194,337,0.728,0.681,0.612,20300,700
"5353",170301,2005,1,0,"Hope College",NA,NA,774,463,311,531,194,337,0.728,0.686,0.624,21420,713
"5354",170301,2006,1,0,"Hope College",NA,NA,778,461,317,524,189,335,0.727,0.674,0.596,22430,714
"5355",170301,2007,1,0,"Hope College",NA,NA,819,495,324,554,199,355,0.717,0.676,0.614,23660,728
"5356",170301,2008,1,0,"Hope College",NA,NA,805,499,306,565,189,376,0.753,0.702,0.618,24780,711
"5357",170301,2009,1,0,"Hope College",NA,NA,803,486,317,515,186,329,0.677,0.641,0.587,25500,701
"5358",170301,2010,1,0,"Hope College",NA,NA,765,455,310,524,185,339,0.745,0.685,0.597,26350,660
"5359",170532,1991,0,1,"KALAMAZOO COLLEGE",9999,0,336,179,157,192,86,106,0.592,0.571,0.548,12669,294
"5360",170532,1992,0,1,"KALAMAZOO COLLEGE",9999,0,349,201,148,193,77,116,0.577,0.553,0.52,13785,303
"5361",170532,1993,0,1,"KALAMAZOO COLLEGE",9999,0,338,198,140,217,86,131,0.662,0.642,0.614,15135,298
"5362",170532,1995,0,1,"KALAMAZOO COLLEGE",9999,0,350,197,153,221,90,131,0.665,0.631,0.588,16713,305
"5363",170532,1996,0,1,"KALAMAZOO COLLEGE",9999,0,360,202,158,239,108,131,0.648,0.664,0.684,17214,313
"5364",170532,1997,0,1,"KALAMAZOO COLLEGE",9999,0,290,170,120,201,78,123,0.723,0.693,0.65,17976,247
"5365",170532,1998,0,1,"KALAMAZOO COLLEGE",9999,0,442,256,186,322,126,196,0.766,0.729,0.677,18630,391
"5366",170532,1999,0,1,"KALAMAZOO COLLEGE",9999,0,369,187,182,270,128,142,0.759,0.732,0.703,19188,318
"5367",170532,2000,0,1,"KALAMAZOO COLLEGE",9999,0,324,180,144,246,103,143,0.794,0.759,0.715,19764,260
"5368",170532,2001,0,1,"KALAMAZOO COLLEGE",9999,0,341,198,143,248,100,148,0.748,0.727,0.699,20652,289
"5369",170532,2002,0,1,"KALAMAZOO COLLEGE",9999,0,335,177,158,239,105,134,0.757,0.713,0.665,21603,267
"5370",170532,2003,0,1,"KALAMAZOO COLLEGE",9999,0,382,220,162,275,118,157,0.714,0.72,0.728,22908,309
"5371",170532,2004,0,1,"KALAMAZOO COLLEGE",9999,0,310,188,122,240,86,154,0.819,0.774,0.705,24351,239
"5372",170532,2005,0,1,"Kalamazoo College",9999,0,377,196,181,286,134,152,0.775,0.759,0.74,25644,308
"5373",170532,2006,0,1,"Kalamazoo College",9999,0,379,211,168,279,110,169,0.801,0.736,0.655,27054,277
"5374",170532,2007,0,1,"Kalamazoo College",9999,0,363,213,150,263,100,163,0.765,0.725,0.667,28716,259
"5375",170532,2008,0,1,"Kalamazoo College",9999,0,364,200,164,279,128,151,0.755,0.766,0.78,30723,274
"5376",170532,2009,0,1,"Kalamazoo College",9999,0,389,219,170,299,121,178,0.813,0.769,0.712,32643,273
"5377",170532,2010,0,1,"Kalamazoo College",9999,0,341,192,149,250,106,144,0.75,0.733,0.711,34017,211
"5378",170639,1991,1,0,"LAKE SUPERIOR STATE UNIVERSITY",NA,NA,492,221,271,60,28,32,0.145,0.122,0.103,2518,413
"5379",170639,1992,1,0,"LAKE SUPERIOR STATE UNIVERSITY",NA,NA,482,226,256,84,35,49,0.217,0.174,0.137,2694,385
"5380",170639,1993,1,0,"LAKE SUPERIOR STATE UNIVERSITY",NA,NA,593,290,303,95,35,60,0.207,0.16,0.116,3200,443
"5381",170639,1995,1,0,"LAKE SUPERIOR STATE UNIVERSITY",NA,NA,593,281,312,80,39,41,0.146,0.135,0.125,3396,480
"5382",170639,1996,1,0,"LAKE SUPERIOR STATE UNIVERSITY",NA,NA,540,247,293,63,27,36,0.146,0.117,0.092,3534,418
"5383",170639,1997,1,0,"LAKE SUPERIOR STATE UNIVERSITY",NA,NA,522,239,283,71,34,37,0.155,0.136,0.12,3642,386
"5384",170639,1998,1,0,"LAKE SUPERIOR STATE UNIVERSITY",NA,NA,575,250,325,67,27,40,0.16,0.117,0.083,3871,453
"5385",170639,1999,1,0,"LAKE SUPERIOR STATE UNIVERSITY",NA,NA,505,242,263,71,30,41,0.169,0.141,0.114,4030,392
"5386",170639,2000,1,0,"LAKE SUPERIOR STATE UNIVERSITY",NA,NA,555,262,293,76,35,41,0.156,0.137,0.119,3818,437
"5387",170639,2001,1,0,"LAKE SUPERIOR STATE UNIVERSITY",NA,NA,536,235,301,83,42,41,0.174,0.155,0.14,4128,428
"5388",170639,2002,1,0,"LAKE SUPERIOR STATE UNIVERSITY",NA,NA,574,262,312,53,29,24,0.092,0.092,0.093,4548,454
"5389",170639,2003,1,0,"LAKE SUPERIOR STATE UNIVERSITY",NA,NA,551,243,308,42,17,25,0.103,0.076,0.055,5136,453
"5390",170639,2004,1,0,"LAKE SUPERIOR STATE UNIVERSITY",NA,NA,527,242,285,67,27,40,0.165,0.127,0.095,5418,436
"5391",170639,2005,1,0,"Lake Superior State University",NA,NA,474,216,258,62,31,31,0.144,0.131,0.12,5988,379
"5392",170639,2006,1,0,"Lake Superior State University",NA,NA,454,232,222,58,23,35,0.151,0.128,0.104,6558,367
"5393",170639,2007,1,0,"Lake Superior State University",NA,NA,469,230,239,66,35,31,0.135,0.141,0.146,7176,400
"5394",170639,2008,1,0,"Lake Superior State University",NA,NA,490,250,240,72,32,40,0.16,0.147,0.133,7824,403
"5395",170639,2009,1,0,"Lake Superior State University",NA,NA,437,209,228,65,33,32,0.153,0.149,0.145,8184,358
"5396",170639,2010,1,0,"Lake Superior State University",NA,NA,501,229,272,91,54,37,0.162,0.182,0.199,8664,399
"5397",170976,1991,0,1,"UNIVERSITY OF MICHIGAN-ANN ARBOR",9999,0,4908,2299,2609,2841,1363,1478,0.643,0.579,0.522,4044,3399
"5398",170976,1992,0,1,"UNIVERSITY OF MICHIGAN-ANN ARBOR",9999,0,5006,2342,2664,3058,1490,1568,0.67,0.611,0.559,4583,3411
"5399",170976,1993,0,1,"UNIVERSITY OF MICHIGAN-ANN ARBOR",9999,0,5016,2428,2588,3078,1451,1627,0.67,0.614,0.561,5119,3366
"5400",170976,1995,0,1,"UNIVERSITY OF MICHIGAN-ANN ARBOR",9999,0,5265,2658,2607,3223,1428,1795,0.675,0.612,0.548,5842,3375
"5401",170976,1996,0,1,"UNIVERSITY OF MICHIGAN-ANN ARBOR",9999,0,5328,2710,2618,3399,1533,1866,0.689,0.638,0.586,5710,3338
"5402",170976,1997,0,1,"UNIVERSITY OF MICHIGAN-ANN ARBOR",9999,0,5535,2763,2772,3619,1656,1963,0.711,0.654,0.597,5878,3616
"5403",170976,1998,0,1,"UNIVERSITY OF MICHIGAN-ANN ARBOR",9999,0,5258,2654,2604,3531,1620,1911,0.72,0.672,0.622,6098,3321
"5404",170976,1999,0,1,"UNIVERSITY OF MICHIGAN-ANN ARBOR",9999,0,5563,2853,2710,3879,1779,2100,0.736,0.697,0.656,6148,3607
"5405",170976,2000,0,1,"UNIVERSITY OF MICHIGAN-ANN ARBOR",9999,0,5403,2860,2543,3803,1697,2106,0.736,0.704,0.667,6328,3447
"5406",170976,2001,0,1,"UNIVERSITY OF MICHIGAN-ANN ARBOR",9999,0,5531,2884,2647,3896,1752,2144,0.743,0.704,0.662,6750,3618
"5407",170976,2002,0,1,"UNIVERSITY OF MICHIGAN-ANN ARBOR",9999,0,5180,2704,2476,3641,1634,2007,0.742,0.703,0.66,7298,3402
"5408",170976,2003,0,1,"UNIVERSITY OF MICHIGAN-ANN ARBOR",9999,0,5538,2903,2635,4025,1840,2185,0.753,0.727,0.698,7788,3530
"5409",170976,2004,0,1,"UNIVERSITY OF MICHIGAN-ANN ARBOR",9999,0,6016,3033,2983,4334,1990,2344,0.773,0.72,0.667,8014,3990
"5410",170976,2005,0,1,"University of Michigan-Ann Arbor",9999,0,6080,3071,3009,4431,2061,2370,0.772,0.729,0.685,9024,3955
"5411",170976,2006,0,1,"University of Michigan-Ann Arbor",9999,0,5356,2704,2652,4072,1880,2192,0.811,0.76,0.709,9534,3555
"5412",170976,2007,0,1,"University of Michigan-Ann Arbor",9999,0,5955,3019,2936,4513,2063,2450,0.812,0.758,0.703,10258,3873
"5413",170976,2008,0,1,"University of Michigan-Ann Arbor",9999,0,5738,2905,2833,4336,1989,2347,0.808,0.756,0.702,10848,3821
"5414",170976,2009,0,1,"University of Michigan-Ann Arbor",9999,0,6019,2983,3036,4503,2101,2402,0.805,0.748,0.692,11470,4316
"5415",170976,2010,0,1,"University of Michigan-Ann Arbor",9999,0,6443,3217,3226,4929,2317,2612,0.812,0.765,0.718,11648,4480
"5416",171100,1991,0,1,"MICHIGAN STATE UNIVERSITY",1992,0,6314,3456,2858,1480,535,945,0.273,0.234,0.187,3474,5257
"5417",171100,1992,1,0,"MICHIGAN STATE UNIVERSITY",1992,1,6086,3320,2766,1897,669,1228,0.37,0.312,0.242,3876,5064
"5418",171100,1993,1,0,"MICHIGAN STATE UNIVERSITY",1992,1,6164,3372,2792,1851,641,1210,0.359,0.3,0.23,4260,5016
"5419",171100,1995,1,0,"MICHIGAN STATE UNIVERSITY",1992,1,6396,3546,2850,2076,693,1383,0.39,0.325,0.243,4521,5312
"5420",171100,1996,1,0,"MICHIGAN STATE UNIVERSITY",1992,1,6708,3728,2980,2358,809,1549,0.416,0.352,0.271,4655,5551
"5421",171100,1997,1,0,"MICHIGAN STATE UNIVERSITY",1992,1,6804,3723,3081,2232,751,1481,0.398,0.328,0.244,4789,5567
"5422",171100,1998,1,0,"MICHIGAN STATE UNIVERSITY",1992,1,6724,3767,2957,2343,757,1586,0.421,0.348,0.256,4896,5437
"5423",171100,1999,1,0,"MICHIGAN STATE UNIVERSITY",1992,1,6499,3674,2825,2580,833,1747,0.476,0.397,0.295,5003,5186
"5424",171100,2000,1,0,"MICHIGAN STATE UNIVERSITY",1992,1,6790,3756,3034,2908,1026,1882,0.501,0.428,0.338,4830,5338
"5425",171100,2001,1,0,"MICHIGAN STATE UNIVERSITY",1992,1,6755,3808,2947,2878,1041,1837,0.482,0.426,0.353,5257,5224
"5426",171100,2002,1,0,"MICHIGAN STATE UNIVERSITY",1992,1,6829,3864,2965,3127,1133,1994,0.516,0.458,0.382,5704,5275
"5427",171100,2003,1,0,"MICHIGAN STATE UNIVERSITY",1992,1,6938,3932,3006,3315,1201,2114,0.538,0.478,0.4,6266,5460
"5428",171100,2004,1,0,"MICHIGAN STATE UNIVERSITY",1992,1,7426,4073,3353,3531,1334,2197,0.539,0.475,0.398,6540,5898
"5429",171100,2005,1,0,"Michigan State University",1992,1,7303,4147,3156,3470,1232,2238,0.54,0.475,0.39,7161,5712
"5430",171100,2006,1,0,"Michigan State University",1992,1,7306,4103,3203,3800,1448,2352,0.573,0.52,0.452,7759,5639
"5431",171100,2007,1,0,"Michigan State University",1992,1,7398,4099,3299,3666,1372,2294,0.56,0.496,0.416,8672,5678
"5432",171100,2008,1,0,"Michigan State University",1992,1,7385,4098,3287,3831,1442,2389,0.583,0.519,0.439,9806,5488
"5433",171100,2009,1,0,"Michigan State University",1992,1,7249,3869,3380,3612,1445,2167,0.56,0.498,0.428,10913,5207
"5434",171100,2010,1,0,"Michigan State University",1992,1,7221,3821,3400,3685,1516,2169,0.568,0.51,0.446,11670,5213
"5435",171128,1991,0,1,"MICHIGAN TECHNOLOGICAL UNIVERSITY",2000,0,1283,319,964,234,145,89,0.279,0.182,0.15,2916,1191
"5436",171128,1992,0,1,"MICHIGAN TECHNOLOGICAL UNIVERSITY",2000,0,1260,321,939,253,169,84,0.262,0.201,0.18,3249,1143
"5437",171128,1993,0,1,"MICHIGAN TECHNOLOGICAL UNIVERSITY",2000,0,1026,262,764,215,133,82,0.313,0.21,0.174,3441,958
"5438",171128,1995,0,1,"MICHIGAN TECHNOLOGICAL UNIVERSITY",2000,0,1072,285,787,218,134,84,0.295,0.203,0.17,3843,971
"5439",171128,1996,0,1,"MICHIGAN TECHNOLOGICAL UNIVERSITY",2000,0,1068,260,808,298,199,99,0.381,0.279,0.246,3948,963
"5440",171128,1997,0,1,"MICHIGAN TECHNOLOGICAL UNIVERSITY",2000,0,1251,295,956,329,224,105,0.356,0.263,0.234,4062,1131
"5441",171128,1998,0,1,"MICHIGAN TECHNOLOGICAL UNIVERSITY",2000,0,1194,328,866,323,202,121,0.369,0.271,0.233,4362,1056
"5442",171128,1999,0,1,"MICHIGAN TECHNOLOGICAL UNIVERSITY",2000,0,1137,276,861,259,183,76,0.275,0.228,0.213,4365,1022
"5443",171128,2000,1,0,"MICHIGAN TECHNOLOGICAL UNIVERSITY",2000,1,1267,292,975,316,223,93,0.318,0.249,0.229,4530,1115
"5444",171128,2001,1,0,"MICHIGAN TECHNOLOGICAL UNIVERSITY",2000,1,1189,281,908,281,181,100,0.356,0.236,0.199,5028,1021
"5445",171128,2002,1,0,"MICHIGAN TECHNOLOGICAL UNIVERSITY",2000,1,1186,267,919,306,210,96,0.36,0.258,0.229,5782,1050
"5446",171128,2003,1,0,"MICHIGAN TECHNOLOGICAL UNIVERSITY",2000,1,1168,238,930,251,177,74,0.311,0.215,0.19,6810,1051
"5447",171128,2004,1,0,"MICHIGAN TECHNOLOGICAL UNIVERSITY",2000,1,1219,243,976,327,221,106,0.436,0.268,0.226,6978,1102
"5448",171128,2005,1,0,"Michigan Technological University",2000,1,1321,236,1085,327,243,84,0.356,0.248,0.224,7560,1152
"5449",171128,2006,1,0,"Michigan Technological University",2000,1,1163,283,880,328,221,107,0.378,0.282,0.251,8271,1023
"5450",171128,2007,1,0,"Michigan Technological University",2000,1,1215,287,928,275,197,78,0.272,0.226,0.212,9180,1035
"5451",171128,2008,1,0,"Michigan Technological University",2000,1,1361,318,1043,333,218,115,0.362,0.245,0.209,9930,1200
"5452",171128,2009,1,0,"Michigan Technological University",2000,1,1155,301,854,260,162,98,0.326,0.225,0.19,10500,1001
"5453",171128,2010,1,0,"Michigan Technological University",2000,1,1110,273,837,308,202,106,0.388,0.277,0.241,11175,959
"5454",171137,1991,1,0,"UNIVERSITY OF MICHIGAN-DEARBORN",NA,NA,597,308,289,50,22,28,0.091,0.084,0.076,2766,507
"5455",171137,1992,1,0,"UNIVERSITY OF MICHIGAN-DEARBORN",NA,NA,625,323,302,46,18,28,0.087,0.074,0.06,2886,552
"5456",171137,1993,1,0,"UNIVERSITY OF MICHIGAN-DEARBORN",NA,NA,631,311,320,50,21,29,0.093,0.079,0.066,3160,518
"5457",171137,1995,1,0,"UNIVERSITY OF MICHIGAN-DEARBORN",NA,NA,600,320,280,49,23,26,0.081,0.082,0.082,3736,493
"5458",171137,1996,1,0,"UNIVERSITY OF MICHIGAN-DEARBORN",NA,NA,666,321,345,67,23,44,0.137,0.101,0.067,3970,523
"5459",171137,1997,1,0,"UNIVERSITY OF MICHIGAN-DEARBORN",NA,NA,696,378,318,96,29,67,0.177,0.138,0.091,4087,569
"5460",171137,1998,1,0,"UNIVERSITY OF MICHIGAN-DEARBORN",NA,NA,741,373,368,99,41,58,0.156,0.134,0.111,4274,569
"5461",171137,1999,1,0,"UNIVERSITY OF MICHIGAN-DEARBORN",NA,NA,690,334,356,88,30,58,0.174,0.128,0.084,4077,514
"5462",171137,2000,1,0,"UNIVERSITY OF MICHIGAN-DEARBORN",NA,NA,738,371,367,118,52,66,0.178,0.16,0.142,4492,583
"5463",171137,2001,1,0,"UNIVERSITY OF MICHIGAN-DEARBORN",NA,NA,658,330,328,90,33,57,0.173,0.137,0.101,4915,497
"5464",171137,2002,1,0,"UNIVERSITY OF MICHIGAN-DEARBORN",NA,NA,735,342,393,105,48,57,0.167,0.143,0.122,5332,573
"5465",171137,2003,1,0,"UNIVERSITY OF MICHIGAN-DEARBORN",NA,NA,704,313,391,123,62,61,0.195,0.175,0.159,5839,535
"5466",171137,2004,1,0,"UNIVERSITY OF MICHIGAN-DEARBORN",NA,NA,656,311,345,106,45,61,0.196,0.162,0.13,5491,460
"5467",171137,2005,1,0,"University of Michigan-Dearborn",NA,NA,798,381,417,128,47,81,0.213,0.16,0.113,6146,601
"5468",171137,2006,1,0,"University of Michigan-Dearborn",NA,NA,761,394,367,136,56,80,0.203,0.179,0.153,6641,563
"5469",171137,2007,1,0,"University of Michigan-Dearborn",NA,NA,859,420,439,128,61,67,0.16,0.149,0.139,7165,611
"5470",171137,2008,1,0,"University of Michigan-Dearborn",NA,NA,905,436,469,145,60,85,0.195,0.16,0.128,7631,645
"5471",171137,2009,1,0,"University of Michigan-Dearborn",NA,NA,886,418,468,146,60,86,0.206,0.165,0.128,8142,651
"5472",171137,2010,1,0,"University of Michigan-Dearborn",NA,NA,883,429,454,149,51,98,0.228,0.169,0.112,8460,650
"5473",171146,1991,1,0,"UNIVERSITY OF MICHIGAN-FLINT",NA,NA,485,286,199,32,7,25,0.087,0.066,0.035,2460,411
"5474",171146,1992,1,0,"UNIVERSITY OF MICHIGAN-FLINT",NA,NA,523,317,206,45,8,37,0.117,0.086,0.039,2700,421
"5475",171146,1993,1,0,"UNIVERSITY OF MICHIGAN-FLINT",NA,NA,504,322,182,41,12,29,0.09,0.081,0.066,2916,434
"5476",171146,1995,1,0,"UNIVERSITY OF MICHIGAN-FLINT",NA,NA,263,169,94,116,45,71,0.42,0.441,0.479,3304,226
"5477",171146,1996,1,0,"UNIVERSITY OF MICHIGAN-FLINT",NA,NA,551,352,199,53,15,38,0.108,0.096,0.075,3433,472
"5478",171146,1997,1,0,"UNIVERSITY OF MICHIGAN-FLINT",NA,NA,552,337,215,30,10,20,0.059,0.054,0.047,3559,450
"5479",171146,1998,1,0,"UNIVERSITY OF MICHIGAN-FLINT",NA,NA,613,372,241,60,20,40,0.108,0.098,0.083,3697,524
"5480",171146,1999,1,0,"UNIVERSITY OF MICHIGAN-FLINT",NA,NA,492,289,203,49,15,34,0.118,0.1,0.074,3640,395
"5481",171146,2000,1,0,"UNIVERSITY OF MICHIGAN-FLINT",NA,NA,576,349,227,64,18,46,0.132,0.111,0.079,3712,464
"5482",171146,2001,1,0,"UNIVERSITY OF MICHIGAN-FLINT",NA,NA,549,330,219,54,17,37,0.112,0.098,0.078,4135,455
"5483",171146,2002,1,0,"UNIVERSITY OF MICHIGAN-FLINT",NA,NA,467,269,198,52,16,36,0.134,0.111,0.081,4494,382
"5484",171146,2003,1,0,"UNIVERSITY OF MICHIGAN-FLINT",NA,NA,420,252,168,57,17,40,0.159,0.136,0.101,5000,334
"5485",171146,2004,1,0,"UNIVERSITY OF MICHIGAN-FLINT",NA,NA,474,293,181,53,17,36,0.123,0.112,0.094,5126,393
"5486",171146,2005,1,0,"University of Michigan-Flint",NA,NA,509,293,216,48,18,30,0.102,0.094,0.083,5752,374
"5487",171146,2006,1,0,"University of Michigan-Flint",NA,NA,483,274,209,46,14,32,0.117,0.095,0.067,6214,347
"5488",171146,2007,1,0,"University of Michigan-Flint",NA,NA,594,346,248,56,16,40,0.116,0.094,0.065,6618,407
"5489",171146,2008,1,0,"University of Michigan-Flint",NA,NA,846,512,334,78,31,47,0.092,0.092,0.093,7008,537
"5490",171146,2009,1,0,"University of Michigan-Flint",NA,NA,713,401,312,77,29,48,0.12,0.108,0.093,7474,471
"5491",171146,2010,1,0,"University of Michigan-Flint",NA,NA,724,398,326,94,34,60,0.151,0.13,0.104,7809,506
"5492",171599,1991,1,0,"OLIVET COLLEGE",NA,NA,162,55,107,30,18,12,0.218,0.185,0.168,7890,136
"5493",171599,1992,1,0,"OLIVET COLLEGE",NA,NA,139,39,100,14,5,9,0.231,0.101,0.05,8291,120
"5494",171599,1993,1,0,"OLIVET COLLEGE",NA,NA,234,78,156,53,30,23,0.295,0.226,0.192,10500,210
"5495",171599,1995,1,0,"OLIVET COLLEGE",NA,NA,209,69,140,28,20,8,0.116,0.134,0.143,11580,171
"5496",171599,1996,1,0,"OLIVET COLLEGE",NA,NA,241,93,148,45,21,24,0.258,0.187,0.142,12160,163
"5497",171599,1997,1,0,"OLIVET COLLEGE",NA,NA,228,73,155,2,0,2,0.027,0.009,0,12660,159
"5498",171599,1998,1,0,"OLIVET COLLEGE",NA,NA,198,85,113,42,21,21,0.247,0.212,0.186,12900,117
"5499",171599,1999,1,0,"OLIVET COLLEGE",NA,NA,181,74,107,63,32,31,0.419,0.348,0.299,12948,118
"5500",171599,2000,1,0,"OLIVET COLLEGE",NA,NA,183,66,117,36,18,18,0.273,0.197,0.154,13142,94
"5501",171599,2001,1,0,"OLIVET COLLEGE",NA,NA,151,59,92,52,26,26,0.441,0.344,0.283,13982,95
"5502",171599,2002,1,0,"OLIVET COLLEGE",NA,NA,238,85,153,82,42,40,0.471,0.345,0.275,14332,174
"5503",171599,2003,1,0,"OLIVET COLLEGE",NA,NA,271,99,172,101,53,48,0.485,0.373,0.308,14762,175
"5504",171599,2004,1,0,"OLIVET COLLEGE",NA,NA,198,72,126,51,26,25,0.347,0.258,0.206,15500,144
"5505",171599,2005,1,0,"Olivet College",NA,NA,257,103,154,77,33,44,0.427,0.3,0.214,15970,198
"5506",171599,2006,1,0,"Olivet College",NA,NA,195,73,122,52,28,24,0.329,0.267,0.23,17584,153
"5507",171599,2007,1,0,"Olivet College",NA,NA,182,67,115,48,18,30,0.448,0.264,0.157,17994,137
"5508",171599,2008,1,0,"Olivet College",NA,NA,282,99,183,76,34,42,0.424,0.27,0.186,18580,202
"5509",171599,2009,1,0,"Olivet College",NA,NA,258,141,117,68,26,42,0.298,0.264,0.222,19138,212
"5510",171599,2010,1,0,"Olivet College",NA,NA,229,93,136,80,35,45,0.484,0.349,0.257,19710,187
"5511",172051,1991,1,0,"SAGINAW VALLEY STATE UNIVERSITY",NA,NA,564,296,268,26,6,20,0.068,0.046,0.022,2426,492
"5512",172051,1992,1,0,"SAGINAW VALLEY STATE UNIVERSITY",NA,NA,655,360,295,42,8,34,0.094,0.064,0.027,2620,561
"5513",172051,1993,1,0,"SAGINAW VALLEY STATE UNIVERSITY",NA,NA,633,337,296,112,36,76,0.226,0.177,0.122,2891,580
"5514",172051,1995,1,0,"SAGINAW VALLEY STATE UNIVERSITY",NA,NA,752,412,340,40,14,26,0.063,0.053,0.041,3259,674
"5515",172051,1996,1,0,"SAGINAW VALLEY STATE UNIVERSITY",NA,NA,747,425,322,33,8,25,0.059,0.044,0.025,3350,664
"5516",172051,1997,1,0,"SAGINAW VALLEY STATE UNIVERSITY",NA,NA,818,461,357,55,12,43,0.093,0.067,0.034,3447,673
"5517",172051,1998,1,0,"SAGINAW VALLEY STATE UNIVERSITY",NA,NA,895,492,403,59,20,39,0.079,0.066,0.05,3526,757
"5518",172051,1999,1,0,"SAGINAW VALLEY STATE UNIVERSITY",NA,NA,1015,549,466,81,36,45,0.082,0.08,0.077,3351,843
"5519",172051,2000,1,0,"SAGINAW VALLEY STATE UNIVERSITY",NA,NA,1049,559,490,68,24,44,0.079,0.065,0.049,3290,878
"5520",172051,2001,1,0,"SAGINAW VALLEY STATE UNIVERSITY",NA,NA,1044,539,505,106,39,67,0.124,0.102,0.077,3455,865
"5521",172051,2002,1,0,"SAGINAW VALLEY STATE UNIVERSITY",NA,NA,1109,654,455,97,27,70,0.107,0.087,0.059,3824,923
"5522",172051,2003,1,0,"SAGINAW VALLEY STATE UNIVERSITY",NA,NA,1156,667,489,104,32,72,0.108,0.09,0.065,4188,969
"5523",172051,2004,1,0,"SAGINAW VALLEY STATE UNIVERSITY",NA,NA,1209,720,489,129,32,97,0.135,0.107,0.065,4271,1044
"5524",172051,2005,1,0,"Saginaw Valley State University",NA,NA,1233,742,491,102,26,76,0.102,0.083,0.053,4877,1014
"5525",172051,2006,1,0,"Saginaw Valley State University",NA,NA,1434,840,594,123,36,87,0.104,0.086,0.061,5130,1167
"5526",172051,2007,1,0,"Saginaw Valley State University",NA,NA,1533,883,650,155,56,99,0.112,0.101,0.086,5832,1219
"5527",172051,2008,1,0,"Saginaw Valley State University",NA,NA,1647,949,698,144,50,94,0.099,0.087,0.072,6054,1337
"5528",172051,2009,1,0,"Saginaw Valley State University",NA,NA,1728,1028,700,177,59,118,0.115,0.102,0.084,6462,1338
"5529",172051,2010,1,0,"Saginaw Valley State University",NA,NA,1729,1013,716,196,51,145,0.143,0.113,0.071,6870,1284
"5530",172699,1991,0,1,"WESTERN MICHIGAN UNIVERSITY",1996,0,2778,1543,1235,432,162,270,0.175,0.156,0.131,2447,2379
"5531",172699,1992,0,1,"WESTERN MICHIGAN UNIVERSITY",1996,0,2863,1614,1249,484,165,319,0.198,0.169,0.132,2807,2370
"5532",172699,1993,0,1,"WESTERN MICHIGAN UNIVERSITY",1996,0,2810,1587,1223,538,161,377,0.238,0.191,0.132,2997,2439
"5533",172699,1995,0,1,"WESTERN MICHIGAN UNIVERSITY",1996,0,3165,1851,1314,524,148,376,0.203,0.166,0.113,3242,2704
"5534",172699,1996,1,0,"WESTERN MICHIGAN UNIVERSITY",1996,1,3121,1801,1320,557,177,380,0.211,0.178,0.134,3332,2672
"5535",172699,1997,1,0,"WESTERN MICHIGAN UNIVERSITY",1996,1,3213,1835,1378,592,211,381,0.208,0.184,0.153,3655,2820
"5536",172699,1998,1,0,"WESTERN MICHIGAN UNIVERSITY",1996,1,3621,1981,1640,699,255,444,0.224,0.193,0.155,3937,3198
"5537",172699,1999,1,0,"WESTERN MICHIGAN UNIVERSITY",1996,1,4302,2288,2014,864,306,558,0.244,0.201,0.152,3453,3916
"5538",172699,2000,1,0,"WESTERN MICHIGAN UNIVERSITY",1996,1,4429,2349,2080,865,323,542,0.231,0.195,0.155,3492,4012
"5539",172699,2001,1,0,"WESTERN MICHIGAN UNIVERSITY",1996,1,4562,2306,2256,857,334,523,0.227,0.188,0.148,3897,4113
"5540",172699,2002,1,0,"WESTERN MICHIGAN UNIVERSITY",1996,1,4442,2318,2124,941,381,560,0.242,0.212,0.179,4322,4020
"5541",172699,2003,1,0,"WESTERN MICHIGAN UNIVERSITY",1996,1,4218,2191,2027,915,388,527,0.241,0.217,0.191,4933,3743
"5542",172699,2004,1,0,"WESTERN MICHIGAN UNIVERSITY",1996,1,3725,1872,1853,802,301,501,0.268,0.215,0.162,5066,3246
"5543",172699,2005,1,0,"Western Michigan University",1996,1,3702,1917,1785,919,374,545,0.284,0.248,0.21,5826,3272
"5544",172699,2006,1,0,"Western Michigan University",1996,1,3531,1800,1731,852,359,493,0.274,0.241,0.207,6176,2977
"5545",172699,2007,1,0,"Western Michigan University",1996,1,3473,1750,1723,842,362,480,0.274,0.242,0.21,6570,2838
"5546",172699,2008,1,0,"Western Michigan University",1996,1,3803,1934,1869,880,381,499,0.258,0.231,0.204,7220,3067
"5547",172699,2009,1,0,"Western Michigan University",1996,1,3162,1591,1571,718,279,439,0.276,0.227,0.178,7654,2453
"5548",172699,2010,1,0,"Western Michigan University",1996,1,3346,1734,1612,721,259,462,0.266,0.215,0.161,8182,2502
"5549",173160,1991,1,0,"BETHEL COLLEGE",NA,NA,272,183,89,157,49,108,0.59,0.577,0.551,9950,260
"5550",173160,1992,1,0,"BETHEL COLLEGE",NA,NA,236,143,93,153,54,99,0.692,0.648,0.581,10540,225
"5551",173160,1993,1,0,"BETHEL COLLEGE",NA,NA,275,168,107,175,64,111,0.661,0.636,0.598,11050,262
"5552",173160,1995,1,0,"BETHEL COLLEGE",NA,NA,475,303,172,282,90,192,0.634,0.594,0.523,12260,450
"5553",173160,1996,1,0,"BETHEL COLLEGE",NA,NA,468,284,184,292,103,189,0.665,0.624,0.56,13180,439
"5554",173160,1997,1,0,"BETHEL COLLEGE",NA,NA,447,281,166,279,98,181,0.644,0.624,0.59,13840,431
"5555",173160,1998,1,0,"BETHEL COLLEGE",NA,NA,513,314,199,314,122,192,0.612,0.612,0.613,14720,485
"5556",173160,1999,1,0,"BETHEL COLLEGE",NA,NA,479,315,164,295,98,197,0.625,0.616,0.598,15300,459
"5557",173160,2000,1,0,"BETHEL COLLEGE",NA,NA,591,357,234,364,127,237,0.664,0.616,0.543,15900,568
"5558",173160,2001,1,0,"BETHEL COLLEGE",NA,NA,645,385,260,442,173,269,0.699,0.685,0.665,16780,614
"5559",173160,2002,1,0,"BETHEL COLLEGE",NA,NA,567,348,219,370,125,245,0.704,0.653,0.571,17700,540
"5560",173160,2003,1,0,"BETHEL COLLEGE",NA,NA,690,419,271,427,172,255,0.609,0.619,0.635,18700,650
"5561",173160,2004,1,0,"BETHEL UNIVERSITY",NA,NA,669,386,283,385,160,225,0.583,0.575,0.565,19880,615
"5562",173160,2005,1,0,"Bethel University",NA,NA,683,425,258,436,149,287,0.675,0.638,0.578,21130,638
"5563",173160,2006,1,0,"Bethel University",NA,NA,629,351,278,392,157,235,0.67,0.623,0.565,22590,575
"5564",173160,2007,1,0,"Bethel University",NA,NA,597,370,227,374,126,248,0.67,0.626,0.555,24400,562
"5565",173160,2008,1,0,"Bethel University",NA,NA,632,377,255,408,155,253,0.671,0.646,0.608,25750,578
"5566",173160,2009,1,0,"Bethel University",NA,NA,683,387,296,430,169,261,0.674,0.63,0.571,26900,629
"5567",173160,2010,1,0,"Bethel University",NA,NA,604,366,238,408,146,262,0.716,0.675,0.613,27950,557
"5568",173258,1991,0,1,"CARLETON COLLEGE",9999,0,471,247,224,387,175,212,0.858,0.822,0.781,16296,389
"5569",173258,1992,0,1,"CARLETON COLLEGE",9999,0,494,249,245,402,204,198,0.795,0.814,0.833,17360,399
"5570",173258,1993,0,1,"CARLETON COLLEGE",9999,0,488,252,236,391,185,206,0.818,0.801,0.784,18405,405
"5571",173258,1995,0,1,"CARLETON COLLEGE",9999,0,463,232,231,393,191,202,0.871,0.849,0.827,20300,379
"5572",173258,1996,0,1,"CARLETON COLLEGE",9999,0,471,256,215,387,164,223,0.871,0.822,0.763,21117,384
"5573",173258,1997,0,1,"CARLETON COLLEGE",9999,0,484,255,229,412,195,217,0.851,0.851,0.852,21885,405
"5574",173258,1998,0,1,"CARLETON COLLEGE",9999,0,520,279,241,450,204,246,0.882,0.865,0.846,22611,421
"5575",173258,1999,0,1,"CARLETON COLLEGE",9999,0,507,257,250,410,199,211,0.821,0.809,0.796,23325,423
"5576",173258,2000,0,1,"CARLETON COLLEGE",9999,0,471,247,224,415,194,221,0.895,0.881,0.866,24240,385
"5577",173258,2001,0,1,"CARLETON COLLEGE",9999,0,516,265,251,467,222,245,0.925,0.905,0.884,25371,397
"5578",173258,2002,0,1,"CARLETON COLLEGE",9999,0,499,264,235,447,203,244,0.924,0.896,0.864,26745,350
"5579",173258,2003,0,1,"CARLETON COLLEGE",9999,0,488,241,247,435,215,220,0.913,0.891,0.87,28362,359
"5580",173258,2004,0,1,"CARLETON COLLEGE",9999,0,487,263,224,432,195,237,0.901,0.887,0.871,30501,355
"5581",173258,2005,0,1,"Carleton College",9999,0,542,278,264,478,226,252,0.907,0.882,0.856,32460,359
"5582",173258,2006,0,1,"Carleton College",9999,0,504,272,232,458,209,249,0.915,0.909,0.901,34083,368
"5583",173258,2007,0,1,"Carleton College",9999,0,509,255,254,456,221,235,0.922,0.896,0.87,35958,361
"5584",173258,2008,0,1,"Carleton College",9999,0,488,244,244,444,220,224,0.918,0.91,0.902,37845,335
"5585",173258,2009,0,1,"Carleton College",9999,0,528,272,256,480,222,258,0.949,0.909,0.867,39546,352
"5586",173258,2010,0,1,"Carleton College",9999,0,511,268,243,451,209,242,0.903,0.883,0.86,41076,343
"5587",173328,1991,0,1,"CONCORDIA COLLEGE",1998,0,151,94,57,31,10,21,0.223,0.205,0.175,8268,119
"5588",173328,1992,0,1,"CONCORDIA COLLEGE",1998,0,149,90,59,39,12,27,0.3,0.262,0.203,9000,118
"5589",173328,1993,0,1,"CONCORDIA COLLEGE",1998,0,138,77,61,39,16,23,0.299,0.283,0.262,9720,116
"5590",173328,1995,0,1,"CONCORDIA COLLEGE",1998,0,153,91,62,42,13,29,0.319,0.275,0.21,10815,125
"5591",173328,1996,0,1,"CONCORDIA COLLEGE",1998,0,161,82,79,53,25,28,0.341,0.329,0.316,11355,133
"5592",173328,1997,0,1,"CONCORDIA UNIVERSITY",1998,0,222,132,90,86,32,54,0.409,0.387,0.356,11980,178
"5593",173328,1998,1,0,"CONCORDIA UNIVERSITY",1998,1,213,106,107,57,24,33,0.311,0.268,0.224,12658,179
"5594",173328,1999,1,0,"CONCORDIA UNIVERSITY",1998,1,258,142,116,76,32,44,0.31,0.295,0.276,13040,187
"5595",173328,2000,1,0,"CONCORDIA UNIVERSITY",1998,1,212,124,88,57,15,42,0.339,0.269,0.17,14752,158
"5596",173328,2001,1,0,"CONCORDIA UNIVERSITY",1998,1,200,87,113,57,26,31,0.356,0.285,0.23,15786,138
"5597",173328,2002,1,0,"CONCORDIA UNIVERSITY",1998,1,175,89,86,57,19,38,0.427,0.326,0.221,17326,137
"5598",173328,2003,1,0,"CONCORDIA UNIVERSITY-ST PAUL",1998,1,167,83,84,59,25,34,0.41,0.353,0.298,18624,123
"5599",173328,2004,1,0,"CONCORDIA UNIVERSITY-ST PAUL",1998,1,176,102,74,64,24,40,0.392,0.364,0.324,19928,127
"5600",173328,2005,1,0,"Concordia University-Saint Paul",1998,1,163,84,79,53,21,32,0.381,0.325,0.266,21312,113
"5601",173328,2006,1,0,"Concordia University-Saint Paul",1998,1,199,108,91,51,19,32,0.296,0.256,0.209,22378,139
"5602",173328,2007,1,0,"Concordia University-Saint Paul",1998,1,201,112,89,61,20,41,0.366,0.303,0.225,23496,138
"5603",173328,2008,1,0,"Concordia University-Saint Paul",1998,1,211,116,95,60,25,35,0.302,0.284,0.263,24900,137
"5604",173328,2009,1,0,"Concordia University-Saint Paul",1998,1,183,82,101,56,22,34,0.415,0.306,0.218,26400,110
"5605",173328,2010,1,0,"Concordia University-Saint Paul",1998,1,217,126,91,81,19,62,0.492,0.373,0.209,27400,132
"5606",173647,1991,1,0,"GUSTAVUS ADOLPHUS COLLEGE",NA,NA,624,336,288,464,210,254,0.756,0.744,0.729,11900,595
"5607",173647,1992,1,0,"GUSTAVUS ADOLPHUS COLLEGE",NA,NA,620,327,293,455,224,231,0.706,0.734,0.765,12600,582
"5608",173647,1993,1,0,"GUSTAVUS ADOLPHUS COLLEGE",NA,NA,630,369,261,485,191,294,0.797,0.77,0.732,13400,584
"5609",173647,1995,1,0,"GUSTAVUS ADOLPHUS COLLEGE",NA,NA,690,380,310,478,196,282,0.742,0.693,0.632,14760,659
"5610",173647,1996,1,0,"GUSTAVUS ADOLPHUS COLLEGE",NA,NA,633,375,258,504,202,302,0.805,0.796,0.783,15350,585
"5611",173647,1997,1,0,"GUSTAVUS ADOLPHUS COLLEGE",NA,NA,625,353,272,438,174,264,0.748,0.701,0.64,15940,592
"5612",173647,1998,1,0,"GUSTAVUS ADOLPHUS COLLEGE",NA,NA,695,391,304,477,195,282,0.721,0.686,0.641,16560,663
"5613",173647,1999,1,0,"GUSTAVUS ADOLPHUS COLLEGE",NA,NA,654,365,289,473,207,266,0.729,0.723,0.716,17200,612
"5614",173647,2000,1,0,"GUSTAVUS ADOLPHUS COLLEGE",NA,NA,652,383,269,392,169,223,0.582,0.601,0.628,17970,603
"5615",173647,2001,1,0,"GUSTAVUS ADOLPHUS COLLEGE",NA,NA,601,343,258,468,196,272,0.793,0.779,0.76,18940,546
"5616",173647,2002,1,0,"GUSTAVUS ADOLPHUS COLLEGE",NA,NA,645,383,262,521,216,305,0.796,0.808,0.824,19215,601
"5617",173647,2003,1,0,"GUSTAVUS ADOLPHUS COLLEGE",NA,NA,623,331,292,514,235,279,0.843,0.825,0.805,20405,571
"5618",173647,2004,1,0,"GUSTAVUS ADOLPHUS COLLEGE",NA,NA,651,361,290,468,221,247,0.684,0.719,0.762,22625,584
"5619",173647,2005,1,0,"Gustavus Adolphus College",NA,NA,739,439,300,588,208,380,0.866,0.796,0.693,25765,673
"5620",173647,2006,1,0,"Gustavus Adolphus College",NA,NA,684,396,288,553,226,327,0.826,0.808,0.785,26310,610
"5621",173647,2007,1,0,"Gustavus Adolphus College",NA,NA,666,374,292,542,234,308,0.824,0.814,0.801,28125,573
"5622",173647,2008,1,0,"Gustavus Adolphus College",NA,NA,616,346,270,495,211,284,0.821,0.804,0.781,29990,541
"5623",173647,2009,1,0,"Gustavus Adolphus College",NA,NA,611,372,239,495,193,302,0.812,0.81,0.808,31460,514
"5624",173647,2010,1,0,"Gustavus Adolphus College",NA,NA,585,314,271,454,208,246,0.783,0.776,0.768,33100,470
"5625",173902,1991,1,0,"MACALESTER COLLEGE",NA,NA,403,206,197,284,126,158,0.767,0.705,0.64,13331,311
"5626",173902,1992,1,0,"MACALESTER COLLEGE",NA,NA,475,258,217,332,139,193,0.748,0.699,0.641,14125,358
"5627",173902,1993,1,0,"MACALESTER COLLEGE",NA,NA,452,252,200,318,128,190,0.754,0.704,0.64,15107,346
"5628",173902,1995,1,0,"MACALESTER COLLEGE",NA,NA,437,231,206,322,143,179,0.775,0.737,0.694,16686,353
"5629",173902,1996,1,0,"MACALESTER COLLEGE",NA,NA,491,293,198,377,151,226,0.771,0.768,0.763,17580,387
"5630",173902,1997,1,0,"MACALESTER COLLEGE",NA,NA,450,251,199,339,140,199,0.793,0.753,0.704,18630,347
"5631",173902,1998,1,0,"MACALESTER COLLEGE",NA,NA,465,260,205,339,153,186,0.715,0.729,0.746,19673,352
"5632",173902,1999,1,0,"MACALESTER COLLEGE",NA,NA,460,271,189,360,147,213,0.786,0.783,0.778,20560,332
"5633",173902,2000,1,0,"MACALESTER COLLEGE",NA,NA,454,299,155,366,126,240,0.803,0.806,0.813,21486,336
"5634",173902,2001,1,0,"MACALESTER COLLEGE",NA,NA,505,265,240,415,193,222,0.838,0.822,0.804,22480,379
"5635",173902,2002,1,0,"MACALESTER COLLEGE",NA,NA,440,241,199,370,169,201,0.834,0.841,0.849,23604,310
"5636",173902,2003,1,0,"MACALESTER COLLEGE",NA,NA,513,300,213,422,168,254,0.847,0.823,0.789,24902,407
"5637",173902,2004,1,0,"MACALESTER COLLEGE",NA,NA,485,284,201,410,164,246,0.866,0.845,0.816,26638,321
"5638",173902,2005,1,0,"MacAlester College",NA,NA,491,287,204,405,158,247,0.861,0.825,0.775,28474,352
"5639",173902,2006,1,0,"Macalester College",NA,NA,501,281,220,429,181,248,0.883,0.856,0.823,30870,353
"5640",173902,2007,1,0,"Macalester College",NA,NA,485,270,215,411,176,235,0.87,0.847,0.819,33494,327
"5641",173902,2008,1,0,"Macalester College",NA,NA,478,279,199,401,161,240,0.86,0.839,0.809,36304,346
"5642",173902,2009,1,0,"Macalester College",NA,NA,564,329,235,481,196,285,0.866,0.853,0.834,37974,391
"5643",173902,2010,1,0,"Macalester College",NA,NA,515,314,201,434,158,276,0.879,0.843,0.786,39846,332
"5644",174066,1991,0,1,"UNIVERSITY OF MINNESOTA TWIN CITIES",1999,0,1979,917,1062,318,134,184,0.201,0.161,0.126,2829,1618
"5645",174066,1992,0,1,"UNIVERSITY OF MINNESOTA TWIN CITIES",1999,0,1980,905,1075,329,137,192,0.212,0.166,0.127,3158,1634
"5646",174066,1993,0,1,"UNIVERSITY OF MINNESOTA TWIN CITIES",1999,0,2272,1080,1192,413,171,242,0.224,0.182,0.143,3266,1848
"5647",174066,1995,0,1,"UNIVERSITY OF MINNESOTA TWIN CITIES",1999,0,4128,2100,2028,984,418,566,0.27,0.238,0.206,3857,3308
"5648",174066,1996,0,1,"UNIVERSITY OF MINNESOTA TWIN CITIES",1999,0,4057,2049,2008,1050,451,599,0.292,0.259,0.225,4320,3300
"5649",174066,1997,0,1,"UNIVERSITY OF MINNESOTA-TWIN CITIES",1999,0,4371,2282,2089,1208,467,741,0.325,0.276,0.224,4749,3462
"5650",174066,1998,0,1,"UNIVERSITY OF MINNESOTA-TWIN CITIES",1999,0,4992,2582,2410,1441,573,868,0.336,0.289,0.238,4963,3986
"5651",174066,1999,1,0,"UNIVERSITY OF MINNESOTA-TWIN CITIES",1999,1,5025,2636,2389,1604,655,949,0.36,0.319,0.274,4171,4033
"5652",174066,2000,1,0,"UNIVERSITY OF MINNESOTA-TWIN CITIES",1999,1,4865,2577,2288,1581,668,913,0.354,0.325,0.292,4401,3853
"5653",174066,2001,1,0,"UNIVERSITY OF MINNESOTA-TWIN CITIES",1999,1,5259,2677,2582,1939,841,1098,0.41,0.369,0.326,4852,4248
"5654",174066,2002,1,0,"UNIVERSITY OF MINNESOTA-TWIN CITIES",1999,1,5162,2762,2400,2118,869,1249,0.452,0.41,0.362,5420,4109
"5655",174066,2003,1,0,"UNIVERSITY OF MINNESOTA-TWIN CITIES",1999,1,5160,2820,2340,2341,902,1439,0.51,0.454,0.385,5962,3970
"5656",174066,2004,1,0,"UNIVERSITY OF MINNESOTA-TWIN CITIES",1999,1,5562,3081,2481,2549,994,1555,0.505,0.458,0.401,6677,4434
"5657",174066,2005,1,0,"University of Minnesota-Twin Cities",1999,1,5274,2856,2418,2488,1023,1465,0.513,0.472,0.423,7140,4165
"5658",174066,2006,1,0,"University of Minnesota-Twin Cities",1999,1,5418,2970,2448,2734,1150,1584,0.533,0.505,0.47,7588,4194
"5659",174066,2007,1,0,"University of Minnesota-Twin Cities",1999,1,5256,2927,2329,2863,1182,1681,0.574,0.545,0.508,7950,3990
"5660",174066,2008,1,0,"University of Minnesota-Twin Cities",1999,1,5089,2813,2276,2975,1224,1751,0.623,0.585,0.538,8500,3729
"5661",174066,2009,1,0,"University of Minnesota-Twin Cities",1999,1,5381,2849,2532,3188,1380,1808,0.635,0.592,0.545,9120,3986
"5662",174066,2010,1,0,"University of Minnesota-Twin Cities",1999,1,5310,2810,2500,3251,1428,1823,0.649,0.612,0.571,9794,4074
"5663",174233,1991,0,1,"UNIVERSITY OF MINNESOTA DULUTH",1999,0,1091,567,524,196,69,127,0.224,0.18,0.132,2750,975
"5664",174233,1992,0,1,"UNIVERSITY OF MINNESOTA DULUTH",1999,0,1163,566,597,221,95,126,0.223,0.19,0.159,3044,1092
"5665",174233,1993,0,1,"UNIVERSITY OF MINNESOTA-DULUTH",1999,0,1248,631,617,226,88,138,0.219,0.181,0.143,3137,1164
"5666",174233,1995,0,1,"UNIVERSITY OF MINNESOTA-DULUTH",1999,0,1462,688,774,361,146,215,0.312,0.247,0.189,3745,1341
"5667",174233,1996,0,1,"UNIVERSITY OF MINNESOTA-DULUTH",1999,0,1736,886,850,411,156,255,0.288,0.237,0.184,4187,1614
"5668",174233,1997,0,1,"UNIVERSITY OF MINNESOTA-DULUTH",1999,0,1679,843,836,363,140,223,0.264,0.216,0.167,4522,1550
"5669",174233,1998,0,1,"UNIVERSITY OF MINNESOTA-DULUTH",1999,0,1746,911,835,362,138,224,0.246,0.207,0.165,4725,1623
"5670",174233,1999,1,0,"UNIVERSITY OF MINNESOTA-DULUTH",1999,1,2000,1032,968,416,168,248,0.24,0.208,0.174,4230,1869
"5671",174233,2000,1,0,"UNIVERSITY OF MINNESOTA-DULUTH",1999,1,2088,1107,981,508,182,326,0.294,0.243,0.186,4463,1947
"5672",174233,2001,1,0,"UNIVERSITY OF MINNESOTA-DULUTH",1999,1,2109,1094,1015,495,180,315,0.288,0.235,0.177,4920,1970
"5673",174233,2002,1,0,"UNIVERSITY OF MINNESOTA-DULUTH",1999,1,2025,1029,996,476,183,293,0.285,0.235,0.184,5585,1870
"5674",174233,2003,1,0,"UNIVERSITY OF MINNESOTA-DULUTH",1999,1,2155,1073,1082,514,218,296,0.276,0.239,0.201,6045,1972
"5675",174233,2004,1,0,"UNIVERSITY OF MINNESOTA-DULUTH",1999,1,2205,1153,1052,568,208,360,0.312,0.258,0.198,6710,2021
"5676",174233,2005,1,0,"University of Minnesota-Duluth",1999,1,2111,1025,1086,565,243,322,0.314,0.268,0.224,7157,1969
"5677",174233,2006,1,0,"University of Minnesota-Duluth",1999,1,2283,1105,1178,629,270,359,0.325,0.276,0.229,7605,2122
"5678",174233,2007,1,0,"University of Minnesota-Duluth",1999,1,2196,1100,1096,649,244,405,0.368,0.296,0.223,7700,2006
"5679",174233,2008,1,0,"University of Minnesota-Duluth",1999,1,2213,1110,1103,760,306,454,0.409,0.343,0.277,8230,1999
"5680",174233,2009,1,0,"University of Minnesota-Duluth",1999,1,2079,1028,1051,728,296,432,0.42,0.35,0.282,8830,1887
"5681",174233,2010,1,0,"University of Minnesota-Duluth",1999,1,2316,1112,1204,819,356,463,0.416,0.354,0.296,9482,2097
"5682",174251,1991,0,1,"UNIVERSITY OF MINNESOTA MORRIS",2000,0,462,272,190,155,55,100,0.368,0.335,0.289,2781,384
"5683",174251,1992,0,1,"UNIVERSITY OF MINNESOTA MORRIS",2000,0,497,291,206,187,67,120,0.412,0.376,0.325,3246,435
"5684",174251,1993,0,1,"UNIVERSITY OF MINNESOTA-MORRIS",2000,0,519,284,235,209,88,121,0.426,0.403,0.374,3417,440
"5685",174251,1995,0,1,"UNIVERSITY OF MINNESOTA-MORRIS",2000,0,503,297,206,202,66,136,0.458,0.402,0.32,4189,430
"5686",174251,1996,0,1,"UNIVERSITY OF MINNESOTA-MORRIS",2000,0,522,310,212,223,71,152,0.49,0.427,0.335,4554,447
"5687",174251,1997,0,1,"UNIVERSITY OF MINNESOTA-MORRIS",2000,0,461,271,190,161,53,108,0.398,0.349,0.279,4766,387
"5688",174251,1998,0,1,"UNIVERSITY OF MINNESOTA-MORRIS",2000,0,522,330,192,198,62,136,0.412,0.379,0.323,4956,441
"5689",174251,1999,0,1,"UNIVERSITY OF MINNESOTA-MORRIS",2000,0,453,270,183,174,70,104,0.385,0.384,0.383,4777,386
"5690",174251,2000,1,0,"UNIVERSITY OF MINNESOTA-MORRIS",2000,1,467,267,200,186,66,120,0.449,0.398,0.33,5033,391
"5691",174251,2001,1,0,"UNIVERSITY OF MINNESOTA-MORRIS",2000,1,474,296,178,206,74,132,0.446,0.435,0.416,5549,394
"5692",174251,2002,1,0,"UNIVERSITY OF MINNESOTA-MORRIS",2000,1,475,309,166,219,71,148,0.479,0.461,0.428,6381,404
"5693",174251,2003,1,0,"UNIVERSITY OF MINNESOTA-MORRIS",2000,1,412,249,163,179,60,119,0.478,0.434,0.368,6908,349
"5694",174251,2004,1,0,"UNIVERSITY OF MINNESOTA-MORRIS",2000,1,383,235,148,205,73,132,0.562,0.535,0.493,7668,303
"5695",174251,2005,1,0,"University of Minnesota-Morris",2000,1,353,207,146,171,63,108,0.522,0.484,0.432,8204,275
"5696",174251,2006,1,0,"University of Minnesota-Morris",2000,1,377,214,163,179,66,113,0.528,0.475,0.405,8720,283
"5697",174251,2007,1,0,"University of Minnesota-Morris",2000,1,358,205,153,180,65,115,0.561,0.503,0.425,7700,281
"5698",174251,2008,1,0,"University of Minnesota-Morris",2000,1,373,209,164,200,80,120,0.574,0.536,0.488,8230,286
"5699",174251,2009,1,0,"University of Minnesota-Morris",2000,1,404,235,169,206,74,132,0.562,0.51,0.438,8830,315
"5700",174251,2010,1,0,"University of Minnesota-Morris",2000,1,418,242,176,211,81,130,0.537,0.505,0.46,9482,295
"5701",174491,1991,0,1,"NORTHWESTERN COLLEGE",1999,0,267,165,102,84,24,60,0.364,0.315,0.235,9096,260
"5702",174491,1992,0,1,"NORTHWESTERN COLLEGE",1999,0,308,183,125,106,40,66,0.361,0.344,0.32,9825,297
"5703",174491,1993,0,1,"NORTHWESTERN COLLEGE",1999,0,329,209,120,107,38,69,0.33,0.325,0.317,10659,314
"5704",174491,1995,0,1,"NORTHWESTERN COLLEGE",1999,0,378,245,133,155,43,112,0.457,0.41,0.323,11985,366
"5705",174491,1996,0,1,"NORTHWESTERN COLLEGE",1999,0,358,223,135,140,36,104,0.466,0.391,0.267,12750,336
"5706",174491,1997,0,1,"NORTHWESTERN COLLEGE",1999,0,372,231,141,162,61,101,0.437,0.435,0.433,13125,352
"5707",174491,1998,0,1,"NORTHWESTERN COLLEGE",1999,0,393,242,151,155,55,100,0.413,0.394,0.364,13920,375
"5708",174491,1999,1,0,"NORTHWESTERN COLLEGE",1999,1,392,262,130,160,42,118,0.45,0.408,0.323,14336,376
"5709",174491,2000,1,0,"NORTHWESTERN COLLEGE",1999,1,430,279,151,178,52,126,0.452,0.414,0.344,14982,409
"5710",174491,2001,1,0,"NORTHWESTERN COLLEGE",1999,1,400,262,138,184,54,130,0.496,0.46,0.391,15600,373
"5711",174491,2002,1,0,"NORTHWESTERN COLLEGE",1999,1,431,267,164,183,75,108,0.404,0.425,0.457,16500,410
"5712",174491,2003,1,0,"NORTHWESTERN COLLEGE",1999,1,431,291,140,191,55,136,0.467,0.443,0.393,17400,395
"5713",174491,2004,1,0,"NORTHWESTERN COLLEGE",1999,1,409,245,164,194,67,127,0.518,0.474,0.409,18370,378
"5714",174491,2005,1,0,"Northwestern College",1999,1,476,295,181,221,76,145,0.492,0.464,0.42,19100,424
"5715",174491,2006,1,0,"Northwestern College",1999,1,498,302,196,256,89,167,0.553,0.514,0.454,19990,459
"5716",174491,2007,1,0,"Northwestern College",1999,1,526,315,211,264,99,165,0.524,0.502,0.469,20990,478
"5717",174491,2008,1,0,"Northwestern College",1999,1,455,273,182,202,62,140,0.513,0.444,0.341,22250,420
"5718",174491,2009,1,0,"Northwestern College",1999,1,450,258,192,240,86,154,0.597,0.533,0.448,22990,404
"5719",174491,2010,1,0,"Northwestern College",1999,1,451,247,204,219,89,130,0.526,0.486,0.436,24370,378
"5720",174792,1991,1,0,"SAINT JOHN'S UNIVERSITY",NA,NA,415,0,415,247,247,0,NA,0.595,0.595,10135,380
"5721",174792,1992,1,0,"SAINT JOHN'S UNIVERSITY",NA,NA,435,0,435,236,236,0,NA,0.543,0.543,10578,399
"5722",174792,1993,1,0,"SAINT JOHNS UNIVERSITY",NA,NA,444,0,444,265,265,0,NA,0.597,0.597,11428,420
"5723",174792,1995,1,0,"SAINT JOHNS UNIVERSITY",NA,NA,430,0,430,286,286,0,NA,0.665,0.665,13089,409
"5724",174792,1996,1,0,"SAINT JOHNS UNIVERSITY",NA,NA,426,0,426,296,296,0,NA,0.695,0.695,13996,404
"5725",174792,1997,1,0,"SAINT JOHNS UNIVERSITY",NA,NA,450,0,450,335,335,0,NA,0.744,0.744,14758,434
"5726",174792,1998,1,0,"SAINT JOHNS UNIVERSITY",NA,NA,427,0,427,317,317,0,NA,0.742,0.742,15574,410
"5727",174792,1999,1,0,"SAINT JOHNS UNIVERSITY",NA,NA,475,0,475,335,335,0,NA,0.705,0.705,16195,457
"5728",174792,2000,1,0,"SAINT JOHNS UNIVERSITY",NA,NA,522,0,522,406,406,0,NA,0.778,0.778,16995,486
"5729",174792,2001,1,0,"SAINT JOHNS UNIVERSITY",NA,NA,502,0,502,360,360,0,NA,0.717,0.717,18015,470
"5730",174792,2002,1,0,"SAINT JOHNS UNIVERSITY",NA,NA,468,0,468,340,340,0,NA,0.726,0.726,18916,435
"5731",174792,2003,1,0,"SAINT JOHNS UNIVERSITY",NA,NA,490,0,490,346,346,0,NA,0.706,0.706,20335,451
"5732",174792,2004,1,0,"SAINT JOHNS UNIVERSITY",NA,NA,512,0,512,338,338,0,NA,0.66,0.66,21758,480
"5733",174792,2005,1,0,"Saint Johns University",NA,NA,447,0,447,325,325,0,NA,0.727,0.727,23064,410
"5734",174792,2006,1,0,"Saint Johns University",NA,NA,506,0,506,347,347,0,NA,0.686,0.686,24448,461
"5735",174792,2007,1,0,"Saint Johns University",NA,NA,516,0,516,364,364,0,NA,0.705,0.705,26038,468
"5736",174792,2008,1,0,"Saint Johns University",NA,NA,461,0,461,332,332,0,NA,0.72,0.72,28122,402
"5737",174792,2009,1,0,"Saint Johns University",NA,NA,461,0,461,303,303,0,NA,0.657,0.657,29388,375
"5738",174792,2010,1,0,"Saint Johns University",NA,NA,503,0,503,360,360,0,NA,0.716,0.716,31006,427
"5739",174844,1991,1,0,"SAINT OLAF COLLEGE",NA,NA,733,391,342,534,246,288,0.737,0.729,0.719,12080,674
"5740",174844,1992,1,0,"SAINT OLAF COLLEGE",NA,NA,701,409,292,501,192,309,0.755,0.715,0.658,12750,641
"5741",174844,1993,1,0,"SAINT OLAF COLLEGE",NA,NA,737,413,324,515,215,300,0.726,0.699,0.664,13560,687
"5742",174844,1995,1,0,"SAINT OLAF COLLEGE",NA,NA,742,431,311,557,223,334,0.775,0.751,0.717,15000,692
"5743",174844,1996,1,0,"SAINT OLAF COLLEGE",NA,NA,771,448,323,565,228,337,0.752,0.733,0.706,15700,715
"5744",174844,1997,1,0,"SAINT OLAF COLLEGE",NA,NA,722,416,306,539,227,312,0.75,0.747,0.742,16500,666
"5745",174844,1998,1,0,"SAINT OLAF COLLEGE",NA,NA,756,431,325,594,256,338,0.784,0.786,0.788,17140,692
"5746",174844,1999,1,0,"SAINT OLAF COLLEGE",NA,NA,761,451,310,594,225,369,0.818,0.781,0.726,18250,661
"5747",174844,2000,1,0,"SAINT OLAF COLLEGE",NA,NA,753,441,312,600,232,368,0.835,0.797,0.744,19400,675
"5748",174844,2001,1,0,"SAINT OLAF COLLEGE",NA,NA,744,432,312,608,253,355,0.822,0.817,0.811,21280,639
"5749",174844,2002,1,0,"SAINT OLAF COLLEGE",NA,NA,777,479,298,645,235,410,0.856,0.83,0.789,22200,689
"5750",174844,2003,1,0,"SAINT OLAF COLLEGE",NA,NA,719,422,297,593,234,359,0.851,0.825,0.788,23650,606
"5751",174844,2004,1,0,"SAINT OLAF COLLEGE",NA,NA,777,446,331,631,258,373,0.836,0.812,0.779,25150,632
"5752",174844,2005,1,0,"St. Olaf College",NA,NA,764,426,338,617,270,347,0.815,0.808,0.799,26500,657
"5753",174844,2006,1,0,"St. Olaf College",NA,NA,792,436,356,660,288,372,0.853,0.833,0.809,28200,688
"5754",174844,2007,1,0,"St. Olaf College",NA,NA,751,406,345,624,287,337,0.83,0.831,0.832,30600,652
"5755",174844,2008,1,0,"St. Olaf College",NA,NA,813,454,359,698,292,406,0.894,0.859,0.813,34300,688
"5756",174844,2009,1,0,"St. Olaf College",NA,NA,778,445,333,652,267,385,0.865,0.838,0.802,35500,640
"5757",174844,2010,1,0,"St Olaf College",NA,NA,844,434,410,719,332,387,0.892,0.852,0.81,36800,690
"5758",174899,1991,0,1,"COLLEGE OF SAINT SCHOLASTICA",1999,0,276,206,70,114,28,86,0.418,0.413,0.4,9861,273
"5759",174899,1992,0,1,"COLLEGE OF SAINT SCHOLASTICA",1999,0,325,240,85,126,36,90,0.375,0.388,0.424,10659,318
"5760",174899,1993,0,1,"COLLEGE OF SAINT SCHOLASTICA",1999,0,254,193,61,120,25,95,0.492,0.472,0.41,11280,222
"5761",174899,1995,0,1,"COLLEGE OF SAINT SCHOLASTICA",1999,0,270,201,69,142,30,112,0.557,0.526,0.435,12534,238
"5762",174899,1996,0,1,"COLLEGE OF SAINT SCHOLASTICA",1999,0,295,229,66,145,36,109,0.476,0.492,0.545,13131,265
"5763",174899,1997,0,1,"COLLEGE OF SAINT SCHOLASTICA",1999,0,244,180,64,141,32,109,0.606,0.578,0.5,13995,211
"5764",174899,1998,0,1,"COLLEGE OF SAINT SCHOLASTICA",1999,0,277,213,64,163,30,133,0.624,0.588,0.469,15060,245
"5765",174899,1999,1,0,"THE COLLEGE OF SAINT SCHOLASTICA",1999,1,305,230,75,156,36,120,0.522,0.511,0.48,15420,275
"5766",174899,2000,1,0,"THE COLLEGE OF SAINT SCHOLASTICA",1999,1,315,226,89,173,45,128,0.566,0.549,0.506,16190,287
"5767",174899,2001,1,0,"THE COLLEGE OF SAINT SCHOLASTICA",1999,1,314,224,90,175,48,127,0.567,0.557,0.533,17080,288
"5768",174899,2002,1,0,"THE COLLEGE OF SAINT SCHOLASTICA",1999,1,382,286,96,218,43,175,0.612,0.571,0.448,18106,348
"5769",174899,2003,1,0,"THE COLLEGE OF SAINT SCHOLASTICA",1999,1,411,299,112,256,75,181,0.605,0.623,0.67,19192,371
"5770",174899,2004,1,0,"THE COLLEGE OF SAINT SCHOLASTICA",1999,1,437,300,137,227,66,161,0.537,0.519,0.482,20630,382
"5771",174899,2005,1,0,"The College of Saint Scholastica",1999,1,490,350,140,265,70,195,0.557,0.541,0.5,22110,438
"5772",174899,2006,1,0,"The College of Saint Scholastica",1999,1,493,331,162,283,79,204,0.616,0.574,0.488,23434,412
"5773",174899,2007,1,0,"The College of Saint Scholastica",1999,1,487,336,151,288,76,212,0.631,0.591,0.503,24840,423
"5774",174899,2008,1,0,"The College of Saint Scholastica",1999,1,575,381,194,314,93,221,0.58,0.546,0.479,26324,476
"5775",174899,2009,1,0,"The College of Saint Scholastica",1999,1,540,359,181,337,90,247,0.688,0.624,0.497,27114,476
"5776",174899,2010,1,0,"The College of Saint Scholastica",1999,1,575,358,217,328,100,228,0.637,0.57,0.461,28200,489
"5777",174914,1991,1,0,"UNIVERSITY OF ST THOMAS",NA,NA,854,457,397,393,174,219,0.479,0.46,0.438,10564,784
"5778",174914,1992,1,0,"UNIVERSITY OF ST THOMAS",NA,NA,798,444,354,362,141,221,0.498,0.454,0.398,11204,727
"5779",174914,1993,1,0,"UNIVERSITY OF ST THOMAS",NA,NA,827,439,388,382,155,227,0.517,0.462,0.399,11748,737
"5780",174914,1995,1,0,"UNIVERSITY OF ST THOMAS",NA,NA,852,454,398,430,181,249,0.548,0.505,0.455,13106,769
"5781",174914,1996,1,0,"UNIVERSITY OF ST THOMAS",NA,NA,991,540,451,519,204,315,0.583,0.524,0.452,13778,919
"5782",174914,1997,1,0,"UNIVERSITY OF ST THOMAS",NA,NA,955,514,441,595,237,358,0.697,0.623,0.537,14660,869
"5783",174914,1998,1,0,"UNIVERSITY OF ST THOMAS",NA,NA,1038,579,459,561,230,331,0.572,0.54,0.501,15396,942
"5784",174914,1999,1,0,"UNIVERSITY OF ST THOMAS",NA,NA,1087,603,484,642,255,387,0.642,0.591,0.527,16128,993
"5785",174914,2000,1,0,"UNIVERSITY OF ST THOMAS",NA,NA,1082,578,504,597,244,353,0.611,0.552,0.484,17088,971
"5786",174914,2001,1,0,"UNIVERSITY OF ST THOMAS",NA,NA,1080,579,501,601,253,348,0.601,0.556,0.505,18096,943
"5787",174914,2002,1,0,"UNIVERSITY OF ST THOMAS",NA,NA,1095,577,518,629,280,349,0.605,0.574,0.541,19120,992
"5788",174914,2003,1,0,"UNIVERSITY OF ST THOMAS",NA,NA,1038,547,491,584,244,340,0.622,0.563,0.497,20240,952
"5789",174914,2004,1,0,"UNIVERSITY OF ST THOMAS",NA,NA,1161,608,553,710,312,398,0.655,0.612,0.564,21440,970
"5790",174914,2005,1,0,"University of St Thomas",NA,NA,1325,706,619,812,342,470,0.666,0.613,0.553,22880,1115
"5791",174914,2006,1,0,"University of St Thomas",NA,NA,1298,644,654,816,392,424,0.658,0.629,0.599,24368,1129
"5792",174914,2007,1,0,"University of St Thomas",NA,NA,1313,672,641,822,365,457,0.68,0.626,0.569,25808,1111
"5793",174914,2008,1,0,"University of St Thomas",NA,NA,1321,638,683,792,374,418,0.655,0.6,0.548,27328,1088
"5794",174914,2009,1,0,"University of St Thomas",NA,NA,1350,586,764,812,439,373,0.636,0.601,0.575,28944,1106
"5795",174914,2010,1,0,"University of St Thomas",NA,NA,1518,762,756,941,396,545,0.715,0.62,0.524,29952,1329
"5796",175342,1991,1,0,"ALCORN STATE UNIVERSITY",NA,NA,899,520,379,108,25,83,0.16,0.12,0.066,2068,16
"5797",175342,1992,1,0,"ALCORN STATE UNIVERSITY",NA,NA,531,310,221,73,16,57,0.184,0.137,0.072,2376,19
"5798",175342,1993,1,0,"ALCORN STATE UNIVERSITY",NA,NA,506,299,207,100,24,76,0.254,0.198,0.116,2376,9
"5799",175342,1995,1,0,"ALCORN STATE UNIVERSITY",NA,NA,746,410,336,148,38,110,0.268,0.198,0.113,2389,3
"5800",175342,1996,1,0,"ALCORN STATE UNIVERSITY",NA,NA,621,384,237,175,44,131,0.341,0.282,0.186,2389,4
"5801",175342,1997,1,0,"ALCORN STATE UNIVERSITY",NA,NA,532,299,233,138,42,96,0.321,0.259,0.18,2429,7
"5802",175342,1998,1,0,"ALCORN STATE UNIVERSITY",NA,NA,556,306,250,140,41,99,0.324,0.252,0.164,2685,3
"5803",175342,1999,1,0,"ALCORN STATE UNIVERSITY",NA,NA,553,309,244,130,41,89,0.288,0.235,0.168,2685,1
"5804",175342,2000,1,0,"ALCORN STATE UNIVERSITY",NA,NA,489,248,241,107,28,79,0.318,0.219,0.116,2585,5
"5805",175342,2001,1,0,"ALCORN STATE UNIVERSITY",NA,NA,495,262,233,97,36,61,0.233,0.196,0.155,2294,6
"5806",175342,2002,1,0,"ALCORN STATE UNIVERSITY",NA,NA,423,249,174,86,23,63,0.253,0.203,0.132,2478,8
"5807",175342,2003,1,0,"ALCORN STATE UNIVERSITY",NA,NA,495,271,224,108,32,76,0.28,0.218,0.143,2478,8
"5808",175342,2004,1,0,"ALCORN STATE UNIVERSITY",NA,NA,572,309,263,116,33,83,0.269,0.203,0.125,2999,21
"5809",175342,2005,1,0,"Alcorn State University",NA,NA,526,274,252,100,44,56,0.204,0.19,0.175,2733,17
"5810",175342,2006,1,0,"Alcorn State University",NA,NA,545,302,243,79,34,45,0.149,0.145,0.14,3300,7
"5811",175342,2007,1,0,"Alcorn State University",NA,NA,514,305,209,94,27,67,0.22,0.183,0.129,3432,3
"5812",175342,2008,1,0,"Alcorn State University",NA,NA,451,261,190,87,36,51,0.195,0.193,0.189,3571,7
"5813",175342,2009,1,0,"Alcorn State University",NA,NA,463,277,186,77,20,57,0.206,0.166,0.108,3571,12
"5814",175342,2010,1,0,"Alcorn State University",NA,NA,588,341,247,94,25,69,0.202,0.16,0.101,3931,2
"5815",175421,1991,1,0,"BELHAVEN COLLEGE",NA,NA,43,27,16,5,2,3,0.111,0.116,0.125,5850,29
"5816",175421,1992,1,0,"BELHAVEN COLLEGE",NA,NA,89,52,37,22,10,12,0.231,0.247,0.27,6300,70
"5817",175421,1993,1,0,"BELHAVEN COLLEGE",NA,NA,113,59,54,37,16,21,0.356,0.327,0.296,6980,88
"5818",175421,1995,1,0,"BELHAVEN COLLEGE",NA,NA,112,67,45,39,13,26,0.388,0.348,0.289,7890,90
"5819",175421,1996,1,0,"BELHAVEN COLLEGE",NA,NA,84,42,42,21,11,10,0.238,0.25,0.262,8390,62
"5820",175421,1997,1,0,"BELHAVEN COLLEGE",NA,NA,86,42,44,28,11,17,0.405,0.326,0.25,8990,71
"5821",175421,1998,1,0,"BELHAVEN COLLEGE",NA,NA,112,53,59,35,12,23,0.434,0.312,0.203,9870,90
"5822",175421,1999,1,0,"BELHAVEN COLLEGE",NA,NA,144,71,73,46,25,21,0.296,0.319,0.342,9960,101
"5823",175421,2000,1,0,"BELHAVEN COLLEGE",NA,NA,182,95,87,50,19,31,0.326,0.275,0.218,10450,137
"5824",175421,2001,1,0,"BELHAVEN COLLEGE",NA,NA,224,122,102,50,22,28,0.23,0.223,0.216,10990,160
"5825",175421,2002,1,0,"BELHAVEN COLLEGE",NA,NA,266,150,116,68,19,49,0.327,0.256,0.164,11580,187
"5826",175421,2003,1,0,"BELHAVEN COLLEGE",NA,NA,170,96,74,53,15,38,0.396,0.312,0.203,12200,127
"5827",175421,2004,1,0,"BELHAVEN COLLEGE",NA,NA,237,144,93,94,28,66,0.458,0.397,0.301,12800,164
"5828",175421,2005,1,0,"Belhaven College",NA,NA,201,105,96,68,16,52,0.495,0.338,0.167,13450,155
"5829",175421,2006,1,0,"Belhaven College",NA,NA,248,133,115,76,31,45,0.338,0.306,0.27,14124,166
"5830",175421,2007,1,0,"Belhaven College",NA,NA,241,134,107,60,15,45,0.336,0.249,0.14,15580,146
"5831",175421,2008,1,0,"Belhaven College",NA,NA,239,146,93,79,27,52,0.356,0.331,0.29,16360,141
"5832",175421,2009,1,0,"Belhaven University",NA,NA,208,116,92,67,18,49,0.422,0.322,0.196,16780,123
"5833",175421,2010,1,0,"Belhaven University",NA,NA,234,126,108,65,17,48,0.381,0.278,0.157,17700,117
"5834",175616,1991,1,0,"DELTA STATE UNIVERSITY",NA,NA,445,283,162,111,33,78,0.276,0.249,0.204,2000,341
"5835",175616,1992,1,0,"DELTA STATE UNIVERSITY",NA,NA,443,247,196,98,35,63,0.255,0.221,0.179,2194,345
"5836",175616,1993,1,0,"DELTA STATE UNIVERSITY",NA,NA,450,255,195,81,28,53,0.208,0.18,0.144,2194,360
"5837",175616,1995,1,0,"DELTA STATE UNIVERSITY",NA,NA,464,301,163,102,25,77,0.256,0.22,0.153,2294,333
"5838",175616,1996,1,0,"DELTA STATE UNIVERSITY",NA,NA,449,278,171,94,27,67,0.241,0.209,0.158,2294,306
"5839",175616,1997,1,0,"DELTA STATE UNIVERSITY",NA,NA,521,338,183,136,40,96,0.284,0.261,0.219,2354,368
"5840",175616,1998,1,0,"DELTA STATE UNIVERSITY",NA,NA,427,265,162,100,23,77,0.291,0.234,0.142,2596,298
"5841",175616,1999,1,0,"DELTA STATE UNIVERSITY",NA,NA,458,275,183,107,38,69,0.251,0.234,0.208,2054,334
"5842",175616,2000,1,0,"DELTA STATE UNIVERSITY",NA,NA,461,273,188,111,24,87,0.319,0.241,0.128,2145,331
"5843",175616,2001,1,0,"DELTA STATE UNIVERSITY",NA,NA,430,253,177,77,21,56,0.221,0.179,0.119,2549,308
"5844",175616,2002,1,0,"DELTA STATE UNIVERSITY",NA,NA,336,200,136,58,13,45,0.225,0.173,0.096,2924,236
"5845",175616,2003,1,0,"DELTA STATE UNIVERSITY",NA,NA,327,191,136,55,19,36,0.189,0.168,0.14,2924,198
"5846",175616,2004,1,0,"DELTA STATE UNIVERSITY",NA,NA,381,211,170,76,24,52,0.246,0.199,0.141,3092,258
"5847",175616,2005,1,0,"Delta State University",NA,NA,393,222,171,67,25,42,0.189,0.17,0.146,3272,236
"5848",175616,2006,1,0,"Delta State University",NA,NA,468,288,180,85,33,52,0.181,0.182,0.183,3518,294
"5849",175616,2007,1,0,"Delta State University",NA,NA,477,293,184,78,27,51,0.174,0.164,0.147,3708,268
"5850",175616,2008,1,0,"Delta State University",NA,NA,384,227,157,58,19,39,0.172,0.151,0.121,3946,221
"5851",175616,2009,1,0,"Delta State University",NA,NA,367,230,137,62,22,40,0.174,0.169,0.161,3946,189
"5852",175616,2010,1,0,"Delta State University",NA,NA,370,208,162,61,25,36,0.173,0.165,0.154,4347,219
"5853",175856,1991,1,0,"JACKSON STATE UNIVERSITY",NA,NA,1081,615,466,113,34,79,0.128,0.105,0.073,2028,2
"5854",175856,1992,1,0,"JACKSON STATE UNIVERSITY",NA,NA,906,477,429,89,21,68,0.143,0.098,0.049,2230,4
"5855",175856,1993,1,0,"JACKSON STATE UNIVERSITY",NA,NA,1105,596,509,124,35,89,0.149,0.112,0.069,2230,3
"5856",175856,1995,1,0,"JACKSON STATE UNIVERSITY",NA,NA,1212,679,533,162,39,123,0.181,0.134,0.073,2380,2
"5857",175856,1996,1,0,"JACKSON STATE UNIVERSITY",NA,NA,906,508,398,140,33,107,0.211,0.155,0.083,2380,2
"5858",175856,1997,1,0,"JACKSON STATE UNIVERSITY",NA,NA,808,463,345,124,28,96,0.207,0.153,0.081,2380,5
"5859",175856,1998,1,0,"JACKSON STATE UNIVERSITY",NA,NA,842,494,348,155,43,112,0.227,0.184,0.124,2688,0
"5860",175856,1999,1,0,"JACKSON STATE UNIVERSITY",NA,NA,845,527,318,128,34,94,0.178,0.151,0.107,2688,1
"5861",175856,2000,1,0,"JACKSON STATE UNIVERSITY",NA,NA,936,547,389,134,40,94,0.172,0.143,0.103,2788,2
"5862",175856,2001,1,0,"JACKSON STATE UNIVERSITY",NA,NA,930,540,390,154,35,119,0.22,0.166,0.09,3206,4
"5863",175856,2002,1,0,"JACKSON STATE UNIVERSITY",NA,NA,1014,581,433,206,49,157,0.27,0.203,0.113,3462,5
"5864",175856,2003,1,0,"JACKSON STATE UNIVERSITY",NA,NA,883,470,413,141,43,98,0.209,0.16,0.104,3612,2
"5865",175856,2004,1,0,"JACKSON STATE UNIVERSITY",NA,NA,995,587,408,200,50,150,0.256,0.201,0.123,3842,5
"5866",175856,2005,1,0,"Jackson State University",NA,NA,1131,690,441,221,64,157,0.228,0.195,0.145,3964,18
"5867",175856,2006,1,0,"Jackson State University",NA,NA,889,513,376,191,57,134,0.261,0.215,0.152,4224,19
"5868",175856,2007,1,0,"Jackson State University",NA,NA,919,541,378,153,41,112,0.207,0.166,0.108,4432,18
"5869",175856,2008,1,0,"Jackson State University",NA,NA,938,547,391,177,48,129,0.236,0.189,0.123,4634,15
"5870",175856,2009,1,0,"Jackson State University",NA,NA,841,507,334,157,47,110,0.217,0.187,0.141,4634,14
"5871",175856,2010,1,0,"Jackson State University",NA,NA,879,489,390,169,52,117,0.239,0.192,0.133,5050,33
"5872",175980,1991,1,0,"MILLSAPS COLLEGE",NA,NA,273,140,133,170,73,97,0.693,0.623,0.549,9710,256
"5873",175980,1992,1,0,"MILLSAPS COLLEGE",NA,NA,274,143,131,167,75,92,0.643,0.609,0.573,10280,252
"5874",175980,1993,1,0,"MILLSAPS COLLEGE",NA,NA,319,161,158,189,95,94,0.584,0.592,0.601,11236,304
"5875",175980,1995,1,0,"MILLSAPS COLLEGE",NA,NA,261,128,133,180,74,106,0.828,0.69,0.556,12700,237
"5876",175980,1996,1,0,"MILLSAPS COLLEGE",NA,NA,292,163,129,166,64,102,0.626,0.568,0.496,13088,262
"5877",175980,1997,1,0,"MILLSAPS COLLEGE",NA,NA,299,159,140,188,84,104,0.654,0.629,0.6,13612,263
"5878",175980,1998,1,0,"MILLSAPS COLLEGE",NA,NA,286,145,141,169,79,90,0.621,0.591,0.56,14424,243
"5879",175980,1999,1,0,"MILLSAPS COLLEGE",NA,NA,284,158,126,177,67,110,0.696,0.623,0.532,14190,244
"5880",175980,2000,1,0,"MILLSAPS COLLEGE",NA,NA,292,152,140,176,82,94,0.618,0.603,0.586,14900,246
"5881",175980,2001,1,0,"MILLSAPS COLLEGE",NA,NA,324,178,146,208,80,128,0.719,0.642,0.548,15586,273
"5882",175980,2002,1,0,"MILLSAPS COLLEGE",NA,NA,251,125,126,159,75,84,0.672,0.633,0.595,16364,204
"5883",175980,2003,1,0,"MILLSAPS COLLEGE",NA,NA,259,141,118,152,63,89,0.631,0.587,0.534,17346,218
"5884",175980,2004,1,0,"MILLSAPS COLLEGE",NA,NA,278,136,142,170,83,87,0.64,0.612,0.585,18386,219
"5885",175980,2005,1,0,"Millsaps College",NA,NA,258,118,140,158,76,82,0.695,0.612,0.543,19490,208
"5886",175980,2006,1,0,"Millsaps College",NA,NA,225,122,103,149,63,86,0.705,0.662,0.612,20660,183
"5887",175980,2007,1,0,"Millsaps College",NA,NA,296,154,142,175,75,100,0.649,0.591,0.528,21900,247
"5888",175980,2008,1,0,"Millsaps College",NA,NA,266,141,125,165,66,99,0.702,0.62,0.528,23214,188
"5889",175980,2009,1,0,"Millsaps College",NA,NA,281,116,165,166,80,86,0.741,0.591,0.485,24608,205
"5890",175980,2010,1,0,"Millsaps College",NA,NA,211,106,105,145,69,76,0.717,0.687,0.657,26084,149
"5891",176017,1991,1,0,"UNIVERSITY OF MISSISSIPPI MAIN CAMPUS",NA,NA,1690,892,798,484,169,315,0.353,0.286,0.212,2221,1537
"5892",176017,1992,1,0,"UNIVERSITY OF MISSISSIPPI MAIN CAMPUS",NA,NA,1610,810,800,460,175,285,0.352,0.286,0.219,2435,1448
"5893",176017,1993,1,0,"UNIVERSITY OF MISSISSIPPI MAIN CAMPUS",NA,NA,1538,796,742,461,156,305,0.383,0.3,0.21,2456,1386
"5894",176017,1995,1,0,"UNIVERSITY OF MISSISSIPPI MAIN CAMPUS",NA,NA,1526,825,701,490,180,310,0.376,0.321,0.257,2546,1363
"5895",176017,1996,1,0,"UNIVERSITY OF MISSISSIPPI MAIN CAMPUS",NA,NA,1736,909,827,580,199,381,0.419,0.334,0.241,2631,1512
"5896",176017,1997,1,0,"UNIVERSITY OF MISSISSIPPI MAIN CAMPUS",NA,NA,1770,948,822,578,209,369,0.389,0.327,0.254,2731,1526
"5897",176017,1998,1,0,"UNIVERSITY OF MISSISSIPPI MAIN CAMPUS",NA,NA,1794,920,874,602,213,389,0.423,0.336,0.244,3053,1577
"5898",176017,1999,1,0,"UNIVERSITY OF MISSISSIPPI MAIN CAMPUS",NA,NA,1810,944,866,621,218,403,0.427,0.343,0.252,3053,1537
"5899",176017,2000,1,0,"UNIVERSITY OF MISSISSIPPI MAIN CAMPUS",NA,NA,1981,1019,962,655,248,407,0.399,0.331,0.258,3153,1693
"5900",176017,2001,1,0,"UNIVERSITY OF MISSISSIPPI MAIN CAMPUS",NA,NA,2126,1110,1016,402,215,187,0.168,0.189,0.212,3626,1788
"5901",176017,2002,1,0,"UNIVERSITY OF MISSISSIPPI MAIN CAMPUS",NA,NA,2230,1150,1080,724,271,453,0.394,0.325,0.251,3916,1871
"5902",176017,2003,1,0,"UNIVERSITY OF MISSISSIPPI MAIN CAMPUS",NA,NA,2377,1297,1080,851,286,565,0.436,0.358,0.265,3916,1991
"5903",176017,2004,1,0,"UNIVERSITY OF MISSISSIPPI MAIN CAMPUS",NA,NA,2248,1185,1063,761,292,469,0.396,0.339,0.275,4110,1906
"5904",176017,2005,1,0,"University of Mississippi Main Campus",NA,NA,2131,1139,992,800,280,520,0.456,0.375,0.282,4320,1823
"5905",176017,2006,1,0,"University of Mississippi Main Campus",NA,NA,2521,1320,1201,920,352,568,0.43,0.365,0.293,4602,2061
"5906",176017,2007,1,0,"University of Mississippi Main Campus",NA,NA,2434,1293,1141,885,328,557,0.431,0.364,0.287,4932,2002
"5907",176017,2008,1,0,"University of Mississippi Main Campus",NA,NA,2316,1272,1044,857,301,556,0.437,0.37,0.288,5106,1846
"5908",176017,2009,1,0,"University of Mississippi Main Campus",NA,NA,2547,1358,1189,996,360,636,0.468,0.391,0.303,5106,2012
"5909",176017,2010,1,0,"University of Mississippi Main Campus",NA,NA,3065,1580,1485,1135,440,695,0.44,0.37,0.296,5436,2321
"5910",176035,1991,1,0,"MISSISSIPPI UNIVERSITY FOR WOMEN",NA,NA,339,282,57,99,10,89,0.316,0.292,0.175,2043,273
"5911",176035,1992,1,0,"MISSISSIPPI UNIVERSITY FOR WOMEN",NA,NA,259,210,49,52,6,46,0.219,0.201,0.122,2239,197
"5912",176035,1993,1,0,"MISSISSIPPI UNIVERSITY FOR WOMEN",NA,NA,272,229,43,68,5,63,0.275,0.25,0.116,2239,190
"5913",176035,1995,1,0,"MISSISSIPPI UNIVERSITY FOR WOMEN",NA,NA,288,238,50,59,7,52,0.219,0.205,0.14,2244,205
"5914",176035,1996,1,0,"MISSISSIPPI UNIVERSITY FOR WOMEN",NA,NA,291,248,43,58,2,56,0.226,0.199,0.047,2284,214
"5915",176035,1997,1,0,"MISSISSIPPI UNIVERSITY FOR WOMEN",NA,NA,231,193,38,71,6,65,0.337,0.307,0.158,2284,171
"5916",176035,1998,1,0,"MISSISSIPPI UNIVERSITY FOR WOMEN",NA,NA,210,180,30,47,4,43,0.239,0.224,0.133,2556,150
"5917",176035,1999,1,0,"MISSISSIPPI UNIVERSITY FOR WOMEN",NA,NA,202,177,25,59,3,56,0.316,0.292,0.12,2556,128
"5918",176035,2000,1,0,"MISSISSIPPI UNIVERSITY FOR WOMEN",NA,NA,205,190,15,57,0,57,0.3,0.278,0,2656,132
"5919",176035,2001,1,0,"MISSISSIPPI UNIVERSITY FOR WOMEN",NA,NA,189,163,26,44,3,41,0.252,0.233,0.115,3054,129
"5920",176035,2002,1,0,"MISSISSIPPI UNIVERSITY FOR WOMEN",NA,NA,250,223,27,61,2,59,0.265,0.244,0.074,3298,162
"5921",176035,2003,1,0,"MISSISSIPPI UNIVERSITY FOR WOMEN",NA,NA,202,178,24,48,3,45,0.253,0.238,0.125,3298,136
"5922",176035,2004,1,0,"MISSISSIPPI UNIVERSITY FOR WOMEN",NA,NA,242,207,35,55,1,54,0.261,0.227,0.029,3495,161
"5923",176035,2005,1,0,"Mississippi University for Women",NA,NA,238,204,34,53,5,48,0.235,0.223,0.147,3690,147
"5924",176035,2006,1,0,"Mississippi University for Women",NA,NA,256,243,13,53,3,50,0.206,0.207,0.231,3933,145
"5925",176035,2007,1,0,"Mississippi University for Women",NA,NA,235,213,22,46,6,40,0.188,0.196,0.273,4209,123
"5926",176035,2008,1,0,"Mississippi University for Women",NA,NA,252,212,40,54,7,47,0.222,0.214,0.175,4423,121
"5927",176035,2009,1,0,"Mississippi University for Women",NA,NA,216,177,39,56,10,46,0.26,0.259,0.256,4423,103
"5928",176035,2010,1,0,"Mississippi University for Women",NA,NA,199,154,45,50,7,43,0.279,0.251,0.156,4644,105
"5929",176044,1991,1,0,"MISSISSIPPI VALLEY STATE UNIVERSITY",NA,NA,386,223,163,34,7,27,0.121,0.088,0.043,1952,0
"5930",176044,1992,1,0,"MISSISSIPPI VALLEY STATE UNIVERSITY",NA,NA,563,290,273,64,26,38,0.131,0.114,0.095,2164,6
"5931",176044,1993,1,0,"MISSISSIPPI VALLEY STATE UNIVERSITY",NA,NA,478,256,222,57,19,38,0.148,0.119,0.086,2164,1
"5932",176044,1995,1,0,"MISSISSIPPI VALLEY STATE UNIVERSITY",NA,NA,448,244,204,87,23,64,0.262,0.194,0.113,2278,2
"5933",176044,1996,1,0,"MISSISSIPPI VALLEY STATE UNIVERSITY",NA,NA,367,170,197,59,26,33,0.194,0.161,0.132,2278,2
"5934",176044,1997,1,0,"MISSISSIPPI VALLEY STATE UNIVERSITY",NA,NA,343,198,145,73,23,50,0.252,0.213,0.159,2353,2
"5935",176044,1998,1,0,"MISSISSIPPI VALLEY STATE UNIVERSITY",NA,NA,321,182,139,68,16,52,0.286,0.212,0.115,2646,4
"5936",176044,1999,1,0,"MISSISSIPPI VALLEY STATE UNIVERSITY",NA,NA,248,138,110,48,18,30,0.217,0.194,0.164,2646,1
"5937",176044,2000,1,0,"MISSISSIPPI VALLEY STATE UNIVERSITY",NA,NA,297,173,124,41,13,28,0.162,0.138,0.105,2746,3
"5938",176044,2001,1,0,"MISSISSIPPI VALLEY STATE UNIVERSITY",NA,NA,258,158,100,42,9,33,0.209,0.163,0.09,3158,3
"5939",176044,2002,1,0,"MISSISSIPPI VALLEY STATE UNIVERSITY",NA,NA,269,129,140,37,14,23,0.178,0.138,0.1,3411,9
"5940",176044,2003,1,0,"MISSISSIPPI VALLEY STATE UNIVERSITY",NA,NA,325,187,138,57,16,41,0.219,0.175,0.116,3411,13
"5941",176044,2004,1,0,"MISSISSIPPI VALLEY STATE UNIVERSITY",NA,NA,372,184,188,51,15,36,0.196,0.137,0.08,3832,8
"5942",176044,2005,1,0,"Mississippi Valley State University",NA,NA,398,197,201,43,13,30,0.152,0.108,0.065,4024,18
"5943",176044,2006,1,0,"Mississippi Valley State University",NA,NA,443,216,227,55,14,41,0.19,0.124,0.062,4247,25
"5944",176044,2007,1,0,"Mississippi Valley State University",NA,NA,485,256,229,51,15,36,0.141,0.105,0.066,4417,15
"5945",176044,2008,1,0,"Mississippi Valley State University",NA,NA,446,203,243,57,23,34,0.168,0.128,0.095,4574,15
"5946",176044,2009,1,0,"Mississippi Valley State University",NA,NA,413,222,191,43,13,30,0.135,0.104,0.068,4754,18
"5947",176044,2010,1,0,"Mississippi Valley State University",NA,NA,382,192,190,68,25,43,0.224,0.178,0.132,4781,12
"5948",176080,1991,1,0,"MISSISSIPPI STATE UNIVERSITY",NA,NA,1569,715,854,320,134,186,0.26,0.204,0.157,2223,1291
"5949",176080,1992,1,0,"MISSISSIPPI STATE UNIVERSITY",NA,NA,1672,760,912,316,130,186,0.245,0.189,0.143,2474,1338
"5950",176080,1993,1,0,"MISSISSIPPI STATE UNIVERSITY",NA,NA,1633,777,856,330,118,212,0.273,0.202,0.138,2474,1286
"5951",176080,1995,1,0,"MISSISSIPPI STATE UNIVERSITY",NA,NA,1826,845,981,382,158,224,0.265,0.209,0.161,2591,1430
"5952",176080,1996,1,0,"MISSISSIPPI STATE UNIVERSITY",NA,NA,1864,869,995,463,175,288,0.331,0.248,0.176,2631,1506
"5953",176080,1997,1,0,"MISSISSIPPI STATE UNIVERSITY",NA,NA,2016,965,1051,462,162,300,0.311,0.229,0.154,2731,1578
"5954",176080,1998,1,0,"MISSISSIPPI STATE UNIVERSITY",NA,NA,1929,944,985,501,178,323,0.342,0.26,0.181,3017,1450
"5955",176080,1999,1,0,"MISSISSIPPI STATE UNIVERSITY",NA,NA,2033,1003,1030,507,177,330,0.329,0.249,0.172,3017,1511
"5956",176080,2000,1,0,"MISSISSIPPI STATE UNIVERSITY",NA,NA,2055,1057,998,556,204,352,0.333,0.271,0.204,3117,1540
"5957",176080,2001,1,0,"MISSISSIPPI STATE UNIVERSITY",NA,NA,1826,909,917,483,201,282,0.31,0.265,0.219,3586,1444
"5958",176080,2002,1,0,"MISSISSIPPI STATE UNIVERSITY",NA,NA,1737,833,904,476,181,295,0.354,0.274,0.2,3874,1373
"5959",176080,2003,1,0,"MISSISSIPPI STATE UNIVERSITY",NA,NA,1659,822,837,509,185,324,0.394,0.307,0.221,3874,1303
"5960",176080,2004,1,0,"MISSISSIPPI STATE UNIVERSITY",NA,NA,1735,829,906,492,193,299,0.361,0.284,0.213,4106,1291
"5961",176080,2005,1,0,"Mississippi State University",NA,NA,1951,1010,941,585,215,370,0.366,0.3,0.228,4312,1408
"5962",176080,2006,1,0,"Mississippi State University",NA,NA,1897,947,950,575,233,342,0.361,0.303,0.245,4596,1396
"5963",176080,2007,1,0,"Mississippi State University",NA,NA,2262,1105,1157,699,274,425,0.385,0.309,0.237,4978,1662
"5964",176080,2008,1,0,"Mississippi State University",NA,NA,2474,1278,1196,746,282,464,0.363,0.302,0.236,5151,1811
"5965",176080,2009,1,0,"Mississippi State University",NA,NA,2447,1210,1237,755,282,473,0.391,0.309,0.228,5151,1778
"5966",176080,2010,1,0,"Mississippi State University",NA,NA,2688,1308,1380,847,348,499,0.382,0.315,0.252,5461,1857
"5967",176406,1991,1,0,"TOUGALOO COLLEGE",NA,NA,317,205,112,61,16,45,0.22,0.192,0.143,4395,0
"5968",176406,1992,1,0,"TOUGALOO COLLEGE",NA,NA,325,215,110,69,15,54,0.251,0.212,0.136,4835,0
"5969",176406,1993,1,0,"TOUGALOO COLLEGE",NA,NA,311,223,88,79,17,62,0.278,0.254,0.193,4795,0
"5970",176406,1995,1,0,"TOUGALOO COLLEGE",NA,NA,218,141,77,65,19,46,0.326,0.298,0.247,5440,0
"5971",176406,1996,1,0,"TOUGALOO COLLEGE",NA,NA,211,144,67,68,11,57,0.396,0.322,0.164,5712,0
"5972",176406,1997,1,0,"TOUGALOO COLLEGE",NA,NA,206,146,60,66,11,55,0.377,0.32,0.183,6160,0
"5973",176406,1998,1,0,"TOUGALOO COLLEGE",NA,NA,198,142,56,66,12,54,0.38,0.333,0.214,6610,0
"5974",176406,1999,1,0,"TOUGALOO COLLEGE",NA,NA,252,196,56,73,11,62,0.316,0.29,0.196,6400,0
"5975",176406,2000,1,0,"TOUGALOO COLLEGE",NA,NA,224,168,56,66,15,51,0.304,0.295,0.268,6600,0
"5976",176406,2001,1,0,"TOUGALOO COLLEGE",NA,NA,201,137,64,58,13,45,0.328,0.289,0.203,6900,0
"5977",176406,2002,1,0,"TOUGALOO COLLEGE",NA,NA,209,149,60,55,12,43,0.289,0.263,0.2,7245,0
"5978",176406,2003,1,0,"TOUGALOO COLLEGE",NA,NA,221,166,55,53,9,44,0.265,0.24,0.164,7750,1
"5979",176406,2004,1,0,"TOUGALOO COLLEGE",NA,NA,278,190,88,68,16,52,0.274,0.245,0.182,8140,0
"5980",176406,2005,1,0,"Tougaloo College",NA,NA,207,146,61,61,15,46,0.315,0.295,0.246,8800,0
"5981",176406,2006,1,0,"Tougaloo College",NA,NA,243,172,71,74,15,59,0.343,0.305,0.211,8800,1
"5982",176406,2007,1,0,"Tougaloo College",NA,NA,200,135,65,53,9,44,0.326,0.265,0.138,9240,0
"5983",176406,2008,1,0,"Tougaloo College",NA,NA,237,158,79,68,19,49,0.31,0.287,0.241,9240,1
"5984",176406,2009,1,0,"Tougaloo College",NA,NA,231,154,77,57,12,45,0.292,0.247,0.156,9240,4
"5985",176406,2010,1,0,"Tougaloo College",NA,NA,198,126,72,50,10,40,0.318,0.253,0.139,9240,4
"5986",176628,1991,1,0,"AVILA COLLEGE",NA,NA,88,53,35,27,8,19,0.359,0.307,0.229,7380,73
"5987",176628,1992,1,0,"AVILA COLLEGE",NA,NA,91,50,41,21,10,11,0.22,0.231,0.244,7980,83
"5988",176628,1993,1,0,"AVILA COLLEGE",NA,NA,84,57,27,25,3,22,0.386,0.298,0.111,8490,74
"5989",176628,1995,1,0,"AVILA COLLEGE",NA,NA,101,61,40,31,11,20,0.328,0.307,0.275,9600,78
"5990",176628,1996,1,0,"AVILA COLLEGE",NA,NA,91,56,35,20,5,15,0.268,0.22,0.143,10100,83
"5991",176628,1997,1,0,"AVILA COLLEGE",NA,NA,96,57,39,29,6,23,0.404,0.302,0.154,10700,68
"5992",176628,1998,1,0,"AVILA COLLEGE",NA,NA,113,64,49,39,9,30,0.469,0.345,0.184,11410,95
"5993",176628,1999,1,0,"AVILA COLLEGE",NA,NA,113,81,32,45,7,38,0.469,0.398,0.219,11800,91
"5994",176628,2000,1,0,"AVILA COLLEGE",NA,NA,162,91,71,36,5,31,0.341,0.222,0.07,12500,127
"5995",176628,2001,1,0,"AVILA COLLEGE",NA,NA,155,62,93,32,7,25,0.403,0.206,0.075,13150,119
"5996",176628,2002,1,0,"AVILA UNIVERSITY",NA,NA,129,70,59,29,5,24,0.343,0.225,0.085,13900,94
"5997",176628,2003,1,0,"AVILA UNIVERSITY",NA,NA,152,93,59,36,5,31,0.333,0.237,0.085,14700,111
"5998",176628,2004,1,0,"AVILA UNIVERSITY",NA,NA,129,88,41,39,3,36,0.409,0.302,0.073,15500,104
"5999",176628,2005,1,0,"Avila University",NA,NA,154,95,59,38,11,27,0.284,0.247,0.186,16300,111
"6000",176628,2006,1,0,"Avila University",NA,NA,138,78,60,34,11,23,0.295,0.246,0.183,17300,107
"6001",176628,2007,1,0,"Avila University",NA,NA,114,79,35,30,5,25,0.316,0.263,0.143,18300,96
"6002",176628,2008,1,0,"Avila University",NA,NA,183,105,78,45,9,36,0.343,0.246,0.115,19500,156
"6003",176628,2009,1,0,"Avila University",NA,NA,118,79,39,36,9,27,0.342,0.305,0.231,20250,93
"6004",176628,2010,1,0,"Avila University",NA,NA,166,94,72,46,11,35,0.372,0.277,0.153,21050,111
"6005",176947,1991,1,0,"CENTRAL METHODIST COLLEGE",NA,NA,240,109,131,52,22,30,0.275,0.217,0.168,6710,210
"6006",176947,1992,1,0,"CENTRAL METHODIST COLLEGE",NA,NA,209,79,130,42,20,22,0.278,0.201,0.154,7050,178
"6007",176947,1993,1,0,"CENTRAL METHODIST COLLEGE",NA,NA,238,108,130,62,21,41,0.38,0.261,0.162,7780,207
"6008",176947,1995,1,0,"CENTRAL METHODIST COLLEGE",NA,NA,229,95,134,73,36,37,0.39,0.319,0.269,9160,196
"6009",176947,1996,1,0,"CENTRAL METHODIST COLLEGE",NA,NA,212,82,130,48,19,29,0.354,0.226,0.146,9570,189
"6010",176947,1997,1,0,"CENTRAL METHODIST COLLEGE",NA,NA,233,115,118,72,25,47,0.409,0.309,0.212,10220,193
"6011",176947,1998,1,0,"CENTRAL METHODIST COLLEGE",NA,NA,218,111,107,59,19,40,0.36,0.271,0.178,10620,183
"6012",176947,1999,1,0,"CENTRAL METHODIST COLLEGE",NA,NA,228,108,120,62,25,37,0.343,0.272,0.208,10860,205
"6013",176947,2000,1,0,"CENTRAL METHODIST COLLEGE",NA,NA,216,102,114,68,17,51,0.5,0.315,0.149,11390,174
"6014",176947,2001,1,0,"CENTRAL METHODIST COLLEGE",NA,NA,240,116,124,67,23,44,0.379,0.279,0.185,11950,208
"6015",176947,2002,1,0,"CENTRAL METHODIST COLLEGE",NA,NA,232,100,132,61,16,45,0.45,0.263,0.121,12420,196
"6016",176947,2003,1,0,"CENTRAL METHODIST COLLEGE",NA,NA,223,93,130,64,25,39,0.419,0.287,0.192,13160,183
"6017",176947,2004,1,0,"CENTRAL METHODIST UNIV-COLL OF LIBERAL ARTS & SCIENCES",NA,NA,193,86,107,64,21,43,0.5,0.332,0.196,13800,168
"6018",176947,2005,1,0,"Central Methodist University-College of Liberal Arts & Sciences",NA,NA,223,96,127,73,29,44,0.458,0.327,0.228,14490,198
"6019",176947,2006,1,0,"Central Methodist University-College of Liberal Arts & Sciences",NA,NA,207,111,96,81,28,53,0.478,0.391,0.292,15500,190
"6020",176947,2007,1,0,"Central Methodist University-College of Liberal Arts & Sciences",NA,NA,270,123,147,69,31,38,0.309,0.256,0.211,16430,228
"6021",176947,2008,1,0,"Central Methodist University-College of Liberal Arts & Sciences",NA,NA,300,141,159,110,47,63,0.447,0.367,0.296,17250,254
"6022",176947,2009,1,0,"Central Methodist University-College of Liberal Arts & Sciences",NA,NA,260,129,131,106,42,64,0.496,0.408,0.321,17940,221
"6023",176947,2010,1,0,"Central Methodist University-College of Liberal Arts & Sciences",NA,NA,314,147,167,109,33,76,0.517,0.347,0.198,18660,266
"6024",176965,1991,1,0,"CENTRAL MISSOURI STATE UNIVERSITY",NA,NA,1952,1038,914,273,107,166,0.16,0.14,0.117,1860,1691
"6025",176965,1992,1,0,"CENTRAL MISSOURI STATE UNIVERSITY",NA,NA,1763,921,842,240,105,135,0.147,0.136,0.125,2040,1564
"6026",176965,1993,1,0,"CENTRAL MISSOURI STATE UNIVERSITY",NA,NA,1433,757,676,213,72,141,0.186,0.149,0.107,2160,1232
"6027",176965,1995,1,0,"CENTRAL MISSOURI STATE UNIVERSITY",NA,NA,1428,755,673,243,79,164,0.217,0.17,0.117,2460,1259
"6028",176965,1996,1,0,"CENTRAL MISSOURI STATE UNIVERSITY",NA,NA,1252,655,597,221,77,144,0.22,0.177,0.129,2520,1138
"6029",176965,1997,1,0,"CENTRAL MISSOURI STATE UNIVERSITY",NA,NA,1323,718,605,298,88,210,0.292,0.225,0.145,2640,1195
"6030",176965,1998,1,0,"CENTRAL MISSOURI STATE UNIVERSITY",NA,NA,1408,730,678,317,107,210,0.288,0.225,0.158,2730,1250
"6031",176965,1999,1,0,"CENTRAL MISSOURI STATE UNIVERSITY",NA,NA,1329,725,604,300,94,206,0.284,0.226,0.156,2970,1191
"6032",176965,2000,1,0,"CENTRAL MISSOURI STATE UNIVERSITY",NA,NA,1455,794,661,380,146,234,0.295,0.261,0.221,3210,1274
"6033",176965,2001,1,0,"CENTRAL MISSOURI STATE UNIVERSITY",NA,NA,1437,789,648,275,33,242,0.307,0.191,0.051,3450,1191
"6034",176965,2002,1,0,"CENTRAL MISSOURI STATE UNIVERSITY",NA,NA,1248,668,580,306,106,200,0.299,0.245,0.183,3240,1041
"6035",176965,2003,1,0,"CENTRAL MISSOURI STATE UNIVERSITY",NA,NA,1355,737,618,323,115,208,0.282,0.238,0.186,3696,1098
"6036",176965,2004,1,0,"CENTRAL MISSOURI STATE UNIVERSITY",NA,NA,1434,798,636,369,120,249,0.312,0.257,0.189,3936,1232
"6037",176965,2005,1,0,"Central Missouri State University",NA,NA,1484,810,674,410,164,246,0.304,0.276,0.243,4104,1245
"6038",176965,2006,1,0,"University of Central Missouri",NA,NA,1505,871,634,416,134,282,0.324,0.276,0.211,5415,1188
"6039",176965,2007,1,0,"University of Central Missouri",NA,NA,1426,786,640,428,148,280,0.356,0.3,0.231,4500,1166
"6040",176965,2008,1,0,"University of Central Missouri",NA,NA,1583,854,729,463,185,278,0.325,0.292,0.254,4687,1290
"6041",176965,2009,1,0,"University of Central Missouri",NA,NA,1478,822,656,452,148,304,0.37,0.306,0.226,5859,1197
"6042",176965,2010,1,0,"University of Central Missouri",NA,NA,1546,862,684,496,176,320,0.371,0.321,0.257,5859,1179
"6043",177418,1991,1,0,"FONTBONNE COLLEGE",NA,NA,114,87,27,38,9,29,0.333,0.333,0.333,7390,93
"6044",177418,1992,1,0,"FONTBONNE COLLEGE",NA,NA,144,110,34,56,5,51,0.464,0.389,0.147,7750,118
"6045",177418,1993,1,0,"FONTBONNE COLLEGE",NA,NA,126,95,31,50,7,43,0.453,0.397,0.226,8140,102
"6046",177418,1995,1,0,"FONTBONNE COLLEGE",NA,NA,143,110,33,51,11,40,0.364,0.357,0.333,8890,120
"6047",177418,1996,1,0,"FONTBONNE COLLEGE",NA,NA,146,104,42,66,13,53,0.51,0.452,0.31,9660,131
"6048",177418,1997,1,0,"FONTBONNE COLLEGE",NA,NA,171,124,47,50,10,40,0.323,0.292,0.213,10000,143
"6049",177418,1998,1,0,"FONTBONNE COLLEGE",NA,NA,156,111,45,59,11,48,0.432,0.378,0.244,10810,129
"6050",177418,1999,1,0,"FONTBONNE COLLEGE",NA,NA,144,94,50,60,14,46,0.489,0.417,0.28,11184,115
"6051",177418,2000,1,0,"FONTBONNE COLLEGE",NA,NA,164,124,40,57,4,53,0.427,0.348,0.1,11686,129
"6052",177418,2001,1,0,"FONTBONNE UNIVERSITY",NA,NA,153,111,42,50,12,38,0.342,0.327,0.286,12596,129
"6053",177418,2002,1,0,"FONTBONNE UNIVERSITY",NA,NA,183,134,49,76,16,60,0.448,0.415,0.327,13414,157
"6054",177418,2003,1,0,"FONTBONNE UNIVERSITY",NA,NA,194,143,51,61,14,47,0.329,0.314,0.275,14200,152
"6055",177418,2004,1,0,"FONTBONNE UNIVERSITY",NA,NA,190,132,58,52,16,36,0.273,0.274,0.276,15100,141
"6056",177418,2005,1,0,"Fontbonne University",NA,NA,187,136,51,44,9,35,0.257,0.235,0.176,16000,141
"6057",177418,2006,1,0,"Fontbonne University",NA,NA,187,98,89,30,11,19,0.194,0.16,0.124,17120,140
"6058",177418,2007,1,0,"Fontbonne University",NA,NA,193,110,83,5,1,4,0.036,0.026,0.012,18000,143
"6059",177418,2008,1,0,"Fontbonne University",NA,NA,187,112,75,44,12,32,0.286,0.235,0.16,19000,130
"6060",177418,2009,1,0,"Fontbonne University",NA,NA,173,104,69,65,19,46,0.442,0.376,0.275,19475,127
"6061",177418,2010,1,0,"Fontbonne University",NA,NA,151,77,74,53,21,32,0.416,0.351,0.284,20060,119
"6062",178059,1991,1,0,"MARYVILLE UNIVERSITY OF SAINT LOUIS",NA,NA,102,61,41,63,22,41,0.672,0.618,0.537,7800,94
"6063",178059,1992,1,0,"MARYVILLE UNIVERSITY OF SAINT LOUIS",NA,NA,129,93,36,70,19,51,0.548,0.543,0.528,8200,121
"6064",178059,1993,1,0,"MARYVILLE UNIVERSITY OF SAINT LOUIS",NA,NA,165,109,56,73,20,53,0.486,0.442,0.357,8700,149
"6065",178059,1995,1,0,"MARYVILLE UNIVERSITY OF SAINT LOUIS",NA,NA,167,123,44,77,16,61,0.496,0.461,0.364,9800,144
"6066",178059,1996,1,0,"MARYVILLE UNIVERSITY OF SAINT LOUIS",NA,NA,185,127,58,100,28,72,0.567,0.541,0.483,10280,169
"6067",178059,1997,1,0,"MARYVILLE UNIVERSITY OF SAINT LOUIS",NA,NA,223,173,50,114,26,88,0.509,0.511,0.52,10850,199
"6068",178059,1998,1,0,"MARYVILLE UNIVERSITY OF SAINT LOUIS",NA,NA,225,158,67,100,26,74,0.468,0.444,0.388,11600,214
"6069",178059,1999,1,0,"MARYVILLE UNIVERSITY OF SAINT LOUIS",NA,NA,198,133,65,101,26,75,0.564,0.51,0.4,12160,164
"6070",178059,2000,1,0,"MARYVILLE UNIVERSITY OF SAINT LOUIS",NA,NA,231,186,45,122,18,104,0.559,0.528,0.4,12880,206
"6071",178059,2001,1,0,"MARYVILLE UNIVERSITY OF SAINT LOUIS",NA,NA,247,183,64,141,31,110,0.601,0.571,0.484,13650,206
"6072",178059,2002,1,0,"MARYVILLE UNIVERSITY OF SAINT LOUIS",NA,NA,279,194,85,132,46,86,0.443,0.473,0.541,14400,233
"6073",178059,2003,1,0,"MARYVILLE UNIVERSITY OF SAINT LOUIS",NA,NA,318,236,82,163,39,124,0.525,0.513,0.476,15200,286
"6074",178059,2004,1,0,"MARYVILLE UNIVERSITY OF SAINT LOUIS",NA,NA,313,248,65,160,29,131,0.528,0.511,0.446,16000,266
"6075",178059,2005,1,0,"Maryville University of Saint Louis",NA,NA,322,232,90,182,42,140,0.603,0.565,0.467,17000,296
"6076",178059,2006,1,0,"Maryville University of Saint Louis",NA,NA,290,237,53,152,26,126,0.532,0.524,0.491,17800,261
"6077",178059,2007,1,0,"Maryville University of Saint Louis",NA,NA,294,211,83,149,43,106,0.502,0.507,0.518,18600,257
"6078",178059,2008,1,0,"Maryville University of Saint Louis",NA,NA,318,236,82,149,39,110,0.466,0.469,0.476,19650,283
"6079",178059,2009,1,0,"Maryville University of Saint Louis",NA,NA,340,233,107,190,57,133,0.571,0.559,0.533,20384,278
"6080",178059,2010,1,0,"Maryville University of Saint Louis",NA,NA,338,242,96,192,49,143,0.591,0.568,0.51,21100,271
"6081",178341,1991,1,0,"MISSOURI SOUTHERN STATE COLLEGE",NA,NA,758,397,361,71,24,47,0.118,0.094,0.066,1272,729
"6082",178341,1992,1,0,"MISSOURI SOUTHERN STATE COLLEGE",NA,NA,702,381,321,63,24,39,0.102,0.09,0.075,1598,655
"6083",178341,1993,1,0,"MISSOURI SOUTHERN STATE COLLEGE",NA,NA,701,362,339,51,16,35,0.097,0.073,0.047,2018,665
"6084",178341,1995,1,0,"MISSOURI SOUTHERN STATE COLLEGE",NA,NA,720,359,361,77,37,40,0.111,0.107,0.102,2205,672
"6085",178341,1996,1,0,"MISSOURI SOUTHERN STATE COLLEGE",NA,NA,685,373,312,77,25,52,0.139,0.112,0.08,2310,644
"6086",178341,1997,1,0,"MISSOURI SOUTHERN STATE COLLEGE",NA,NA,675,368,307,61,19,42,0.114,0.09,0.062,2376,632
"6087",178341,1998,1,0,"MISSOURI SOUTHERN STATE COLLEGE",NA,NA,857,469,388,95,30,65,0.139,0.111,0.077,2471,794
"6088",178341,1999,1,0,"MISSOURI SOUTHERN STATE COLLEGE",NA,NA,804,434,370,104,40,64,0.148,0.129,0.108,2265,738
"6089",178341,2000,1,0,"MISSOURI SOUTHERN STATE COLLEGE",NA,NA,771,427,344,129,50,79,0.185,0.167,0.145,2370,713
"6090",178341,2001,1,0,"MISSOURI SOUTHERN STATE COLLEGE",NA,NA,786,411,375,117,47,70,0.17,0.149,0.125,2700,686
"6091",178341,2002,1,0,"MISSOURI SOUTHERN STATE COLLEGE",NA,NA,614,334,280,78,27,51,0.153,0.127,0.096,3720,544
"6092",178341,2003,1,0,"MISSOURI SOUTHERN STATE UNIVERSITY",NA,NA,568,319,249,76,25,51,0.16,0.134,0.1,3810,511
"6093",178341,2004,1,0,"MISSOURI SOUTHERN STATE UNIVERSITY",NA,NA,695,368,327,97,33,64,0.174,0.14,0.101,3810,626
"6094",178341,2005,1,0,"Missouri Southern State University",NA,NA,836,466,370,106,32,74,0.159,0.127,0.086,3750,709
"6095",178341,2006,1,0,"Missouri Southern State University",NA,NA,851,484,367,106,40,66,0.136,0.125,0.109,3900,715
"6096",178341,2007,1,0,"Missouri Southern State University",NA,NA,766,416,350,110,29,81,0.195,0.144,0.083,4050,656
"6097",178341,2008,1,0,"Missouri Southern State University",NA,NA,727,398,329,106,34,72,0.181,0.146,0.103,4290,621
"6098",178341,2009,1,0,"Missouri Southern State University",NA,NA,811,395,416,119,53,66,0.167,0.147,0.127,4290,669
"6099",178341,2010,1,0,"Missouri Southern State University",NA,NA,844,439,405,88,35,53,0.121,0.104,0.086,4290,687
"6100",178387,1991,1,0,"MISSOURI WESTERN STATE COLLEGE",NA,NA,806,435,371,71,27,44,0.101,0.088,0.073,1648,699
"6101",178387,1992,1,0,"MISSOURI WESTERN STATE COLLEGE",NA,NA,794,445,349,85,22,63,0.142,0.107,0.063,1822,696
"6102",178387,1993,1,0,"MISSOURI WESTERN STATE COLLEGE",NA,NA,928,514,414,86,30,56,0.109,0.093,0.072,1930,784
"6103",178387,1995,1,0,"MISSOURI WESTERN STATE COLLEGE",NA,NA,923,530,393,92,24,68,0.128,0.1,0.061,2258,801
"6104",178387,1996,1,0,"MISSOURI WESTERN STATE COLLEGE",NA,NA,963,564,399,113,28,85,0.151,0.117,0.07,2414,836
"6105",178387,1997,1,0,"MISSOURI WESTERN STATE COLLEGE",NA,NA,985,572,413,135,42,93,0.163,0.137,0.102,2534,846
"6106",178387,1998,1,0,"MISSOURI WESTERN STATE COLLEGE",NA,NA,983,577,406,127,27,100,0.173,0.129,0.067,2660,827
"6107",178387,1999,1,0,"MISSOURI WESTERN STATE COLLEGE",NA,NA,980,575,405,113,35,78,0.136,0.115,0.086,2622,832
"6108",178387,2000,1,0,"MISSOURI WESTERN STATE COLLEGE",NA,NA,908,532,376,91,20,71,0.134,0.1,0.053,2754,740
"6109",178387,2001,1,0,"MISSOURI WESTERN STATE COLLEGE",NA,NA,1079,666,413,140,44,96,0.144,0.13,0.107,2928,903
"6110",178387,2002,1,0,"MISSOURI WESTERN STATE COLLEGE",NA,NA,1131,655,476,134,52,82,0.125,0.118,0.109,3768,907
"6111",178387,2003,1,0,"MISSOURI WESTERN STATE COLLEGE",NA,NA,994,572,422,111,27,84,0.147,0.112,0.064,4098,783
"6112",178387,2004,1,0,"MISSOURI WESTERN STATE COLLEGE",NA,NA,1021,573,448,109,26,83,0.145,0.107,0.058,4380,801
"6113",178387,2005,1,0,"Missouri Western State University",NA,NA,1005,557,448,111,42,69,0.124,0.11,0.094,4380,758
"6114",178387,2006,1,0,"Missouri Western State University",NA,NA,936,516,420,102,39,63,0.122,0.109,0.093,4650,723
"6115",178387,2007,1,0,"Missouri Western State University",NA,NA,935,538,397,126,36,90,0.167,0.135,0.091,4800,699
"6116",178387,2008,1,0,"Missouri Western State University",NA,NA,956,536,420,146,44,102,0.19,0.153,0.105,3994,766
"6117",178387,2009,1,0,"Missouri Western State University",NA,NA,1004,572,432,127,35,92,0.161,0.126,0.081,3994,793
"6118",178387,2010,1,0,"Missouri Western State University",NA,NA,1083,559,524,145,55,90,0.161,0.134,0.105,3994,841
"6119",178396,1991,1,0,"UNIVERSITY OF MISSOURI-COLUMBIA",NA,NA,3368,1820,1548,959,356,603,0.331,0.285,0.23,2432,2906
"6120",178396,1992,1,0,"UNIVERSITY OF MISSOURI-COLUMBIA",NA,NA,2904,1600,1304,828,305,523,0.327,0.285,0.234,2812,2493
"6121",178396,1993,1,0,"UNIVERSITY OF MISSOURI-COLUMBIA",NA,NA,2898,1511,1387,828,320,508,0.336,0.286,0.231,3125,2499
"6122",178396,1995,1,0,"UNIVERSITY OF MISSOURI-COLUMBIA",NA,NA,3782,2099,1683,1210,420,790,0.376,0.32,0.25,3771,3232
"6123",178396,1996,1,0,"UNIVERSITY OF MISSOURI-COLUMBIA",NA,NA,3687,2046,1641,1282,462,820,0.401,0.348,0.282,4121,3153
"6124",178396,1997,1,0,"UNIVERSITY OF MISSOURI-COLUMBIA",NA,NA,3512,1935,1577,1290,461,829,0.428,0.367,0.292,4280,2952
"6125",178396,1998,1,0,"UNIVERSITY OF MISSOURI-COLUMBIA",NA,NA,3785,2077,1708,1425,500,925,0.445,0.376,0.293,4439,3251
"6126",178396,1999,1,0,"UNIVERSITY OF MISSOURI-COLUMBIA",NA,NA,3871,2138,1733,1468,525,943,0.441,0.379,0.303,3978,3350
"6127",178396,2000,1,0,"UNIVERSITY OF MISSOURI-COLUMBIA",NA,NA,4170,2247,1923,1657,609,1048,0.466,0.397,0.317,4104,3598
"6128",178396,2001,1,0,"UNIVERSITY OF MISSOURI-COLUMBIA",NA,NA,4112,2175,1937,1686,643,1043,0.48,0.41,0.332,4245,3577
"6129",178396,2002,1,0,"UNIVERSITY OF MISSOURI-COLUMBIA",NA,NA,4379,2284,2095,1813,669,1144,0.501,0.414,0.319,4602,3763
"6130",178396,2003,1,0,"UNIVERSITY OF MISSOURI-COLUMBIA",NA,NA,4605,2443,2162,1985,737,1248,0.511,0.431,0.341,5838,3951
"6131",178396,2004,1,0,"UNIVERSITY OF MISSOURI-COLUMBIA",NA,NA,4625,2442,2183,1993,765,1228,0.503,0.431,0.35,6276,3957
"6132",178396,2005,1,0,"University of Missouri-Columbia",NA,NA,4662,2513,2149,2087,810,1277,0.508,0.448,0.377,6062,3954
"6133",178396,2006,1,0,"University of Missouri-Columbia",NA,NA,4783,2562,2221,2234,835,1399,0.546,0.467,0.376,6364,3953
"6134",178396,2007,1,0,"University of Missouri-Columbia",NA,NA,4897,2672,2225,2305,829,1476,0.552,0.471,0.373,7077,4143
"6135",178396,2008,1,0,"University of Missouri-Columbia",NA,NA,5698,3031,2667,2622,1004,1618,0.534,0.46,0.376,7368,4740
"6136",178396,2009,1,0,"University of Missouri-Columbia",NA,NA,5492,2958,2534,2527,907,1620,0.548,0.46,0.358,7368,4491
"6137",178396,2010,1,0,"University of Missouri-Columbia",NA,NA,5996,3175,2821,2641,963,1678,0.528,0.44,0.341,7368,4904
"6138",178402,1991,1,0,"UNIVERSITY OF MISSOURI-KANSAS CITY",NA,NA,494,270,224,55,26,29,0.107,0.111,0.116,2457,345
"6139",178402,1992,1,0,"UNIVERSITY OF MISSOURI-KANSAS CITY",NA,NA,480,257,223,42,13,29,0.113,0.088,0.058,2841,335
"6140",178402,1993,1,0,"UNIVERSITY OF MISSOURI-KANSAS CITY",NA,NA,515,266,249,53,18,35,0.132,0.103,0.072,3154,353
"6141",178402,1995,1,0,"UNIVERSITY OF MISSOURI-KANSAS CITY",NA,NA,568,318,250,70,25,45,0.142,0.123,0.1,3799,387
"6142",178402,1996,1,0,"UNIVERSITY OF MISSOURI-KANSAS CITY",NA,NA,567,299,268,86,33,53,0.177,0.152,0.123,4121,389
"6143",178402,1997,1,0,"UNIVERSITY OF MISSOURI-KANSAS CITY",NA,NA,588,321,267,79,27,52,0.162,0.134,0.101,4273,433
"6144",178402,1998,1,0,"UNIVERSITY OF MISSOURI-KANSAS CITY",NA,NA,618,336,282,114,39,75,0.223,0.184,0.138,4421,418
"6145",178402,1999,1,0,"UNIVERSITY OF MISSOURI-KANSAS CITY",NA,NA,639,356,283,105,46,59,0.166,0.164,0.163,3978,458
"6146",178402,2000,1,0,"UNIVERSITY OF MISSOURI-KANSAS CITY",NA,NA,688,391,297,120,44,76,0.194,0.174,0.148,4104,453
"6147",178402,2001,1,0,"UNIVERSITY OF MISSOURI-KANSAS CITY",NA,NA,734,444,290,106,36,70,0.158,0.144,0.124,4245,501
"6148",178402,2002,1,0,"UNIVERSITY OF MISSOURI-KANSAS CITY",NA,NA,747,454,293,128,41,87,0.192,0.171,0.14,4602,481
"6149",178402,2003,1,0,"UNIVERSITY OF MISSOURI-KANSAS CITY",NA,NA,758,455,303,124,38,86,0.189,0.164,0.125,5838,435
"6150",178402,2004,1,0,"UNIVERSITY OF MISSOURI-KANSAS CITY",NA,NA,904,540,364,160,50,110,0.204,0.177,0.137,6276,539
"6151",178402,2005,1,0,"University of Missouri-Kansas City",NA,NA,1007,574,433,173,61,112,0.195,0.172,0.141,6495,611
"6152",178402,2006,1,0,"University of Missouri-Kansas City",NA,NA,928,545,383,220,86,134,0.246,0.237,0.225,6819,539
"6153",178402,2007,1,0,"University of Missouri-Kansas City",NA,NA,916,568,348,188,59,129,0.227,0.205,0.17,7077,505
"6154",178402,2008,1,0,"University of Missouri-Kansas City",NA,NA,971,589,382,218,68,150,0.255,0.225,0.178,7368,570
"6155",178402,2009,1,0,"University of Missouri-Kansas City",NA,NA,979,610,369,224,62,162,0.266,0.229,0.168,7368,559
"6156",178402,2010,1,0,"University of Missouri-Kansas City",NA,NA,1109,673,436,246,92,154,0.229,0.222,0.211,7368,640
"6157",178411,1991,1,0,"UNIVERSITY OF MISSOURI-ROLLA",NA,NA,711,135,576,58,43,15,0.111,0.082,0.075,2543,630
"6158",178411,1992,1,0,"UNIVERSITY OF MISSOURI-ROLLA",NA,NA,809,174,635,64,40,24,0.138,0.079,0.063,2932,704
"6159",178411,1993,1,0,"UNIVERSITY OF MISSOURI-ROLLA",NA,NA,786,190,596,78,58,20,0.105,0.099,0.097,3254,707
"6160",178411,1995,1,0,"UNIVERSITY OF MISSOURI-ROLLA",NA,NA,804,190,614,121,75,46,0.242,0.15,0.122,3899,704
"6161",178411,1996,1,0,"UNIVERSITY OF MISSOURI-ROLLA",NA,NA,777,179,598,121,77,44,0.246,0.156,0.129,4213,684
"6162",178411,1997,1,0,"UNIVERSITY OF MISSOURI-ROLLA",NA,NA,692,168,524,99,76,23,0.137,0.143,0.145,4373,631
"6163",178411,1998,1,0,"UNIVERSITY OF MISSOURI-ROLLA",NA,NA,717,151,566,106,81,25,0.166,0.148,0.143,4522,641
"6164",178411,1999,1,0,"UNIVERSITY OF MISSOURI-ROLLA",NA,NA,679,140,539,112,77,35,0.25,0.165,0.143,3978,588
"6165",178411,2000,1,0,"UNIVERSITY OF MISSOURI-ROLLA",NA,NA,672,146,526,143,98,45,0.308,0.213,0.186,4104,583
"6166",178411,2001,1,0,"UNIVERSITY OF MISSOURI-ROLLA",NA,NA,691,126,565,144,109,35,0.278,0.208,0.193,4245,586
"6167",178411,2002,1,0,"UNIVERSITY OF MISSOURI-ROLLA",NA,NA,785,150,635,175,128,47,0.313,0.223,0.202,4602,690
"6168",178411,2003,1,0,"UNIVERSITY OF MISSOURI-ROLLA",NA,NA,870,181,689,217,154,63,0.348,0.249,0.224,5838,752
"6169",178411,2004,1,0,"UNIVERSITY OF MISSOURI-ROLLA",NA,NA,836,169,667,211,162,49,0.29,0.252,0.243,6276,721
"6170",178411,2005,1,0,"University of Missouri-Rolla",NA,NA,877,168,709,224,154,70,0.417,0.255,0.217,6495,772
"6171",178411,2006,1,0,"University of Missouri-Rolla",NA,NA,929,216,713,258,176,82,0.38,0.278,0.247,6819,802
"6172",178411,2007,1,0,"Missouri University of Science and Technology",NA,NA,1018,208,810,257,180,77,0.37,0.252,0.222,7077,885
"6173",178411,2008,1,0,"Missouri University of Science and Technology",NA,NA,1036,234,802,253,181,72,0.308,0.244,0.226,7368,872
"6174",178411,2009,1,0,"Missouri University of Science and Technology",NA,NA,1099,260,839,263,180,83,0.319,0.239,0.215,7368,904
"6175",178411,2010,1,0,"Missouri University of Science and Technology",NA,NA,1138,250,888,246,166,80,0.32,0.216,0.187,7368,970
"6176",178420,1991,1,0,"UNIVERSITY OF MISSOURI-SAINT LOUIS",NA,NA,637,341,296,72,28,44,0.129,0.113,0.095,2379,513
"6177",178420,1992,1,0,"UNIVERSITY OF MISSOURI-SAINT LOUIS",NA,NA,474,224,250,49,18,31,0.138,0.103,0.072,2740,388
"6178",178420,1993,1,0,"UNIVERSITY OF MISSOURI-ST LOUIS",NA,NA,458,231,227,52,17,35,0.152,0.114,0.075,3073,361
"6179",178420,1995,1,0,"UNIVERSITY OF MISSOURI-ST LOUIS",NA,NA,552,315,237,85,31,54,0.171,0.154,0.131,3761,436
"6180",178420,1996,1,0,"UNIVERSITY OF MISSOURI-ST LOUIS",NA,NA,632,351,281,78,20,58,0.165,0.123,0.071,4145,484
"6181",178420,1997,1,0,"UNIVERSITY OF MISSOURI-ST LOUIS",NA,NA,458,242,216,60,12,48,0.198,0.131,0.056,4323,378
"6182",178420,1998,1,0,"UNIVERSITY OF MISSOURI-ST LOUIS",NA,NA,528,274,254,114,46,68,0.248,0.216,0.181,4636,443
"6183",178420,1999,1,0,"UNIVERSITY OF MISSOURI-ST LOUIS",NA,NA,539,274,265,122,43,79,0.288,0.226,0.162,3978,415
"6184",178420,2000,1,0,"UNIVERSITY OF MISSOURI-ST LOUIS",NA,NA,497,279,218,100,35,65,0.233,0.201,0.161,4104,388
"6185",178420,2001,1,0,"UNIVERSITY OF MISSOURI-ST LOUIS",NA,NA,515,313,202,96,25,71,0.227,0.186,0.124,4245,376
"6186",178420,2002,1,0,"UNIVERSITY OF MISSOURI-ST LOUIS",NA,NA,426,234,192,96,29,67,0.286,0.225,0.151,4602,324
"6187",178420,2003,1,0,"UNIVERSITY OF MISSOURI-ST LOUIS",NA,NA,464,280,184,97,26,71,0.254,0.209,0.141,5838,356
"6188",178420,2004,1,0,"UNIVERSITY OF MISSOURI-ST LOUIS",NA,NA,398,235,163,82,25,57,0.243,0.206,0.153,6276,283
"6189",178420,2005,1,0,"University of Missouri-St Louis",NA,NA,497,288,209,124,41,83,0.288,0.249,0.196,5196,337
"6190",178420,2006,1,0,"University of Missouri-St Louis",NA,NA,476,273,203,106,33,73,0.267,0.223,0.163,6819,297
"6191",178420,2007,1,0,"University of Missouri-St Louis",NA,NA,462,280,182,94,25,69,0.246,0.203,0.137,7077,270
"6192",178420,2008,1,0,"University of Missouri-St Louis",NA,NA,437,244,193,92,34,58,0.238,0.211,0.176,7368,279
"6193",178420,2009,1,0,"University of Missouri-St Louis",NA,NA,494,295,199,109,34,75,0.254,0.221,0.171,7368,266
"6194",178420,2010,1,0,"University of Missouri-St Louis",NA,NA,479,282,197,141,51,90,0.319,0.294,0.259,7368,298
"6195",178615,1991,1,0,"NORTHEAST MISSOURI STATE UNIVERSITY",NA,NA,1375,784,591,459,153,306,0.39,0.334,0.259,1800,1262
"6196",178615,1992,1,0,"NORTHEAST MISSOURI STATE UNIVERSITY",NA,NA,1384,786,598,539,167,372,0.473,0.389,0.279,2235,1238
"6197",178615,1993,1,0,"NORTHEAST MISSOURI STATE UNIVERSITY",NA,NA,1614,962,652,597,178,419,0.436,0.37,0.273,2456,1451
"6198",178615,1995,1,0,"TRUMAN STATE UNIVERSITY",NA,NA,1498,883,615,577,183,394,0.446,0.385,0.298,2872,1021
"6199",178615,1996,1,0,"TRUMAN STATE UNIVERSITY",NA,NA,1480,868,612,592,185,407,0.469,0.4,0.302,3008,1124
"6200",178615,1997,1,0,"TRUMAN STATE UNIVERSITY",NA,NA,1654,1020,634,593,175,418,0.41,0.359,0.276,3256,1461
"6201",178615,1998,1,0,"TRUMAN STATE UNIVERSITY",NA,NA,1482,914,568,562,181,381,0.417,0.379,0.319,3408,1304
"6202",178615,1999,1,0,"TRUMAN STATE UNIVERSITY",NA,NA,1446,884,562,594,201,393,0.445,0.411,0.358,3544,1245
"6203",178615,2000,1,0,"TRUMAN STATE UNIVERSITY",NA,NA,1396,840,556,537,181,356,0.424,0.385,0.326,3680,1222
"6204",178615,2001,1,0,"TRUMAN STATE UNIVERSITY",NA,NA,1456,865,591,666,232,434,0.502,0.457,0.393,3800,1249
"6205",178615,2002,1,0,"TRUMAN STATE UNIVERSITY",NA,NA,1441,872,569,654,227,427,0.49,0.454,0.399,4144,1242
"6206",178615,2003,1,0,"TRUMAN STATE UNIVERSITY",NA,NA,1310,787,523,612,198,414,0.526,0.467,0.379,4700,1113
"6207",178615,2004,1,0,"TRUMAN STATE UNIVERSITY",NA,NA,1477,872,605,631,228,403,0.462,0.427,0.377,5410,1310
"6208",178615,2005,1,0,"Truman State University",NA,NA,1441,830,611,626,232,394,0.475,0.434,0.38,5740,1232
"6209",178615,2006,1,0,"Truman State University",NA,NA,1365,826,539,781,258,523,0.633,0.572,0.479,5970,1111
"6210",178615,2007,1,0,"Truman State University",NA,NA,1402,814,588,754,248,506,0.622,0.538,0.422,6210,1146
"6211",178615,2008,1,0,"Truman State University",NA,NA,1334,779,555,757,251,506,0.65,0.567,0.452,6458,1074
"6212",178615,2009,1,0,"Truman State University",NA,NA,1337,776,561,739,263,476,0.613,0.553,0.469,6458,1006
"6213",178615,2010,1,0,"Truman State University",NA,NA,1416,881,535,800,260,540,0.613,0.565,0.486,6458,1184
"6214",179043,1991,1,0,"ROCKHURST COLLEGE",NA,NA,228,142,86,121,44,77,0.542,0.531,0.512,8200,167
"6215",179043,1992,1,0,"ROCKHURST COLLEGE",NA,NA,198,121,77,92,30,62,0.512,0.465,0.39,8830,156
"6216",179043,1993,1,0,"ROCKHURST COLLEGE",NA,NA,345,194,151,169,74,95,0.49,0.49,0.49,9090,295
"6217",179043,1995,1,0,"ROCKHURST COLLEGE",NA,NA,288,161,127,174,74,100,0.621,0.604,0.583,10440,255
"6218",179043,1996,1,0,"ROCKHURST COLLEGE",NA,NA,362,196,166,9,3,6,0.031,0.025,0.018,11270,302
"6219",179043,1997,1,0,"ROCKHURST COLLEGE",NA,NA,319,175,144,181,78,103,0.589,0.567,0.542,11850,268
"6220",179043,1998,1,0,"ROCKHURST COLLEGE",NA,NA,280,153,127,141,50,91,0.595,0.504,0.394,12240,241
"6221",179043,1999,1,0,"ROCKHURST UNIVERSITY",NA,NA,303,177,126,152,61,91,0.514,0.502,0.484,12500,250
"6222",179043,2000,1,0,"ROCKHURST UNIVERSITY",NA,NA,267,141,126,135,61,74,0.525,0.506,0.484,13500,216
"6223",179043,2001,1,0,"ROCKHURST UNIVERSITY",NA,NA,298,150,148,165,76,89,0.593,0.554,0.514,14800,246
"6224",179043,2002,1,0,"ROCKHURST UNIVERSITY",NA,NA,214,133,81,119,44,75,0.564,0.556,0.543,15980,179
"6225",179043,2003,1,0,"ROCKHURST UNIVERSITY",NA,NA,244,130,114,141,60,81,0.623,0.578,0.526,16950,209
"6226",179043,2004,1,0,"ROCKHURST UNIVERSITY",NA,NA,305,176,129,184,76,108,0.614,0.603,0.589,17950,267
"6227",179043,2005,1,0,"Rockhurst University",NA,NA,370,203,167,237,110,127,0.626,0.641,0.659,18900,312
"6228",179043,2006,1,0,"Rockhurst University",NA,NA,396,260,136,237,73,164,0.631,0.598,0.537,20200,345
"6229",179043,2007,1,0,"Rockhurst University",NA,NA,367,230,137,222,81,141,0.613,0.605,0.591,22000,298
"6230",179043,2008,1,0,"Rockhurst University",NA,NA,358,237,121,223,69,154,0.65,0.623,0.57,23760,270
"6231",179043,2009,1,0,"Rockhurst University",NA,NA,417,263,154,251,84,167,0.635,0.602,0.545,24950,331
"6232",179043,2010,1,0,"Rockhurst University",NA,NA,370,232,138,228,79,149,0.642,0.616,0.572,26450,291
"6233",179159,1991,1,0,"SAINT LOUIS UNIVERSITY MAIN CAMPUS",NA,NA,914,479,435,355,121,234,0.489,0.388,0.278,9160,720
"6234",179159,1992,1,0,"SAINT LOUIS UNIVERSITY MAIN CAMPUS",NA,NA,1051,546,505,473,187,286,0.524,0.45,0.37,9880,823
"6235",179159,1993,1,0,"SAINT LOUIS UNIVERSITY-MAIN CAMPUS",NA,NA,1066,578,488,500,188,312,0.54,0.469,0.385,10820,850
"6236",179159,1995,1,0,"SAINT LOUIS UNIVERSITY-MAIN CAMPUS",NA,NA,1055,604,451,501,195,306,0.507,0.475,0.432,12800,817
"6237",179159,1996,1,0,"SAINT LOUIS UNIVERSITY-MAIN CAMPUS",NA,NA,1047,609,438,577,202,375,0.616,0.551,0.461,13900,803
"6238",179159,1997,1,0,"SAINT LOUIS UNIVERSITY-MAIN CAMPUS",NA,NA,1084,609,475,601,246,355,0.583,0.554,0.518,14940,802
"6239",179159,1998,1,0,"SAINT LOUIS UNIVERSITY-MAIN CAMPUS",NA,NA,1239,694,545,684,251,433,0.624,0.552,0.461,16100,962
"6240",179159,1999,1,0,"SAINT LOUIS UNIVERSITY-MAIN CAMPUS",NA,NA,1252,695,557,764,314,450,0.647,0.61,0.564,17230,974
"6241",179159,2000,1,0,"SAINT LOUIS UNIVERSITY-MAIN CAMPUS",NA,NA,1405,748,657,886,397,489,0.654,0.631,0.604,18400,1163
"6242",179159,2001,1,0,"SAINT LOUIS UNIVERSITY-MAIN CAMPUS",NA,NA,1329,695,634,827,374,453,0.652,0.622,0.59,19670,1047
"6243",179159,2002,1,0,"SAINT LOUIS UNIVERSITY-MAIN CAMPUS",NA,NA,1409,762,647,867,366,501,0.657,0.615,0.566,20840,1131
"6244",179159,2003,1,0,"SAINT LOUIS UNIVERSITY-MAIN CAMPUS",NA,NA,1377,752,625,832,338,494,0.657,0.604,0.541,22050,1124
"6245",179159,2004,1,0,"SAINT LOUIS UNIVERSITY-MAIN CAMPUS",NA,NA,1456,864,592,892,336,556,0.643,0.613,0.568,23360,1132
"6246",179159,2005,1,0,"Saint Louis University-Main Campus",NA,NA,1521,859,662,925,377,548,0.638,0.608,0.569,24760,1180
"6247",179159,2006,1,0,"Saint Louis University-Main Campus",NA,NA,1567,940,627,946,358,588,0.625,0.604,0.571,26250,1218
"6248",179159,2007,1,0,"Saint Louis University-Main Campus",NA,NA,1629,933,696,988,380,608,0.652,0.607,0.546,28480,1234
"6249",179159,2008,1,0,"Saint Louis University-Main Campus",NA,NA,1624,923,701,945,365,580,0.628,0.582,0.521,30330,1138
"6250",179159,2009,1,0,"Saint Louis University-Main Campus",NA,NA,1714,966,748,1026,393,633,0.655,0.599,0.525,30940,1183
"6251",179159,2010,1,0,"Saint Louis University-Main Campus",NA,NA,1724,1004,720,1063,381,682,0.679,0.617,0.529,32180,1184
"6252",179557,1991,1,0,"SOUTHEAST MISSOURI STATE UNIVERSITY",NA,NA,1487,815,672,222,70,152,0.186,0.149,0.104,1716,1319
"6253",179557,1992,1,0,"SOUTHEAST MISSOURI STATE UNIVERSITY",NA,NA,1405,806,599,236,67,169,0.21,0.168,0.112,2113,1259
"6254",179557,1993,1,0,"SOUTHEAST MISSOURI STATE UNIVERSITY",NA,NA,1229,733,496,226,58,168,0.229,0.184,0.117,2434,1119
"6255",179557,1995,1,0,"SOUTHEAST MISSOURI STATE UNIVERSITY",NA,NA,1385,824,561,334,90,244,0.296,0.241,0.16,2760,1283
"6256",179557,1996,1,0,"SOUTHEAST MISSOURI STATE UNIVERSITY",NA,NA,1212,681,531,294,82,212,0.311,0.243,0.154,2874,1117
"6257",179557,1997,1,0,"SOUTHEAST MISSOURI STATE UNIVERSITY",NA,NA,1124,713,411,248,65,183,0.257,0.221,0.158,3000,1041
"6258",179557,1998,1,0,"SOUTHEAST MISSOURI STATE UNIVERSITY",NA,NA,1239,757,482,300,75,225,0.297,0.242,0.156,3105,1132
"6259",179557,1999,1,0,"SOUTHEAST MISSOURI STATE UNIVERSITY",NA,NA,1391,816,575,320,87,233,0.286,0.23,0.151,2979,1273
"6260",179557,2000,1,0,"SOUTHEAST MISSOURI STATE UNIVERSITY",NA,NA,1433,817,616,372,103,269,0.329,0.26,0.167,3099,1244
"6261",179557,2001,1,0,"SOUTHEAST MISSOURI STATE UNIVERSITY",NA,NA,1502,910,592,356,98,258,0.284,0.237,0.166,3234,1328
"6262",179557,2002,1,0,"SOUTHEAST MISSOURI STATE UNIVERSITY",NA,NA,1457,858,599,361,105,256,0.298,0.248,0.175,3744,1276
"6263",179557,2003,1,0,"SOUTHEAST MISSOURI STATE UNIVERSITY",NA,NA,1410,826,584,336,98,238,0.288,0.238,0.168,4254,1215
"6264",179557,2004,1,0,"SOUTHEAST MISSOURI STATE UNIVERSITY",NA,NA,1386,823,563,334,98,236,0.287,0.241,0.174,4554,1194
"6265",179557,2005,1,0,"Southeast Missouri State University",NA,NA,1538,918,620,369,102,267,0.291,0.24,0.165,4764,1267
"6266",179557,2006,1,0,"Southeast Missouri State University",NA,NA,1383,853,530,318,92,226,0.265,0.23,0.174,5034,1087
"6267",179557,2007,1,0,"Southeast Missouri State University",NA,NA,1650,946,704,438,158,280,0.296,0.265,0.224,5304,1263
"6268",179557,2008,1,0,"Southeast Missouri State University",NA,NA,1672,1054,618,492,141,351,0.333,0.294,0.228,5544,1423
"6269",179557,2009,1,0,"Southeast Missouri State University",NA,NA,1640,943,697,455,165,290,0.308,0.277,0.237,5544,1392
"6270",179557,2010,1,0,"Southeast Missouri State University",NA,NA,1813,1097,716,526,165,361,0.329,0.29,0.23,5544,1482
"6271",179566,1991,1,0,"SOUTHWEST MISSOURI STATE UNIVERSITY",NA,NA,2895,1571,1324,676,241,435,0.277,0.234,0.182,1594,2658
"6272",179566,1992,1,0,"SOUTHWEST MISSOURI STATE UNIVERSITY",NA,NA,2925,1621,1304,420,110,310,0.191,0.144,0.084,1752,2636
"6273",179566,1993,1,0,"SOUTHWEST MISSOURI STATE UNIVERSITY",NA,NA,2800,1493,1307,376,109,267,0.179,0.134,0.083,1904,2577
"6274",179566,1995,1,0,"SOUTHWEST MISSOURI STATE UNIVERSITY",NA,NA,2479,1394,1085,440,156,284,0.204,0.177,0.144,2758,2297
"6275",179566,1996,1,0,"SOUTHWEST MISSOURI STATE UNIVERSITY",NA,NA,2447,1404,1043,433,127,306,0.218,0.177,0.122,2888,2160
"6276",179566,1997,1,0,"SOUTHWEST MISSOURI STATE UNIVERSITY",NA,NA,2704,1543,1161,522,180,342,0.222,0.193,0.155,3060,2436
"6277",179566,1998,1,0,"SOUTHWEST MISSOURI STATE UNIVERSITY",NA,NA,2739,1545,1194,607,192,415,0.269,0.222,0.161,3214,2446
"6278",179566,1999,1,0,"SOUTHWEST MISSOURI STATE UNIVERSITY",NA,NA,2581,1439,1142,605,223,382,0.266,0.234,0.195,3030,2310
"6279",179566,2000,1,0,"SOUTHWEST MISSOURI STATE UNIVERSITY",NA,NA,2496,1477,1019,613,204,409,0.277,0.246,0.2,3180,2243
"6280",179566,2001,1,0,"SOUTHWEST MISSOURI STATE UNIVERSITY",NA,NA,2508,1417,1091,672,213,459,0.324,0.268,0.195,3330,2278
"6281",179566,2002,1,0,"SOUTHWEST MISSOURI STATE UNIVERSITY",NA,NA,2702,1609,1093,720,205,515,0.32,0.266,0.188,3840,2474
"6282",179566,2003,1,0,"SOUTHWEST MISSOURI STATE UNIVERSITY",NA,NA,2645,1495,1150,1044,382,662,0.443,0.395,0.332,4140,2297
"6283",179566,2004,1,0,"SOUTHWEST MISSOURI STATE UNIVERSITY",NA,NA,2663,1572,1091,755,234,521,0.331,0.284,0.214,4620,2357
"6284",179566,2005,1,0,"Missouri State University",NA,NA,2575,1490,1085,822,273,549,0.368,0.319,0.252,4920,2281
"6285",179566,2006,1,0,"Missouri State University",NA,NA,2732,1622,1110,854,306,548,0.338,0.313,0.276,5190,2420
"6286",179566,2007,1,0,"Missouri State University",NA,NA,2610,1514,1096,796,263,533,0.352,0.305,0.24,5370,2268
"6287",179566,2008,1,0,"Missouri State University",NA,NA,2532,1464,1068,785,258,527,0.36,0.31,0.242,5580,2236
"6288",179566,2009,1,0,"Missouri State University",NA,NA,2625,1542,1083,768,225,543,0.352,0.293,0.208,5580,2222
"6289",179566,2010,1,0,"Missouri State University-Springfield",NA,NA,2645,1574,1071,796,266,530,0.337,0.301,0.248,5580,2256
"6290",179867,1991,1,0,"WASHINGTON UNIVERSITY",NA,NA,1131,544,587,863,417,446,0.82,0.763,0.71,16110,834
"6291",179867,1992,1,0,"WASHINGTON UNIVERSITY",NA,NA,1070,513,557,831,421,410,0.799,0.777,0.756,16918,779
"6292",179867,1993,1,0,"WASHINGTON UNIVERSITY",NA,NA,1229,569,660,930,460,470,0.826,0.757,0.697,17776,937
"6293",179867,1995,1,0,"WASHINGTON UNIVERSITY",NA,NA,1180,608,572,911,411,500,0.822,0.772,0.719,19291,820
"6294",179867,1996,1,0,"WASHINGTON UNIVERSITY",NA,NA,1275,642,633,1006,463,543,0.846,0.789,0.731,20200,836
"6295",179867,1997,1,0,"WASHINGTON UNIVERSITY",NA,NA,1230,646,584,976,424,552,0.855,0.793,0.726,21210,778
"6296",179867,1998,1,0,"WASHINGTON UNIVERSITY",NA,NA,1465,770,695,1221,570,651,0.846,0.833,0.82,22422,1011
"6297",179867,1999,1,0,"WASHINGTON UNIVERSITY",NA,NA,1369,684,685,1125,548,577,0.844,0.822,0.8,23400,893
"6298",179867,2000,1,0,"WASHINGTON UNIVERSITY",NA,NA,1392,761,631,1158,498,660,0.867,0.832,0.789,24500,926
"6299",179867,2001,1,0,"WASHINGTON UNIVERSITY IN ST LOUIS",NA,NA,1262,637,625,1049,494,555,0.871,0.831,0.79,25700,832
"6300",179867,2002,1,0,"WASHINGTON UNIVERSITY IN ST LOUIS",NA,NA,1329,699,630,1127,513,614,0.878,0.848,0.814,26900,883
"6301",179867,2003,1,0,"WASHINGTON UNIVERSITY IN ST LOUIS",NA,NA,1349,699,650,1138,517,621,0.888,0.844,0.795,28300,880
"6302",179867,2004,1,0,"WASHINGTON UNIVERSITY IN ST LOUIS",NA,NA,1436,725,711,1233,592,641,0.884,0.859,0.833,29700,868
"6303",179867,2005,1,0,"Washington University in St Louis",NA,NA,1372,715,657,1186,544,642,0.898,0.864,0.828,31100,817
"6304",179867,2006,1,0,"Washington University in St Louis",NA,NA,1456,714,742,1284,628,656,0.919,0.882,0.846,32800,881
"6305",179867,2007,1,0,"Washington University in St Louis",NA,NA,1325,645,680,1169,593,576,0.893,0.882,0.872,34500,776
"6306",179867,2008,1,0,"Washington University in St Louis",NA,NA,1408,711,697,1270,605,665,0.935,0.902,0.868,36200,817
"6307",179867,2009,1,0,"Washington University in St Louis",NA,NA,1481,720,761,1280,622,658,0.914,0.864,0.817,37800,812
"6308",179867,2010,1,0,"Washington University in St Louis",NA,NA,1619,776,843,1430,716,714,0.92,0.883,0.849,39400,929
"6309",179894,1991,1,0,"WEBSTER UNIVERSITY",NA,NA,187,110,77,65,24,41,0.373,0.348,0.312,7300,149
"6310",179894,1992,1,0,"WEBSTER UNIVERSITY",NA,NA,201,114,87,68,22,46,0.404,0.338,0.253,8000,165
"6311",179894,1993,1,0,"WEBSTER UNIVERSITY",NA,NA,227,132,95,81,28,53,0.401,0.357,0.295,8560,201
"6312",179894,1995,1,0,"WEBSTER UNIVERSITY",NA,NA,227,105,122,90,52,38,0.362,0.396,0.426,9710,153
"6313",179894,1996,1,0,"WEBSTER UNIVERSITY",NA,NA,270,139,131,116,50,66,0.475,0.43,0.382,10292,211
"6314",179894,1997,1,0,"WEBSTER UNIVERSITY",NA,NA,314,193,121,124,41,83,0.43,0.395,0.339,10860,264
"6315",179894,1998,1,0,"WEBSTER UNIVERSITY",NA,NA,339,198,141,123,50,73,0.369,0.363,0.355,11460,274
"6316",179894,1999,1,0,"WEBSTER UNIVERSITY",NA,NA,369,214,155,156,52,104,0.486,0.423,0.335,12150,299
"6317",179894,2000,1,0,"WEBSTER UNIVERSITY",NA,NA,412,242,170,168,60,108,0.446,0.408,0.353,12880,327
"6318",179894,2001,1,0,"WEBSTER UNIVERSITY",NA,NA,399,250,149,179,64,115,0.46,0.449,0.43,13720,330
"6319",179894,2002,1,0,"WEBSTER UNIVERSITY",NA,NA,385,226,159,178,67,111,0.491,0.462,0.421,14600,287
"6320",179894,2003,1,0,"WEBSTER UNIVERSITY",NA,NA,419,260,159,201,62,139,0.535,0.48,0.39,15480,333
"6321",179894,2004,1,0,"WEBSTER UNIVERSITY",NA,NA,448,256,192,229,89,140,0.547,0.511,0.464,16250,359
"6322",179894,2005,1,0,"Webster University",NA,NA,394,224,170,175,76,99,0.442,0.444,0.447,17210,288
"6323",179894,2006,1,0,"Webster University",NA,NA,418,240,178,198,69,129,0.537,0.474,0.388,18240,328
"6324",179894,2007,1,0,"Webster University",NA,NA,483,278,205,224,80,144,0.518,0.464,0.39,19330,350
"6325",179894,2008,1,0,"Webster University",NA,NA,407,250,157,173,58,115,0.46,0.425,0.369,20440,290
"6326",179894,2009,1,0,"Webster University",NA,NA,486,289,197,219,78,141,0.488,0.451,0.396,21056,332
"6327",179894,2010,1,0,"Webster University",NA,NA,413,238,175,187,67,120,0.504,0.453,0.383,21688,279
"6328",179946,1991,1,0,"WESTMINSTER COLLEGE",NA,NA,194,83,111,99,56,43,0.518,0.51,0.505,8400,181
"6329",179946,1992,1,0,"WESTMINSTER COLLEGE",NA,NA,203,89,114,75,39,36,0.404,0.369,0.342,8950,191
"6330",179946,1993,1,0,"WESTMINSTER COLLEGE",NA,NA,180,71,109,73,39,34,0.479,0.406,0.358,9950,168
"6331",179946,1995,1,0,"WESTMINSTER COLLEGE",NA,NA,190,88,102,91,47,44,0.5,0.479,0.461,11150,174
"6332",179946,1996,1,0,"WESTMINSTER COLLEGE",NA,NA,214,84,130,100,62,38,0.452,0.467,0.477,11700,195
"6333",179946,1997,1,0,"WESTMINSTER COLLEGE",NA,NA,190,71,119,78,40,38,0.535,0.411,0.336,12300,177
"6334",179946,1998,1,0,"WESTMINSTER COLLEGE",NA,NA,205,94,111,78,40,38,0.404,0.38,0.36,13205,178
"6335",179946,1999,1,0,"WESTMINSTER COLLEGE",NA,NA,201,90,111,94,41,53,0.589,0.468,0.369,13490,180
"6336",179946,2000,1,0,"WESTMINSTER COLLEGE",NA,NA,173,75,98,82,37,45,0.6,0.474,0.378,14060,155
"6337",179946,2001,1,0,"WESTMINSTER COLLEGE",NA,NA,248,102,146,97,42,55,0.539,0.391,0.288,14630,218
"6338",179946,2002,1,0,"WESTMINSTER COLLEGE",NA,NA,207,93,114,100,48,52,0.559,0.483,0.421,15360,172
"6339",179946,2003,1,0,"WESTMINSTER COLLEGE",NA,NA,240,93,147,96,56,40,0.43,0.4,0.381,16128,188
"6340",179946,2004,1,0,"WESTMINSTER COLLEGE",NA,NA,231,108,123,105,54,51,0.472,0.455,0.439,12990,195
"6341",179946,2005,1,0,"Westminster College",NA,NA,287,125,162,143,65,78,0.624,0.498,0.401,13750,203
"6342",179946,2006,1,0,"Westminster College",NA,NA,278,139,139,163,73,90,0.647,0.586,0.525,14120,212
"6343",179946,2007,1,0,"Westminster College",NA,NA,223,95,128,115,57,58,0.61,0.516,0.445,15500,169
"6344",179946,2008,1,0,"Westminster College",NA,NA,244,108,136,123,67,56,0.519,0.504,0.493,16650,181
"6345",179946,2009,1,0,"Westminster College",NA,NA,311,152,159,149,61,88,0.579,0.479,0.384,17990,217
"6346",179946,2010,1,0,"Westminster College",NA,NA,315,139,176,175,75,100,0.719,0.556,0.426,18990,227
"6347",180179,1991,1,0,"EASTERN MONTANA COLLEGE",NA,NA,248,168,80,17,4,13,0.077,0.069,0.05,1524,211
"6348",180179,1992,1,0,"EASTERN MONTANA COLLEGE",NA,NA,285,200,85,27,9,18,0.09,0.095,0.106,1835,253
"6349",180179,1993,1,0,"EASTERN MONTANA COLLEGE",NA,NA,386,261,125,25,3,22,0.084,0.065,0.024,1916,348
"6350",180179,1995,1,0,"MONTANA STATE UNIVERSITY-BILLINGS",NA,NA,384,255,129,12,2,10,0.039,0.031,0.016,2304,358
"6351",180179,1996,1,0,"MONTANA STATE UNIVERSITY-BILLINGS",NA,NA,520,332,188,79,28,51,0.154,0.152,0.149,2388,466
"6352",180179,1997,1,0,"MONTANA STATE UNIVERSITY-BILLINGS",NA,NA,508,334,174,121,28,93,0.278,0.238,0.161,2517,431
"6353",180179,1998,1,0,"MONTANA STATE UNIVERSITY-BILLINGS",NA,NA,539,325,214,52,10,42,0.129,0.096,0.047,2816,450
"6354",180179,1999,1,0,"MONTANA STATE UNIVERSITY-BILLINGS",NA,NA,629,384,245,56,15,41,0.107,0.089,0.061,2922,532
"6355",180179,2000,1,0,"MONTANA STATE UNIVERSITY-BILLINGS",NA,NA,538,352,186,48,10,38,0.108,0.089,0.054,3052,424
"6356",180179,2001,1,0,"MONTANA STATE UNIVERSITY-BILLINGS",NA,NA,526,346,180,48,15,33,0.095,0.091,0.083,3429,438
"6357",180179,2002,1,0,"MONTANA STATE UNIVERSITY-BILLINGS",NA,NA,542,357,185,48,9,39,0.109,0.089,0.049,3973,458
"6358",180179,2003,1,0,"MONTANA STATE UNIVERSITY-BILLINGS",NA,NA,588,380,208,54,13,41,0.108,0.092,0.062,4180,513
"6359",180179,2004,1,0,"MONTANA STATE UNIVERSITY-BILLINGS",NA,NA,502,338,164,64,18,46,0.136,0.127,0.11,4550,423
"6360",180179,2005,1,0,"Montana State University-Billings",NA,NA,796,463,333,79,26,53,0.114,0.099,0.078,3762,677
"6361",180179,2006,1,0,"Montana State University-Billings",NA,NA,646,339,307,59,17,42,0.124,0.091,0.055,3951,567
"6362",180179,2007,1,0,"Montana State University-Billings",NA,NA,724,393,331,60,16,44,0.112,0.083,0.048,3988,615
"6363",180179,2008,1,0,"Montana State University-Billings",NA,NA,692,402,290,47,14,33,0.082,0.068,0.048,3988,577
"6364",180179,2009,1,0,"Montana State University-Billings",NA,NA,715,400,315,51,19,32,0.08,0.071,0.06,3988,619
"6365",180179,2010,1,0,"Montana State University-Billings",NA,NA,829,434,395,44,11,33,0.076,0.053,0.028,3988,674
"6366",180461,1991,1,0,"MONTANA STATE UNIVERSITY",NA,NA,1445,652,793,156,60,96,0.147,0.108,0.076,1550,1227
"6367",180461,1992,1,0,"MONTANA STATE UNIVERSITY",NA,NA,1530,646,884,155,65,90,0.139,0.101,0.074,1839,1313
"6368",180461,1993,1,0,"MONTANA STATE UNIVERSITY",NA,NA,1716,756,960,195,89,106,0.14,0.114,0.093,2002,1511
"6369",180461,1995,1,0,"MONTANA STATE UNIVERSITY-BOZEMAN",NA,NA,1744,714,1030,224,101,123,0.172,0.128,0.098,2378,1565
"6370",180461,1996,1,0,"MONTANA STATE UNIVERSITY-BOZEMAN",NA,NA,1740,780,960,246,120,126,0.161,0.141,0.125,2504,1531
"6371",180461,1997,1,0,"MONTANA STATE UNIVERSITY-BOZEMAN",NA,NA,1819,784,1035,259,116,143,0.182,0.142,0.112,2677,1616
"6372",180461,1998,1,0,"MONTANA STATE UNIVERSITY-BOZEMAN",NA,NA,1886,846,1040,299,140,159,0.188,0.159,0.135,2869,1666
"6373",180461,1999,1,0,"MONTANA STATE UNIVERSITY-BOZEMAN",NA,NA,1894,891,1003,354,164,190,0.213,0.187,0.164,2177,1659
"6374",180461,2000,1,0,"MONTANA STATE UNIVERSITY-BOZEMAN",NA,NA,1852,841,1011,357,160,197,0.234,0.193,0.158,2272,1698
"6375",180461,2001,1,0,"MONTANA STATE UNIVERSITY-BOZEMAN",NA,NA,1720,731,989,292,148,144,0.197,0.17,0.15,2567,1583
"6376",180461,2002,1,0,"MONTANA STATE UNIVERSITY-BOZEMAN",NA,NA,1924,833,1091,307,130,177,0.212,0.16,0.119,2900,1765
"6377",180461,2003,1,0,"MONTANA STATE UNIVERSITY-BOZEMAN",NA,NA,2004,837,1167,383,193,190,0.227,0.191,0.165,3256,1861
"6378",180461,2004,1,0,"MONTANA STATE UNIVERSITY-BOZEMAN",NA,NA,1998,836,1162,341,159,182,0.218,0.171,0.137,3654,1832
"6379",180461,2005,1,0,"Montana State University-Bozeman",NA,NA,1980,843,1137,412,198,214,0.254,0.208,0.174,4106,1843
"6380",180461,2006,1,0,"Montana State University-Bozeman",NA,NA,1940,814,1126,381,173,208,0.256,0.196,0.154,4501,1782
"6381",180461,2007,1,0,"Montana State University",NA,NA,1852,791,1061,371,162,209,0.264,0.2,0.153,4559,1668
"6382",180461,2008,1,0,"Montana State University",NA,NA,1805,765,1040,354,154,200,0.261,0.196,0.148,4559,1627
"6383",180461,2009,1,0,"Montana State University",NA,NA,1795,728,1067,387,190,197,0.271,0.216,0.178,4696,1627
"6384",180461,2010,1,0,"Montana State University",NA,NA,2115,877,1238,502,219,283,0.323,0.237,0.177,4836,1870
"6385",180522,1991,0,1,"NORTHERN MONTANA COLLEGE",1992,0,188,86,102,27,18,9,0.105,0.144,0.176,1440,151
"6386",180522,1992,1,0,"NORTHERN MONTANA COLLEGE",1992,1,188,98,90,20,13,7,0.071,0.106,0.144,1732,160
"6387",180522,1993,1,0,"NORTHERN MONTANA COLLEGE",1992,1,223,106,117,20,9,11,0.104,0.09,0.077,1802,182
"6388",180522,1995,1,0,"MONTANA STATE UNIVERSITY-NORTHERN",1992,1,192,99,93,38,16,22,0.222,0.198,0.172,2221,150
"6389",180522,1996,1,0,"MONTANA STATE UNIVERSITY-NORTHERN",1992,1,218,96,122,24,13,11,0.115,0.11,0.107,2350,108
"6390",180522,1997,1,0,"MONTANA STATE UNIVERSITY-NORTHERN",1992,1,235,89,146,28,16,12,0.135,0.119,0.11,2484,182
"6391",180522,1998,1,0,"MONTANA STATE UNIVERSITY-NORTHERN",1992,1,253,107,146,25,15,10,0.094,0.099,0.103,2692,213
"6392",180522,1999,1,0,"MONTANA STATE UNIVERSITY-NORTHERN",1992,1,261,112,149,30,16,14,0.125,0.115,0.107,1988,210
"6393",180522,2000,1,0,"MONTANA STATE UNIVERSITY-NORTHERN",1992,1,187,85,102,28,17,11,0.129,0.15,0.167,1988,152
"6394",180522,2001,1,0,"MONTANA STATE UNIVERSITY-NORTHERN",1992,1,177,76,101,16,10,6,0.079,0.09,0.099,2436,128
"6395",180522,2002,1,0,"MONTANA STATE UNIVERSITY-NORTHERN",1992,1,185,87,98,23,13,10,0.115,0.124,0.133,2796,136
"6396",180522,2003,1,0,"MONTANA STATE UNIVERSITY-NORTHERN",1992,1,214,108,106,36,20,16,0.148,0.168,0.189,2769,177
"6397",180522,2004,1,0,"MONTANA STATE UNIVERSITY-NORTHERN",1992,1,175,57,118,19,12,7,0.123,0.109,0.102,3101,140
"6398",180522,2005,1,0,"Montana State University-Northern",1992,1,192,55,137,15,10,5,0.091,0.078,0.073,3335,140
"6399",180522,2006,1,0,"Montana State University-Northern",1992,1,193,66,127,12,5,7,0.106,0.062,0.039,3586,160
"6400",180522,2007,1,0,"Montana State University-Northern",1992,1,186,69,117,19,12,7,0.101,0.102,0.103,3586,136
"6401",180522,2008,1,0,"Montana State University-Northern",1992,1,199,70,129,14,5,9,0.129,0.07,0.039,3586,153
"6402",180522,2009,1,0,"Montana State University-Northern",1992,1,233,71,162,21,13,8,0.113,0.09,0.08,3586,178
"6403",180522,2010,1,0,"Montana State University-Northern",1992,1,226,78,148,16,10,6,0.077,0.071,0.068,3586,160
"6404",180984,1991,1,0,"CONCORDIA TEACHERS COLLEGE",NA,NA,204,117,87,58,17,41,0.35,0.284,0.195,7110,194
"6405",180984,1992,1,0,"CONCORDIA TEACHERS COLLEGE",NA,NA,202,114,88,73,24,49,0.43,0.361,0.273,8090,189
"6406",180984,1993,1,0,"CONCORDIA TEACHERS COLLEGE",NA,NA,230,114,116,87,31,56,0.491,0.378,0.267,8506,210
"6407",180984,1995,1,0,"CONCORDIA TEACHERS COLLEGE",NA,NA,227,128,99,92,37,55,0.43,0.405,0.374,9480,220
"6408",180984,1996,1,0,"CONCORDIA TEACHERS COLLEGE",NA,NA,247,133,114,67,27,40,0.301,0.271,0.237,10150,214
"6409",180984,1997,1,0,"CONCORDIA TEACHERS COLLEGE",NA,NA,277,152,125,64,22,42,0.276,0.231,0.176,10750,262
"6410",180984,1998,1,0,"CONCORDIA UNIVERSITY",NA,NA,294,172,122,90,25,65,0.378,0.306,0.205,11310,273
"6411",180984,1999,1,0,"CONCORDIA UNIVERSITY",NA,NA,324,149,175,86,41,45,0.302,0.265,0.234,11876,209
"6412",180984,2000,1,0,"CONCORDIA UNIVERSITY",NA,NA,329,173,156,84,42,42,0.243,0.255,0.269,12470,317
"6413",180984,2001,1,0,"CONCORDIA UNIVERSITY",NA,NA,265,163,102,71,23,48,0.294,0.268,0.225,13468,245
"6414",180984,2002,1,0,"CONCORDIA UNIVERSITY",NA,NA,319,175,144,130,41,89,0.509,0.408,0.285,14546,299
"6415",180984,2003,1,0,"CONCORDIA UNIVERSITY",NA,NA,222,138,84,77,25,52,0.377,0.347,0.298,16000,200
"6416",180984,2004,1,0,"CONCORDIA UNIVERSITY",NA,NA,278,146,132,103,28,75,0.514,0.371,0.212,16880,247
"6417",180984,2005,1,0,"Concordia University",NA,NA,289,146,143,113,33,80,0.548,0.391,0.231,17724,199
"6418",180984,2006,1,0,"Concordia University",NA,NA,302,153,149,114,43,71,0.464,0.377,0.289,18750,265
"6419",180984,2007,1,0,"Concordia University",NA,NA,264,141,123,111,41,70,0.496,0.42,0.333,19670,239
"6420",180984,2008,1,0,"Concordia University",NA,NA,273,129,144,125,57,68,0.527,0.458,0.396,20580,245
"6421",180984,2009,1,0,"Concordia University",NA,NA,288,139,149,117,47,70,0.504,0.406,0.315,21100,259
"6422",180984,2010,1,0,"Concordia University-Seward",NA,NA,276,139,137,138,57,81,0.583,0.5,0.416,21940,254
"6423",181002,1991,1,0,"CREIGHTON UNIVERSITY",NA,NA,750,445,305,430,170,260,0.584,0.573,0.557,8996,648
"6424",181002,1992,1,0,"CREIGHTON UNIVERSITY",NA,NA,843,517,326,509,190,319,0.617,0.604,0.583,9670,728
"6425",181002,1993,1,0,"CREIGHTON UNIVERSITY",NA,NA,833,492,341,438,164,274,0.557,0.526,0.481,10252,711
"6426",181002,1995,1,0,"CREIGHTON UNIVERSITY",NA,NA,746,441,305,421,157,264,0.599,0.564,0.515,11964,608
"6427",181002,1996,1,0,"CREIGHTON UNIVERSITY",NA,NA,832,494,338,489,194,295,0.597,0.588,0.574,12210,642
"6428",181002,1997,1,0,"CREIGHTON UNIVERSITY",NA,NA,798,457,341,466,184,282,0.617,0.584,0.54,12756,627
"6429",181002,1998,1,0,"CREIGHTON UNIVERSITY",NA,NA,794,462,332,481,195,286,0.619,0.606,0.587,13394,627
"6430",181002,1999,1,0,"CREIGHTON UNIVERSITY",NA,NA,822,499,323,516,209,307,0.615,0.628,0.647,13566,677
"6431",181002,2000,1,0,"CREIGHTON UNIVERSITY",NA,NA,881,535,346,537,197,340,0.635,0.61,0.569,14312,719
"6432",181002,2001,1,0,"CREIGHTON UNIVERSITY",NA,NA,760,440,320,454,170,284,0.645,0.597,0.531,16500,643
"6433",181002,2002,1,0,"CREIGHTON UNIVERSITY",NA,NA,802,488,314,534,191,343,0.703,0.666,0.608,18200,675
"6434",181002,2003,1,0,"CREIGHTON UNIVERSITY",NA,NA,933,567,366,601,223,378,0.667,0.644,0.609,19202,792
"6435",181002,2004,1,0,"CREIGHTON UNIVERSITY",NA,NA,968,584,384,633,246,387,0.663,0.654,0.641,20354,796
"6436",181002,2005,1,0,"Creighton University",NA,NA,970,562,408,640,257,383,0.682,0.66,0.63,21576,789
"6437",181002,2006,1,0,"Creighton University",NA,NA,965,591,374,653,257,396,0.67,0.677,0.687,24166,783
"6438",181002,2007,1,0,"Creighton University",NA,NA,947,577,370,638,254,384,0.665,0.674,0.686,25616,740
"6439",181002,2008,1,0,"Creighton University",NA,NA,984,582,402,647,257,390,0.67,0.658,0.639,27282,751
"6440",181002,2009,1,0,"Creighton University",NA,NA,1052,635,417,709,275,434,0.683,0.674,0.659,28232,807
"6441",181002,2010,1,0,"Creighton University",NA,NA,1010,606,404,676,248,428,0.706,0.669,0.614,29226,736
"6442",181020,1991,1,0,"DOANE COLLEGE",NA,NA,230,116,114,117,42,75,0.647,0.509,0.368,8320,216
"6443",181020,1992,1,0,"DOANE COLLEGE",NA,NA,241,125,116,136,55,81,0.648,0.564,0.474,8770,223
"6444",181020,1993,1,0,"DOANE COLLEGE",NA,NA,246,135,111,127,52,75,0.556,0.516,0.468,9390,236
"6445",181020,1995,1,0,"DOANE COLLEGE",NA,NA,243,130,113,140,56,84,0.646,0.576,0.496,10410,236
"6446",181020,1996,1,0,"DOANE COLLEGE",NA,NA,276,139,137,146,62,84,0.604,0.529,0.453,10950,260
"6447",181020,1997,1,0,"DOANE COLLEGE",NA,NA,260,134,126,135,55,80,0.597,0.519,0.437,11450,236
"6448",181020,1998,1,0,"DOANE COLLEGE",NA,NA,266,123,143,156,70,86,0.699,0.586,0.49,11800,256
"6449",181020,1999,1,0,"DOANE COLLEGE",NA,NA,278,141,137,174,79,95,0.674,0.626,0.577,12010,257
"6450",181020,2000,1,0,"DOANE COLLEGE",NA,NA,300,160,140,174,75,99,0.619,0.58,0.536,12500,282
"6451",181020,2001,1,0,"DOANE COLLEGE",NA,NA,218,118,100,128,62,66,0.559,0.587,0.62,13150,202
"6452",181020,2002,1,0,"DOANE COLLEGE",NA,NA,273,142,131,178,84,94,0.662,0.652,0.641,13960,255
"6453",181020,2003,1,0,"DOANE COLLEGE",NA,NA,288,152,136,173,75,98,0.645,0.601,0.551,15080,260
"6454",181020,2004,1,0,"DOANE COLLEGE",NA,NA,303,172,131,162,67,95,0.552,0.535,0.511,15620,247
"6455",181020,2005,1,0,"Doane College",NA,NA,256,146,110,153,56,97,0.664,0.598,0.509,17186,234
"6456",181020,2006,1,0,"Doane College",NA,NA,247,147,100,149,54,95,0.646,0.603,0.54,18420,208
"6457",181020,2007,1,0,"Doane College",NA,NA,259,115,144,132,65,67,0.583,0.51,0.451,18800,204
"6458",181020,2008,1,0,"Doane College",NA,NA,247,105,142,135,62,73,0.695,0.547,0.437,19750,205
"6459",181020,2009,1,0,"Doane College",NA,NA,309,167,142,175,65,110,0.659,0.566,0.458,20540,278
"6460",181020,2010,1,0,"Doane College-Crete",NA,NA,327,179,148,163,52,111,0.62,0.498,0.351,21570,277
"6461",181127,1991,1,0,"HASTINGS COLLEGE",NA,NA,255,111,144,102,55,47,0.423,0.4,0.382,8090,227
"6462",181127,1992,1,0,"HASTINGS COLLEGE",NA,NA,254,124,130,112,43,69,0.556,0.441,0.331,8720,235
"6463",181127,1993,1,0,"HASTINGS COLLEGE",NA,NA,266,147,119,119,48,71,0.483,0.447,0.403,9296,250
"6464",181127,1995,1,0,"HASTINGS COLLEGE",NA,NA,271,134,137,117,44,73,0.545,0.432,0.321,10164,257
"6465",181127,1996,1,0,"HASTINGS COLLEGE",NA,NA,262,140,122,138,51,87,0.621,0.527,0.418,10724,250
"6466",181127,1997,1,0,"HASTINGS COLLEGE",NA,NA,282,145,137,145,50,95,0.655,0.514,0.365,11368,272
"6467",181127,1998,1,0,"HASTINGS COLLEGE",NA,NA,309,168,141,160,57,103,0.613,0.518,0.404,11940,289
"6468",181127,1999,1,0,"HASTINGS COLLEGE",NA,NA,286,141,145,146,54,92,0.652,0.51,0.372,11916,267
"6469",181127,2000,1,0,"HASTINGS COLLEGE",NA,NA,271,119,152,129,61,68,0.571,0.476,0.401,12396,256
"6470",181127,2001,1,0,"HASTINGS COLLEGE",NA,NA,252,125,127,130,55,75,0.6,0.516,0.433,13116,235
"6471",181127,2002,1,0,"HASTINGS COLLEGE",NA,NA,276,132,144,148,57,91,0.689,0.536,0.396,13972,261
"6472",181127,2003,1,0,"HASTINGS COLLEGE",NA,NA,338,143,195,185,87,98,0.685,0.547,0.446,14782,313
"6473",181127,2004,1,0,"HASTINGS COLLEGE",NA,NA,289,140,149,152,60,92,0.657,0.526,0.403,15640,265
"6474",181127,2005,1,0,"Hastings College",NA,NA,312,133,179,143,69,74,0.556,0.458,0.385,16578,288
"6475",181127,2006,1,0,"Hastings College",NA,NA,262,111,151,122,57,65,0.586,0.466,0.377,17572,242
"6476",181127,2007,1,0,"Hastings College",NA,NA,302,117,185,131,70,61,0.521,0.434,0.378,18822,275
"6477",181127,2008,1,0,"Hastings College",NA,NA,320,151,169,153,63,90,0.596,0.478,0.373,19952,282
"6478",181127,2009,1,0,"Hastings College",NA,NA,290,150,140,132,50,82,0.547,0.455,0.357,20912,252
"6479",181127,2010,1,0,"Hastings College",NA,NA,312,150,162,144,66,78,0.52,0.462,0.407,21720,277
"6480",181215,1991,1,0,"UNIVERSITY OF NEBRASKA AT KEARNEY",NA,NA,1230,665,565,141,54,87,0.131,0.115,0.096,1572,1099
"6481",181215,1992,1,0,"UNIVERSITY OF NEBRASKA AT KEARNEY",NA,NA,1322,723,599,137,38,99,0.137,0.104,0.063,1720,1151
"6482",181215,1993,1,0,"UNIVERSITY OF NEBRASKA AT KEARNEY",NA,NA,936,501,435,124,37,87,0.174,0.132,0.085,1811,844
"6483",181215,1995,1,0,"UNIVERSITY OF NEBRASKA AT KEARNEY",NA,NA,1306,729,577,138,46,92,0.126,0.106,0.08,2061,1154
"6484",181215,1996,1,0,"UNIVERSITY OF NEBRASKA AT KEARNEY",NA,NA,1279,707,572,174,59,115,0.163,0.136,0.103,2145,1117
"6485",181215,1997,1,0,"UNIVERSITY OF NEBRASKA AT KEARNEY",NA,NA,1005,570,435,174,60,114,0.2,0.173,0.138,2268,885
"6486",181215,1998,1,0,"UNIVERSITY OF NEBRASKA AT KEARNEY",NA,NA,1022,598,424,204,55,149,0.249,0.2,0.13,2508,895
"6487",181215,1999,1,0,"UNIVERSITY OF NEBRASKA AT KEARNEY",NA,NA,1035,579,456,212,71,141,0.244,0.205,0.156,2122,949
"6488",181215,2000,1,0,"UNIVERSITY OF NEBRASKA AT KEARNEY",NA,NA,996,550,446,159,48,111,0.202,0.16,0.108,2243,897
"6489",181215,2001,1,0,"UNIVERSITY OF NEBRASKA AT KEARNEY",NA,NA,1038,602,436,213,62,151,0.251,0.205,0.142,2468,896
"6490",181215,2002,1,0,"UNIVERSITY OF NEBRASKA AT KEARNEY",NA,NA,1022,574,448,216,69,147,0.256,0.211,0.154,2715,865
"6491",181215,2003,1,0,"UNIVERSITY OF NEBRASKA AT KEARNEY",NA,NA,1012,588,424,229,73,156,0.265,0.226,0.172,3120,864
"6492",181215,2004,1,0,"UNIVERSITY OF NEBRASKA AT KEARNEY",NA,NA,1061,589,472,238,85,153,0.26,0.224,0.18,3495,906
"6493",181215,2005,1,0,"University of Nebraska at Kearney",NA,NA,1013,584,429,228,71,157,0.269,0.225,0.166,3668,848
"6494",181215,2006,1,0,"University of Nebraska at Kearney",NA,NA,937,521,416,202,80,122,0.234,0.216,0.192,3885,771
"6495",181215,2007,1,0,"University of Nebraska at Kearney",NA,NA,915,484,431,193,74,119,0.246,0.211,0.172,4118,729
"6496",181215,2008,1,0,"University of Nebraska at Kearney",NA,NA,1019,530,489,232,87,145,0.274,0.228,0.178,4365,816
"6497",181215,2009,1,0,"University of Nebraska at Kearney",NA,NA,974,548,426,231,81,150,0.274,0.237,0.19,4538,764
"6498",181215,2010,1,0,"University of Nebraska at Kearney",NA,NA,1124,656,468,305,96,209,0.319,0.271,0.205,4808,922
"6499",181394,1991,1,0,"UNIVERSITY OF NEBRASKA AT OMAHA",NA,NA,1275,635,640,70,31,39,0.061,0.055,0.048,1242,1049
"6500",181394,1992,1,0,"UNIVERSITY OF NEBRASKA AT OMAHA",NA,NA,1256,630,626,54,19,35,0.056,0.043,0.03,1467,982
"6501",181394,1993,1,0,"UNIVERSITY OF NEBRASKA AT OMAHA",NA,NA,1220,664,556,52,14,38,0.057,0.043,0.025,1535,1025
"6502",181394,1995,1,0,"UNIVERSITY OF NEBRASKA AT OMAHA",NA,NA,1123,607,516,64,20,44,0.072,0.057,0.039,1790,929
"6503",181394,1996,1,0,"UNIVERSITY OF NEBRASKA AT OMAHA",NA,NA,1129,588,541,87,32,55,0.094,0.077,0.059,1848,954
"6504",181394,1997,1,0,"UNIVERSITY OF NEBRASKA AT OMAHA",NA,NA,1185,615,570,95,33,62,0.101,0.08,0.058,1926,960
"6505",181394,1998,1,0,"UNIVERSITY OF NEBRASKA AT OMAHA",NA,NA,1296,701,595,120,42,78,0.111,0.093,0.071,2144,1072
"6506",181394,1999,1,0,"UNIVERSITY OF NEBRASKA AT OMAHA",NA,NA,1477,762,715,151,45,106,0.139,0.102,0.063,2393,1251
"6507",181394,2000,1,0,"UNIVERSITY OF NEBRASKA AT OMAHA",NA,NA,1517,825,692,157,55,102,0.124,0.103,0.079,2528,1273
"6508",181394,2001,1,0,"UNIVERSITY OF NEBRASKA AT OMAHA",NA,NA,1588,857,731,170,62,108,0.126,0.107,0.085,2226,1338
"6509",181394,2002,1,0,"UNIVERSITY OF NEBRASKA AT OMAHA",NA,NA,1601,851,750,199,77,122,0.143,0.124,0.103,3060,1355
"6510",181394,2003,1,0,"UNIVERSITY OF NEBRASKA AT OMAHA",NA,NA,1465,787,678,189,85,104,0.132,0.129,0.125,3518,1261
"6511",181394,2004,1,0,"UNIVERSITY OF NEBRASKA AT OMAHA",NA,NA,1577,878,699,201,78,123,0.14,0.127,0.112,3938,1366
"6512",181394,2005,1,0,"University of Nebraska at Omaha",NA,NA,1690,911,779,259,105,154,0.169,0.153,0.135,4133,1402
"6513",181394,2006,1,0,"University of Nebraska at Omaha",NA,NA,1637,864,773,231,95,136,0.157,0.141,0.123,4380,1349
"6514",181394,2007,1,0,"University of Nebraska at Omaha",NA,NA,1596,834,762,228,106,122,0.146,0.143,0.139,4643,1279
"6515",181394,2008,1,0,"University of Nebraska at Omaha",NA,NA,1755,920,835,286,107,179,0.195,0.163,0.128,4920,1419
"6516",181394,2009,1,0,"University of Nebraska at Omaha",NA,NA,1747,932,815,278,93,185,0.198,0.159,0.114,5115,1393
"6517",181394,2010,1,0,"University of Nebraska at Omaha",NA,NA,1703,925,778,14,8,6,0.007,0.008,0.01,5423,1281
"6518",181446,1991,1,0,"NEBRASKA WESLEYAN UNIVERSITY",NA,NA,343,192,151,170,72,98,0.51,0.496,0.477,8226,319
"6519",181446,1992,1,0,"NEBRASKA WESLEYAN UNIVERSITY",NA,NA,366,212,154,174,72,102,0.481,0.475,0.468,8430,348
"6520",181446,1993,1,0,"NEBRASKA WESLEYAN UNIVERSITY",NA,NA,382,218,164,153,62,91,0.417,0.401,0.378,8894,363
"6521",181446,1995,1,0,"NEBRASKA WESLEYAN UNIVERSITY",NA,NA,362,214,148,164,57,107,0.5,0.453,0.385,9890,338
"6522",181446,1996,1,0,"NEBRASKA WESLEYAN UNIVERSITY",NA,NA,383,225,158,202,79,123,0.547,0.527,0.5,10284,367
"6523",181446,1997,1,0,"NEBRASKA WESLEYAN UNIVERSITY",NA,NA,437,250,187,205,87,118,0.472,0.469,0.465,11220,422
"6524",181446,1998,1,0,"NEBRASKA WESLEYAN UNIVERSITY",NA,NA,429,246,183,200,76,124,0.504,0.466,0.415,12004,415
"6525",181446,1999,1,0,"NEBRASKA WESLEYAN UNIVERSITY",NA,NA,358,204,154,197,84,113,0.554,0.55,0.545,12584,343
"6526",181446,2000,1,0,"NEBRASKA WESLEYAN UNIVERSITY",NA,NA,423,254,169,235,87,148,0.583,0.556,0.515,13452,403
"6527",181446,2001,1,0,"NEBRASKA WESLEYAN UNIVERSITY",NA,NA,392,223,169,219,84,135,0.605,0.559,0.497,14380,374
"6528",181446,2002,1,0,"NEBRASKA WESLEYAN UNIVERSITY",NA,NA,336,187,149,157,70,87,0.465,0.467,0.47,15372,316
"6529",181446,2003,1,0,"NEBRASKA WESLEYAN UNIVERSITY",NA,NA,417,241,176,216,83,133,0.552,0.518,0.472,16140,396
"6530",181446,2004,1,0,"NEBRASKA WESLEYAN UNIVERSITY",NA,NA,428,238,190,223,101,122,0.513,0.521,0.532,17090,406
"6531",181446,2005,1,0,"Nebraska Wesleyan University",NA,NA,406,237,169,236,82,154,0.65,0.581,0.485,18100,394
"6532",181446,2006,1,0,"Nebraska Wesleyan University",NA,NA,413,212,201,212,94,118,0.557,0.513,0.468,18980,385
"6533",181446,2007,1,0,"Nebraska Wesleyan University",NA,NA,438,272,166,239,74,165,0.607,0.546,0.446,19930,414
"6534",181446,2008,1,0,"Nebraska Wesleyan University",NA,NA,383,212,171,211,76,135,0.637,0.551,0.444,20950,352
"6535",181446,2009,1,0,"Nebraska Wesleyan University",NA,NA,393,233,160,201,63,138,0.592,0.511,0.394,21980,364
"6536",181446,2010,1,0,"Nebraska Wesleyan University",NA,NA,427,237,190,256,106,150,0.633,0.6,0.558,23124,376
"6537",181464,1991,1,0,"UNIVERSITY OF NEBRASKA AT LINCOLN",NA,NA,3386,1641,1745,379,121,258,0.157,0.112,0.069,2040,3162
"6538",181464,1992,1,0,"UNIVERSITY OF NEBRASKA AT LINCOLN",NA,NA,3392,1651,1741,330,124,206,0.125,0.097,0.071,2187,3154
"6539",181464,1993,1,0,"UNIVERSITY OF NEBRASKA AT LINCOLN",NA,NA,3325,1571,1754,449,170,279,0.178,0.135,0.097,2283,3079
"6540",181464,1995,1,0,"UNIVERSITY OF NEBRASKA AT LINCOLN",NA,NA,3891,1925,1966,620,256,364,0.189,0.159,0.13,2555,3514
"6541",181464,1996,1,0,"UNIVERSITY OF NEBRASKA AT LINCOLN",NA,NA,3625,1814,1811,654,248,406,0.224,0.18,0.137,2638,3258
"6542",181464,1997,1,0,"UNIVERSITY OF NEBRASKA AT LINCOLN",NA,NA,3195,1596,1599,681,259,422,0.264,0.213,0.162,2829,2863
"6543",181464,1998,1,0,"UNIVERSITY OF NEBRASKA AT LINCOLN",NA,NA,3353,1619,1734,740,275,465,0.287,0.221,0.159,3083,3026
"6544",181464,1999,1,0,"UNIVERSITY OF NEBRASKA AT LINCOLN",NA,NA,3592,1778,1814,807,317,490,0.276,0.225,0.175,2617,3259
"6545",181464,2000,1,0,"UNIVERSITY OF NEBRASKA AT LINCOLN",NA,NA,3598,1783,1815,823,326,497,0.279,0.229,0.18,2760,3123
"6546",181464,2001,1,0,"UNIVERSITY OF NEBRASKA AT LINCOLN",NA,NA,3480,1691,1789,788,308,480,0.284,0.226,0.172,3038,3090
"6547",181464,2002,1,0,"UNIVERSITY OF NEBRASKA AT LINCOLN",NA,NA,3615,1878,1737,919,358,561,0.299,0.254,0.206,3345,3158
"6548",181464,2003,1,0,"UNIVERSITY OF NEBRASKA AT LINCOLN",NA,NA,3639,1825,1814,904,341,563,0.308,0.248,0.188,3847,3184
"6549",181464,2004,1,0,"UNIVERSITY OF NEBRASKA AT LINCOLN",NA,NA,3236,1559,1677,950,394,556,0.357,0.294,0.235,4312,2817
"6550",181464,2005,1,0,"University of Nebraska at Lincoln",NA,NA,3533,1671,1862,1118,505,613,0.367,0.316,0.271,4530,3012
"6551",181464,2006,1,0,"University of Nebraska at Lincoln",NA,NA,3828,1805,2023,1126,503,623,0.345,0.294,0.249,4800,3245
"6552",181464,2007,1,0,"University of Nebraska-Lincoln",NA,NA,4214,2061,2153,1363,555,808,0.392,0.323,0.258,5085,3423
"6553",181464,2008,1,0,"University of Nebraska-Lincoln",NA,NA,4164,2015,2149,1377,566,811,0.402,0.331,0.263,5392,3582
"6554",181464,2009,1,0,"University of Nebraska-Lincoln",NA,NA,3965,1870,2095,1308,552,756,0.404,0.33,0.263,5610,3409
"6555",181464,2010,1,0,"University of Nebraska-Lincoln",NA,NA,4039,1889,2150,1461,647,814,0.431,0.362,0.301,5948,3510
"6556",181534,1991,1,0,"PERU STATE COLLEGE",NA,NA,235,129,106,24,7,17,0.132,0.102,0.066,1589,211
"6557",181534,1992,1,0,"PERU STATE COLLEGE",NA,NA,264,135,129,27,9,18,0.133,0.102,0.07,1671,247
"6558",181534,1993,1,0,"PERU STATE COLLEGE",NA,NA,211,112,99,22,4,18,0.161,0.104,0.04,1687,200
"6559",181534,1995,1,0,"PERU STATE COLLEGE",NA,NA,225,122,103,45,19,26,0.213,0.2,0.184,1848,205
"6560",181534,1996,1,0,"PERU STATE COLLEGE",NA,NA,223,97,126,38,11,27,0.278,0.17,0.087,1936,199
"6561",181534,1997,1,0,"PERU STATE COLLEGE",NA,NA,258,107,151,38,16,22,0.206,0.147,0.106,2018,222
"6562",181534,1998,1,0,"PERU STATE COLLEGE",NA,NA,213,91,122,22,3,19,0.209,0.103,0.025,2161,184
"6563",181534,1999,1,0,"PERU STATE COLLEGE",NA,NA,192,87,105,65,31,34,0.391,0.339,0.295,1875,168
"6564",181534,2000,1,0,"PERU STATE COLLEGE",NA,NA,201,93,108,26,7,19,0.204,0.129,0.065,1973,170
"6565",181534,2001,1,0,"PERU STATE COLLEGE",NA,NA,186,85,101,16,5,11,0.129,0.086,0.05,2093,164
"6566",181534,2002,1,0,"PERU STATE COLLEGE",NA,NA,171,85,86,29,10,19,0.224,0.17,0.116,2288,149
"6567",181534,2003,1,0,"PERU STATE COLLEGE",NA,NA,188,89,99,29,9,20,0.225,0.154,0.091,2610,161
"6568",181534,2004,1,0,"PERU STATE COLLEGE",NA,NA,217,114,103,21,5,16,0.14,0.097,0.049,2850,189
"6569",181534,2005,1,0,"Peru State College",NA,NA,213,112,101,26,7,19,0.17,0.122,0.069,2932,174
"6570",181534,2006,1,0,"Peru State College",NA,NA,204,95,109,37,17,20,0.211,0.181,0.156,3296,166
"6571",181534,2007,1,0,"Peru State College",NA,NA,197,89,108,38,13,25,0.281,0.193,0.12,3300,159
"6572",181534,2008,1,0,"Peru State College",NA,NA,210,101,109,23,10,13,0.129,0.11,0.092,3495,178
"6573",181534,2009,1,0,"Peru State College",NA,NA,227,113,114,35,12,23,0.204,0.154,0.105,3675,190
"6574",181534,2010,1,0,"Peru State College",NA,NA,243,117,126,32,6,26,0.222,0.132,0.048,3863,209
"6575",181783,1991,1,0,"WAYNE STATE COLLEGE",NA,NA,681,357,324,103,38,65,0.182,0.151,0.117,1515,649
"6576",181783,1992,1,0,"WAYNE STATE COLLEGE",NA,NA,630,348,282,117,39,78,0.224,0.186,0.138,1599,605
"6577",181783,1993,1,0,"WAYNE STATE COLLEGE",NA,NA,718,398,320,105,25,80,0.201,0.146,0.078,1690,674
"6578",181783,1995,1,0,"WAYNE STATE COLLEGE",NA,NA,722,382,340,146,45,101,0.264,0.202,0.132,1839,666
"6579",181783,1996,1,0,"WAYNE STATE COLLEGE",NA,NA,690,397,293,147,53,94,0.237,0.213,0.181,1938,636
"6580",181783,1997,1,0,"WAYNE STATE COLLEGE",NA,NA,707,407,300,161,42,119,0.292,0.228,0.14,2080,641
"6581",181783,1998,1,0,"WAYNE STATE COLLEGE",NA,NA,700,402,298,177,56,121,0.301,0.253,0.188,2163,636
"6582",181783,1999,1,0,"WAYNE STATE COLLEGE",NA,NA,659,387,272,150,41,109,0.282,0.228,0.151,1875,601
"6583",181783,2000,1,0,"WAYNE STATE COLLEGE",NA,NA,623,366,257,168,49,119,0.325,0.27,0.191,1973,573
"6584",181783,2001,1,0,"WAYNE STATE COLLEGE",NA,NA,583,359,224,138,40,98,0.273,0.237,0.179,2093,524
"6585",181783,2002,1,0,"WAYNE STATE COLLEGE",NA,NA,602,325,277,155,66,89,0.274,0.257,0.238,2288,533
"6586",181783,2003,1,0,"WAYNE STATE COLLEGE",NA,NA,598,342,256,163,59,104,0.304,0.273,0.23,2610,536
"6587",181783,2004,1,0,"WAYNE STATE COLLEGE",NA,NA,552,310,242,128,39,89,0.287,0.232,0.161,2850,494
"6588",181783,2005,1,0,"Wayne State College",NA,NA,587,320,267,162,71,91,0.284,0.276,0.266,2346,533
"6589",181783,2006,1,0,"Wayne State College",NA,NA,606,335,271,166,53,113,0.337,0.274,0.196,2460,527
"6590",181783,2007,1,0,"Wayne State College",NA,NA,654,364,290,162,48,114,0.313,0.248,0.166,2640,554
"6591",181783,2008,1,0,"Wayne State College",NA,NA,653,345,308,148,52,96,0.278,0.227,0.169,2796,568
"6592",181783,2009,1,0,"Wayne State College",NA,NA,663,361,302,158,56,102,0.283,0.238,0.185,3675,537
"6593",181783,2010,1,0,"Wayne State College",NA,NA,677,366,311,172,58,114,0.312,0.254,0.186,3863,537
"6594",182281,1991,1,0,"UNIVERSITY OF NEVADA-LAS VEGAS",NA,NA,1172,604,568,125,47,78,0.129,0.107,0.083,1470,796
"6595",182281,1992,1,0,"UNIVERSITY OF NEVADA-LAS VEGAS",NA,NA,1213,641,572,128,44,84,0.131,0.106,0.077,1665,838
"6596",182281,1993,1,0,"UNIVERSITY OF NEVADA-LAS VEGAS",NA,NA,1281,669,612,127,47,80,0.12,0.099,0.077,1665,828
"6597",182281,1995,1,0,"UNIVERSITY OF NEVADA-LAS VEGAS",NA,NA,1324,748,576,161,54,107,0.143,0.122,0.094,1830,837
"6598",182281,1996,1,0,"UNIVERSITY OF NEVADA-LAS VEGAS",NA,NA,1509,797,712,179,49,130,0.163,0.119,0.069,1920,911
"6599",182281,1997,1,0,"UNIVERSITY OF NEVADA-LAS VEGAS",NA,NA,1491,773,718,183,54,129,0.167,0.123,0.075,1995,903
"6600",182281,1998,1,0,"UNIVERSITY OF NEVADA-LAS VEGAS",NA,NA,1546,885,661,186,58,128,0.145,0.12,0.088,2070,910
"6601",182281,1999,1,0,"UNIVERSITY OF NEVADA-LAS VEGAS",NA,NA,1486,805,681,204,73,131,0.163,0.137,0.107,2145,886
"6602",182281,2000,1,0,"UNIVERSITY OF NEVADA-LAS VEGAS",NA,NA,2126,1182,944,240,70,170,0.144,0.113,0.074,2340,1224
"6603",182281,2001,1,0,"UNIVERSITY OF NEVADA-LAS VEGAS",NA,NA,2424,1411,1013,324,99,225,0.16,0.134,0.098,2415,1368
"6604",182281,2002,1,0,"UNIVERSITY OF NEVADA-LAS VEGAS",NA,NA,2383,1373,1010,293,80,213,0.155,0.123,0.079,2490,1292
"6605",182281,2003,1,0,"UNIVERSITY OF NEVADA-LAS VEGAS",NA,NA,2827,1596,1231,338,107,231,0.145,0.12,0.087,2670,1496
"6606",182281,2004,1,0,"UNIVERSITY OF NEVADA-LAS VEGAS",NA,NA,3108,1760,1348,428,134,294,0.167,0.138,0.099,2850,1604
"6607",182281,2005,1,0,"University of Nevada-Las Vegas",NA,NA,2964,1694,1270,402,134,268,0.158,0.136,0.106,3060,1140
"6608",182281,2006,1,0,"University of Nevada-Las Vegas",NA,NA,2532,1410,1122,368,130,238,0.169,0.145,0.116,3278,1225
"6609",182281,2007,1,0,"University of Nevada-Las Vegas",NA,NA,2780,1596,1184,406,117,289,0.181,0.146,0.099,3623,1305
"6610",182281,2008,1,0,"University of Nevada-Las Vegas",NA,NA,3020,1709,1311,422,142,280,0.164,0.14,0.108,4005,1318
"6611",182281,2009,1,0,"University of Nevada-Las Vegas",NA,NA,3083,1659,1424,397,146,251,0.151,0.129,0.103,4485,1307
"6612",182281,2010,1,0,"University of Nevada-Las Vegas",NA,NA,2923,1621,1302,341,117,224,0.138,0.117,0.09,5196,1141
"6613",182290,1991,1,0,"UNIVERSITY OF NEVADA-RENO",NA,NA,966,482,484,101,43,58,0.12,0.105,0.089,1104,751
"6614",182290,1992,1,0,"UNIVERSITY OF NEVADA-RENO",NA,NA,1058,523,535,119,41,78,0.149,0.112,0.077,1308,855
"6615",182290,1993,1,0,"UNIVERSITY OF NEVADA-RENO",NA,NA,1140,563,577,155,49,106,0.188,0.136,0.085,1332,915
"6616",182290,1995,1,0,"UNIVERSITY OF NEVADA-RENO",NA,NA,1035,591,444,170,52,118,0.2,0.164,0.117,1464,790
"6617",182290,1996,1,0,"UNIVERSITY OF NEVADA-RENO",NA,NA,1123,605,518,163,46,117,0.193,0.145,0.089,1650,871
"6618",182290,1997,1,0,"UNIVERSITY OF NEVADA-RENO",NA,NA,1165,654,511,171,54,117,0.179,0.147,0.106,1710,888
"6619",182290,1998,1,0,"UNIVERSITY OF NEVADA-RENO",NA,NA,1260,675,585,181,60,121,0.179,0.144,0.103,1770,973
"6620",182290,1999,1,0,"UNIVERSITY OF NEVADA-RENO",NA,NA,1466,792,674,241,78,163,0.206,0.164,0.116,1704,1116
"6621",182290,2000,1,0,"UNIVERSITY OF NEVADA-RENO",NA,NA,1930,1090,840,293,95,198,0.182,0.152,0.113,2340,1461
"6622",182290,2001,1,0,"UNIVERSITY OF NEVADA-RENO",NA,NA,1956,1125,831,268,78,190,0.169,0.137,0.094,2415,1504
"6623",182290,2002,1,0,"UNIVERSITY OF NEVADA-RENO",NA,NA,2066,1137,929,308,102,206,0.181,0.149,0.11,2490,1571
"6624",182290,2003,1,0,"UNIVERSITY OF NEVADA-RENO",NA,NA,2047,1154,893,254,76,178,0.154,0.124,0.085,2670,1479
"6625",182290,2004,1,0,"UNIVERSITY OF NEVADA-RENO",NA,NA,2132,1157,975,289,104,185,0.16,0.136,0.107,2850,1467
"6626",182290,2005,1,0,"University of Nevada-Reno",NA,NA,2362,1300,1062,383,136,247,0.19,0.162,0.128,3060,1598
"6627",182290,2006,1,0,"University of Nevada-Reno",NA,NA,2358,1300,1058,407,146,261,0.201,0.173,0.138,3278,1576
"6628",182290,2007,1,0,"University of Nevada-Reno",NA,NA,2226,1166,1060,349,131,218,0.187,0.157,0.124,3623,1498
"6629",182290,2008,1,0,"University of Nevada-Reno",NA,NA,2260,1211,1049,467,179,288,0.238,0.207,0.171,4005,1513
"6630",182290,2009,1,0,"University of Nevada-Reno",NA,NA,2124,1144,980,467,172,295,0.258,0.22,0.176,4485,1484
"6631",182290,2010,1,0,"University of Nevada-Reno",NA,NA,2693,1430,1263,610,233,377,0.264,0.227,0.184,5063,1785
"6632",182634,1991,1,0,"COLBY-SAWYER COLLEGE",NA,NA,215,137,78,99,29,70,0.511,0.46,0.372,11900,213
"6633",182634,1992,1,0,"COLBY-SAWYER COLLEGE",NA,NA,160,106,54,73,23,50,0.472,0.456,0.426,12775,158
"6634",182634,1993,1,0,"COLBY-SAWYER COLLEGE",NA,NA,179,115,64,72,24,48,0.417,0.402,0.375,13375,173
"6635",182634,1995,1,0,"COLBY-SAWYER COLLEGE",NA,NA,240,154,86,115,46,69,0.448,0.479,0.535,14720,230
"6636",182634,1996,1,0,"COLBY-SAWYER COLLEGE",NA,NA,227,158,69,91,31,60,0.38,0.401,0.449,15530,220
"6637",182634,1997,1,0,"COLBY-SAWYER COLLEGE",NA,NA,240,172,68,111,29,82,0.477,0.462,0.426,16310,214
"6638",182634,1998,1,0,"COLBY-SAWYER COLLEGE",NA,NA,235,162,73,111,29,82,0.506,0.472,0.397,17270,221
"6639",182634,1999,1,0,"COLBY-SAWYER COLLEGE",NA,NA,236,151,85,115,47,68,0.45,0.487,0.553,18060,224
"6640",182634,2000,1,0,"COLBY-SAWYER COLLEGE",NA,NA,274,180,94,148,47,101,0.561,0.54,0.5,18960,262
"6641",182634,2001,1,0,"COLBY-SAWYER COLLEGE",NA,NA,285,184,101,140,43,97,0.527,0.491,0.426,20130,254
"6642",182634,2002,1,0,"COLBY-SAWYER COLLEGE",NA,NA,270,172,98,133,54,79,0.459,0.493,0.551,21140,261
"6643",182634,2003,1,0,"COLBY-SAWYER COLLEGE",NA,NA,304,207,97,158,34,124,0.599,0.52,0.351,22200,294
"6644",182634,2004,1,0,"COLBY-SAWYER COLLEGE",NA,NA,263,179,84,140,42,98,0.547,0.532,0.5,23310,255
"6645",182634,2005,1,0,"Colby-Sawyer College",NA,NA,280,179,101,130,42,88,0.492,0.464,0.416,24700,271
"6646",182634,2006,1,0,"Colby-Sawyer College",NA,NA,220,151,69,95,22,73,0.483,0.432,0.319,26350,200
"6647",182634,2007,1,0,"Colby-Sawyer College",NA,NA,353,240,113,169,44,125,0.521,0.479,0.389,28010,306
"6648",182634,2008,1,0,"Colby-Sawyer College",NA,NA,376,251,125,138,44,94,0.375,0.367,0.352,29620,323
"6649",182634,2009,1,0,"Colby-Sawyer College",NA,NA,432,313,119,190,45,145,0.463,0.44,0.378,31090,357
"6650",182634,2010,1,0,"Colby-Sawyer College",NA,NA,393,266,127,185,51,134,0.504,0.471,0.402,32640,271
"6651",182795,1991,1,0,"FRANKLIN PIERCE COLLEGE",NA,NA,429,192,237,124,57,67,0.349,0.289,0.241,11510,337
"6652",182795,1992,1,0,"FRANKLIN PIERCE COLLEGE",NA,NA,469,236,233,178,82,96,0.407,0.38,0.352,12430,340
"6653",182795,1993,1,0,"FRANKLIN PIERCE COLLEGE",NA,NA,410,186,224,117,64,53,0.285,0.285,0.286,12820,377
"6654",182795,1995,1,0,"FRANKLIN PIERCE COLLEGE",NA,NA,464,220,244,174,75,99,0.45,0.375,0.307,14445,383
"6655",182795,1996,1,0,"FRANKLIN PIERCE COLLEGE",NA,NA,438,210,228,181,81,100,0.476,0.413,0.355,15375,313
"6656",182795,1997,1,0,"FRANKLIN PIERCE COLLEGE",NA,NA,489,257,232,178,69,109,0.424,0.364,0.297,16325,398
"6657",182795,1998,1,0,"FRANKLIN PIERCE COLLEGE",NA,NA,429,203,226,145,59,86,0.424,0.338,0.261,17022,330
"6658",182795,1999,1,0,"FRANKLIN PIERCE COLLEGE",NA,NA,429,184,245,189,103,86,0.467,0.441,0.42,17250,363
"6659",182795,2000,1,0,"FRANKLIN PIERCE COLLEGE",NA,NA,530,262,268,227,101,126,0.481,0.428,0.377,18150,442
"6660",182795,2001,1,0,"FRANKLIN PIERCE COLLEGE",NA,NA,477,249,228,153,67,86,0.345,0.321,0.294,18900,387
"6661",182795,2002,1,0,"FRANKLIN PIERCE COLLEGE",NA,NA,505,252,253,197,88,109,0.432,0.39,0.348,19560,417
"6662",182795,2003,1,0,"FRANKLIN PIERCE COLLEGE",NA,NA,514,244,270,172,74,98,0.402,0.335,0.274,20790,403
"6663",182795,2004,1,0,"FRANKLIN PIERCE COLLEGE",NA,NA,568,285,283,232,97,135,0.474,0.408,0.343,21900,452
"6664",182795,2005,1,0,"Franklin Pierce College",NA,NA,532,270,262,2,0,2,0.007,0.004,0,23100,443
"6665",182795,2006,1,0,"Franklin Pierce College",NA,NA,553,260,293,226,103,123,0.473,0.409,0.352,24300,438
"6666",182795,2007,1,0,"Franklin Pierce University",NA,NA,533,239,294,207,100,107,0.448,0.388,0.34,25516,402
"6667",182795,2008,1,0,"Franklin Pierce University",NA,NA,474,205,269,185,89,96,0.468,0.39,0.331,27000,360
"6668",182795,2009,1,0,"Franklin Pierce University",NA,NA,388,175,213,138,62,76,0.434,0.356,0.291,27700,307
"6669",182795,2010,1,0,"Franklin Pierce University",NA,NA,399,179,220,142,50,92,0.514,0.356,0.227,27700,295
"6670",183062,1991,1,0,"KEENE STATE COLLEGE",NA,NA,731,444,287,159,41,118,0.266,0.218,0.143,2680,630
"6671",183062,1992,1,0,"KEENE STATE COLLEGE",NA,NA,754,447,307,179,50,129,0.289,0.237,0.163,2845,699
"6672",183062,1993,1,0,"KEENE STATE COLLEGE",NA,NA,809,488,321,170,43,127,0.26,0.21,0.134,3120,765
"6673",183062,1995,1,0,"KEENE STATE COLLEGE",NA,NA,988,588,400,251,86,165,0.281,0.254,0.215,3604,941
"6674",183062,1996,1,0,"KEENE STATE COLLEGE",NA,NA,839,499,340,211,68,143,0.287,0.251,0.2,3794,788
"6675",183062,1997,1,0,"KEENE STATE COLLEGE",NA,NA,845,501,344,193,71,122,0.244,0.228,0.206,4320,789
"6676",183062,1998,1,0,"KEENE STATE COLLEGE",NA,NA,773,470,303,178,53,125,0.266,0.23,0.175,4750,716
"6677",183062,1999,1,0,"KEENE STATE COLLEGE",NA,NA,1014,649,365,262,70,192,0.296,0.258,0.192,3830,964
"6678",183062,2000,1,0,"KEENE STATE COLLEGE",NA,NA,935,576,359,243,69,174,0.302,0.26,0.192,4060,909
"6679",183062,2001,1,0,"KEENE STATE COLLEGE",NA,NA,942,561,381,283,94,189,0.337,0.3,0.247,4220,895
"6680",183062,2002,1,0,"KEENE STATE COLLEGE",NA,NA,1170,668,502,333,119,214,0.32,0.285,0.237,4450,1118
"6681",183062,2003,1,0,"KEENE STATE COLLEGE",NA,NA,991,598,393,369,126,243,0.406,0.372,0.321,4750,942
"6682",183062,2004,1,0,"KEENE STATE COLLEGE",NA,NA,1068,649,419,425,148,277,0.427,0.398,0.353,5060,1003
"6683",183062,2005,1,0,"Keene State College",NA,NA,1001,565,436,434,172,262,0.464,0.434,0.394,5410,943
"6684",183062,2006,1,0,"Keene State College",NA,NA,1139,718,421,559,194,365,0.508,0.491,0.461,5780,1083
"6685",183062,2007,1,0,"Keene State College",NA,NA,1295,762,533,666,252,414,0.543,0.514,0.473,6180,1235
"6686",183062,2008,1,0,"Keene State College",NA,NA,1287,777,510,667,238,429,0.552,0.518,0.467,6600,1226
"6687",183062,2009,1,0,"Keene State College",NA,NA,1171,712,459,616,228,388,0.545,0.526,0.497,7000,1093
"6688",183062,2010,1,0,"Keene State College",NA,NA,1201,718,483,643,252,391,0.545,0.535,0.522,7650,976
"6689",183080,1991,1,0,"PLYMOUTH STATE COLLEGE",NA,NA,729,377,352,219,83,136,0.361,0.3,0.236,2716,655
"6690",183080,1992,1,0,"PLYMOUTH STATE COLLEGE",NA,NA,775,403,372,206,79,127,0.315,0.266,0.212,2926,702
"6691",183080,1993,1,0,"PLYMOUTH STATE COLLEGE",NA,NA,748,364,384,163,63,100,0.275,0.218,0.164,3281,688
"6692",183080,1995,1,0,"PLYMOUTH STATE COLLEGE",NA,NA,872,426,446,204,80,124,0.291,0.234,0.179,3754,820
"6693",183080,1996,1,0,"PLYMOUTH STATE COLLEGE",NA,NA,894,433,461,196,87,109,0.252,0.219,0.189,3926,837
"6694",183080,1997,1,0,"PLYMOUTH STATE COLLEGE",NA,NA,844,396,448,163,75,88,0.222,0.193,0.167,4342,775
"6695",183080,1998,1,0,"PLYMOUTH STATE COLLEGE",NA,NA,784,375,409,190,81,109,0.291,0.242,0.198,4780,715
"6696",183080,1999,1,0,"PLYMOUTH STATE COLLEGE",NA,NA,772,377,395,204,75,129,0.342,0.264,0.19,3830,677
"6697",183080,2000,1,0,"PLYMOUTH STATE COLLEGE",NA,NA,902,454,448,241,97,144,0.317,0.267,0.217,4060,836
"6698",183080,2001,1,0,"PLYMOUTH STATE COLLEGE",NA,NA,872,463,409,272,89,183,0.395,0.312,0.218,4220,804
"6699",183080,2002,1,0,"PLYMOUTH STATE COLLEGE",NA,NA,940,447,493,279,120,159,0.356,0.297,0.243,4450,856
"6700",183080,2003,1,0,"PLYMOUTH STATE UNIVERSITY",NA,NA,900,469,431,310,134,176,0.375,0.344,0.311,4750,811
"6701",183080,2004,1,0,"PLYMOUTH STATE UNIVERSITY",NA,NA,1052,524,528,356,156,200,0.382,0.338,0.295,5060,959
"6702",183080,2005,1,0,"Plymouth State University",NA,NA,999,473,526,401,193,208,0.44,0.401,0.367,5410,921
"6703",183080,2006,1,0,"Plymouth State University",NA,NA,1008,446,562,402,191,211,0.473,0.399,0.34,5780,870
"6704",183080,2007,1,0,"Plymouth State University",NA,NA,1006,444,562,414,206,208,0.469,0.412,0.367,6180,788
"6705",183080,2008,1,0,"Plymouth State University",NA,NA,1087,500,587,476,214,262,0.524,0.438,0.365,6600,889
"6706",183080,2009,1,0,"Plymouth State University",NA,NA,971,450,521,430,196,234,0.52,0.443,0.376,7000,835
"6707",183080,2010,1,0,"Plymouth State University",NA,NA,1056,520,536,456,186,270,0.519,0.432,0.347,7650,817
"6708",183239,1991,1,0,"SAINT ANSELM COLLEGE",NA,NA,545,303,242,365,155,210,0.693,0.67,0.64,10160,535
"6709",183239,1992,1,0,"SAINT ANSELM COLLEGE",NA,NA,493,274,219,325,141,184,0.672,0.659,0.644,10870,479
"6710",183239,1993,1,0,"SAINT ANSELM COLLEGE",NA,NA,510,284,226,323,128,195,0.687,0.633,0.566,11840,496
"6711",183239,1995,1,0,"SAINT ANSELM COLLEGE",NA,NA,612,369,243,424,163,261,0.707,0.693,0.671,13720,592
"6712",183239,1996,1,0,"SAINT ANSELM COLLEGE",NA,NA,549,301,248,397,172,225,0.748,0.723,0.694,14550,527
"6713",183239,1997,1,0,"SAINT ANSELM COLLEGE",NA,NA,508,283,225,350,134,216,0.763,0.689,0.596,15430,483
"6714",183239,1998,1,0,"SAINT ANSELM COLLEGE",NA,NA,528,296,232,392,159,233,0.787,0.742,0.685,16370,512
"6715",183239,1999,1,0,"SAINT ANSELM COLLEGE",NA,NA,534,280,254,376,160,216,0.771,0.704,0.63,17300,509
"6716",183239,2000,1,0,"SAINT ANSELM COLLEGE",NA,NA,518,280,238,349,142,207,0.739,0.674,0.597,18350,502
"6717",183239,2001,1,0,"SAINT ANSELM COLLEGE",NA,NA,535,286,249,363,152,211,0.738,0.679,0.61,19460,502
"6718",183239,2002,1,0,"SAINT ANSELM COLLEGE",NA,NA,570,330,240,406,148,258,0.782,0.712,0.617,20390,531
"6719",183239,2003,1,0,"SAINT ANSELM COLLEGE",NA,NA,587,336,251,418,172,246,0.732,0.712,0.685,21410,497
"6720",183239,2004,1,0,"SAINT ANSELM COLLEGE",NA,NA,516,284,232,370,149,221,0.778,0.717,0.642,22700,241
"6721",183239,2005,1,0,"Saint Anselm College",NA,NA,519,296,223,372,145,227,0.767,0.717,0.65,23990,410
"6722",183239,2006,1,0,"Saint Anselm College",NA,NA,568,343,225,410,151,259,0.755,0.722,0.671,25430,471
"6723",183239,2007,1,0,"Saint Anselm College",NA,NA,568,300,268,404,169,235,0.783,0.711,0.631,26960,515
"6724",183239,2008,1,0,"Saint Anselm College",NA,NA,500,286,214,351,143,208,0.727,0.702,0.668,28440,454
"6725",183239,2009,1,0,"Saint Anselm College",NA,NA,528,285,243,372,154,218,0.765,0.705,0.634,29720,448
"6726",183239,2010,1,0,"Saint Anselm College",NA,NA,535,295,240,369,142,227,0.77,0.69,0.592,30760,455
"6727",183822,1991,1,0,"BLOOMFIELD COLLEGE",NA,NA,267,179,88,18,6,12,0.067,0.067,0.068,7450,67
"6728",183822,1992,1,0,"BLOOMFIELD COLLEGE",NA,NA,266,170,96,15,6,9,0.053,0.056,0.062,7750,66
"6729",183822,1993,1,0,"BLOOMFIELD COLLEGE",NA,NA,270,192,78,20,5,15,0.078,0.074,0.064,8050,78
"6730",183822,1995,1,0,"BLOOMFIELD COLLEGE",NA,NA,275,196,79,40,11,29,0.148,0.145,0.139,8850,63
"6731",183822,1996,1,0,"BLOOMFIELD COLLEGE",NA,NA,227,150,77,36,6,30,0.2,0.159,0.078,9100,41
"6732",183822,1997,1,0,"BLOOMFIELD COLLEGE",NA,NA,312,213,99,26,8,18,0.084,0.083,0.081,9500,52
"6733",183822,1998,1,0,"BLOOMFIELD COLLEGE",NA,NA,247,170,77,25,7,18,0.106,0.101,0.091,9900,20
"6734",183822,1999,1,0,"BLOOMFIELD COLLEGE",NA,NA,242,155,87,13,4,9,0.058,0.054,0.046,10300,28
"6735",183822,2000,1,0,"BLOOMFIELD COLLEGE",NA,NA,236,135,101,13,8,5,0.037,0.055,0.079,10800,25
"6736",183822,2001,1,0,"BLOOMFIELD COLLEGE",NA,NA,250,150,100,41,16,25,0.167,0.164,0.16,11300,47
"6737",183822,2002,1,0,"BLOOMFIELD COLLEGE",NA,NA,339,216,123,57,15,42,0.194,0.168,0.122,12100,42
"6738",183822,2003,1,0,"BLOOMFIELD COLLEGE",NA,NA,341,215,126,39,6,33,0.154,0.114,0.048,12900,44
"6739",183822,2004,1,0,"BLOOMFIELD COLLEGE",NA,NA,361,233,128,32,14,18,0.077,0.089,0.109,13700,53
"6740",183822,2005,1,0,"Bloomfield College",NA,NA,367,210,157,37,15,22,0.105,0.101,0.096,14850,60
"6741",183822,2006,1,0,"Bloomfield College",NA,NA,316,183,133,47,18,29,0.158,0.149,0.135,16100,49
"6742",183822,2007,1,0,"Bloomfield College",NA,NA,313,176,137,45,24,21,0.119,0.144,0.175,17500,47
"6743",183822,2008,1,0,"Bloomfield College",NA,NA,392,237,155,23,10,13,0.055,0.059,0.065,19080,46
"6744",183822,2009,1,0,"Bloomfield College",NA,NA,439,278,161,32,16,16,0.058,0.073,0.099,20000,38
"6745",183822,2010,1,0,"Bloomfield College",NA,NA,379,225,154,44,22,22,0.098,0.116,0.143,21200,33
"6746",183974,1991,1,0,"CENTENARY COLLEGE",NA,NA,89,66,23,22,3,19,0.288,0.247,0.13,10300,52
"6747",183974,1992,1,0,"CENTENARY COLLEGE",NA,NA,113,86,27,19,4,15,0.174,0.168,0.148,10911,68
"6748",183974,1993,1,0,"CENTENARY COLLEGE",NA,NA,95,77,18,20,2,18,0.234,0.211,0.111,11600,50
"6749",183974,1995,1,0,"CENTENARY COLLEGE",NA,NA,73,53,20,19,3,16,0.302,0.26,0.15,12104,46
"6750",183974,1996,1,0,"CENTENARY COLLEGE",NA,NA,86,63,23,21,0,21,0.333,0.244,0,12608,42
"6751",183974,1997,1,0,"CENTENARY COLLEGE",NA,NA,104,65,39,24,8,16,0.246,0.231,0.205,13120,24
"6752",183974,1998,1,0,"CENTENARY COLLEGE",NA,NA,124,77,47,26,8,18,0.234,0.21,0.17,13730,41
"6753",183974,1999,1,0,"CENTENARY COLLEGE",NA,NA,136,98,38,58,17,41,0.418,0.426,0.447,13800,69
"6754",183974,2000,1,0,"CENTENARY COLLEGE",NA,NA,145,114,31,56,7,49,0.43,0.386,0.226,14500,96
"6755",183974,2001,1,0,"CENTENARY COLLEGE",NA,NA,195,141,54,57,6,51,0.362,0.292,0.111,15100,120
"6756",183974,2002,1,0,"CENTENARY COLLEGE",NA,NA,236,147,89,97,27,70,0.476,0.411,0.303,15700,165
"6757",183974,2003,1,0,"CENTENARY COLLEGE",NA,NA,221,126,95,112,47,65,0.516,0.507,0.495,17100,147
"6758",183974,2004,1,0,"CENTENARY COLLEGE",NA,NA,258,169,89,123,38,85,0.503,0.477,0.427,18450,170
"6759",183974,2005,1,0,"Centenary College",NA,NA,240,160,80,115,35,80,0.5,0.479,0.438,19840,172
"6760",183974,2006,1,0,"Centenary College",NA,NA,303,211,92,147,41,106,0.502,0.485,0.446,21230,211
"6761",183974,2007,1,0,"Centenary College",NA,NA,275,175,100,154,54,100,0.571,0.56,0.54,22930,204
"6762",183974,2008,1,0,"Centenary College",NA,NA,310,196,114,188,63,125,0.638,0.606,0.553,23900,227
"6763",183974,2009,1,0,"Centenary College",NA,NA,270,165,105,156,50,106,0.642,0.578,0.476,25334,186
"6764",183974,2010,1,0,"Centenary College",NA,NA,252,144,108,115,35,80,0.556,0.456,0.324,26854,161
"6765",184348,1991,1,0,"DREW UNIVERSITY",NA,NA,269,166,103,188,70,118,0.711,0.699,0.68,16424,184
"6766",184348,1992,1,0,"DREW UNIVERSITY",NA,NA,332,203,129,246,92,154,0.759,0.741,0.713,17294,244
"6767",184348,1993,1,0,"DREW UNIVERSITY",NA,NA,312,190,122,226,84,142,0.747,0.724,0.689,18058,224
"6768",184348,1995,1,0,"DREW UNIVERSITY",NA,NA,433,255,178,312,122,190,0.745,0.721,0.685,19642,291
"6769",184348,1996,1,0,"DREW UNIVERSITY",NA,NA,371,203,168,265,118,147,0.724,0.714,0.702,20402,240
"6770",184348,1997,1,0,"DREW UNIVERSITY",NA,NA,418,243,175,294,117,177,0.728,0.703,0.669,21396,300
"6771",184348,1998,1,0,"DREW UNIVERSITY",NA,NA,337,213,124,226,84,142,0.667,0.671,0.677,22232,224
"6772",184348,1999,1,0,"DREW UNIVERSITY",NA,NA,407,225,182,279,118,161,0.716,0.686,0.648,22462,249
"6773",184348,2000,1,0,"DREW UNIVERSITY",NA,NA,419,265,154,291,98,193,0.728,0.695,0.636,23472,283
"6774",184348,2001,1,0,"DREW UNIVERSITY",NA,NA,395,254,141,261,89,172,0.677,0.661,0.631,24576,251
"6775",184348,2002,1,0,"DREW UNIVERSITY",NA,NA,396,231,165,281,110,171,0.74,0.71,0.667,25800,248
"6776",184348,2003,1,0,"DREW UNIVERSITY",NA,NA,419,247,172,289,109,180,0.729,0.69,0.634,27360,276
"6777",184348,2004,1,0,"DREW UNIVERSITY",NA,NA,418,243,175,264,98,166,0.683,0.632,0.56,29000,290
"6778",184348,2005,1,0,"Drew University",NA,NA,391,218,173,240,103,137,0.628,0.614,0.595,30740,279
"6779",184348,2006,1,0,"Drew University",NA,NA,479,316,163,315,103,212,0.671,0.658,0.632,32508,298
"6780",184348,2007,1,0,"Drew University",NA,NA,452,268,184,293,107,186,0.694,0.648,0.582,34230,266
"6781",184348,2008,1,0,"Drew University",NA,NA,390,256,134,222,75,147,0.574,0.569,0.56,35910,229
"6782",184348,2009,1,0,"Drew University",NA,NA,505,296,209,317,114,203,0.686,0.628,0.545,37310,292
"6783",184348,2010,1,0,"Drew University",NA,NA,494,311,183,280,96,184,0.592,0.567,0.525,38766,260
"6784",184603,1991,1,0,"FAIRLEIGH DICKINSON UNIVERSITY (ALL CAMPUSES)",NA,NA,908,436,472,78,32,46,0.106,0.086,0.068,10460,445
"6785",184603,1992,1,0,"FAIRLEIGH DICKINSON UNIVERSITY (ALL CAMPUSES)",NA,NA,938,466,472,114,53,61,0.131,0.122,0.112,10483,455
"6786",184603,1993,1,0,"FAIRLEIGH DICKINSON UNIVERSITY-ALL CAMPUSES",NA,NA,860,422,438,128,46,82,0.194,0.149,0.105,11091,434
"6787",184603,1995,1,0,"FAIRLEIGH DICKINSON UNIVERSITY-ALL CAMPUSES",NA,NA,781,396,385,128,57,71,0.179,0.164,0.148,12370,452
"6788",184603,1996,1,0,"FAIRLEIGH DICKINSON UNIVERSITY-ALL CAMPUSES",NA,NA,915,494,421,187,76,111,0.225,0.204,0.181,13404,477
"6789",184603,1997,1,0,"FAIRLEIGH DICKINSON UNIVERSITY-ALL CAMPUSES",NA,NA,519,265,254,83,27,56,0.211,0.16,0.106,14126,179
"6790",184603,1998,1,0,"FAIRLEIGH DICKINSON UNIVERSITY-ALL CAMPUSES",NA,NA,566,307,259,90,30,60,0.195,0.159,0.116,14836,165
"6791",184603,1999,1,0,"FAIRLEIGH DICKINSON UNIVERSITY-ALL CAMPUSES",NA,NA,526,281,245,96,31,65,0.231,0.183,0.127,14732,161
"6792",184603,2000,1,0,"FAIRLEIGH DICKINSON UNIVERSITY-ALL CAMPUSES",NA,NA,535,300,235,79,32,47,0.157,0.148,0.136,16346,154
"6793",184603,2001,1,0,"FAIRLEIGH DICKINSON UNIVERSITY-ALL CAMPUSES",NA,NA,448,260,188,80,27,53,0.204,0.179,0.144,17474,116
"6794",184603,2002,1,0,"FAIRLEIGH DICKINSON UNIVERSITY-ALL CAMPUSES",NA,NA,474,281,193,87,34,53,0.189,0.184,0.176,18654,159
"6795",184603,2003,1,0,"FAIRLEIGH DICKINSON UNIVERSITY-METROPOLITAN CAMPUS",NA,NA,540,303,237,105,40,65,0.214,0.194,0.169,19854,189
"6796",184603,2004,1,0,"FAIRLEIGH DICKINSON UNIVERSITY-METROPOLITAN CAMPUS",NA,NA,504,282,222,150,61,89,0.316,0.298,0.275,21224,142
"6797",184603,2005,1,0,"Fairleigh Dickinson University-Metropolitan Campus",NA,NA,425,269,156,100,31,69,0.256,0.235,0.199,22604,149
"6798",184603,2006,1,0,"Fairleigh Dickinson University-Metropolitan Campus",NA,NA,452,254,198,119,37,82,0.323,0.263,0.187,24072,156
"6799",184603,2007,1,0,"Fairleigh Dickinson University-Metropolitan Campus",NA,NA,400,210,190,117,30,87,0.414,0.292,0.158,25624,131
"6800",184603,2008,1,0,"Fairleigh Dickinson University-Metropolitan Campus",NA,NA,461,276,185,126,39,87,0.315,0.273,0.211,27136,122
"6801",184603,2009,1,0,"Fairleigh Dickinson University-Metropolitan Campus",NA,NA,641,361,280,175,57,118,0.327,0.273,0.204,28194,129
"6802",184603,2010,1,0,"Fairleigh Dickinson University-Metropolitan Campus",NA,NA,694,400,294,133,48,85,0.212,0.192,0.163,30140,131
"6803",184612,1991,1,0,"FELICIAN COLLEGE",NA,NA,93,79,14,9,3,6,0.076,0.097,0.214,6970,49
"6804",184612,1992,1,0,"FELICIAN COLLEGE",NA,NA,116,103,13,16,1,15,0.146,0.138,0.077,7430,78
"6805",184612,1993,1,0,"FELICIAN COLLEGE",NA,NA,129,105,24,10,0,10,0.095,0.078,0,7765,82
"6806",184612,1995,1,0,"FELICIAN COLLEGE",NA,NA,87,70,17,18,9,9,0.129,0.207,0.529,8790,53
"6807",184612,1996,1,0,"FELICIAN COLLEGE",NA,NA,141,92,49,8,3,5,0.054,0.057,0.061,9502,87
"6808",184612,1997,1,0,"FELICIAN COLLEGE",NA,NA,112,94,18,9,0,9,0.096,0.08,0,10038,65
"6809",184612,1998,1,0,"FELICIAN COLLEGE",NA,NA,151,118,33,20,3,17,0.144,0.132,0.091,10542,70
"6810",184612,1999,1,0,"FELICIAN COLLEGE",NA,NA,224,140,84,7,7,0,0,0.031,0.083,10560,133
"6811",184612,2000,1,0,"FELICIAN COLLEGE",NA,NA,219,173,46,46,7,39,0.225,0.21,0.152,11010,129
"6812",184612,2001,1,0,"FELICIAN COLLEGE",NA,NA,272,188,84,46,9,37,0.197,0.169,0.107,11460,134
"6813",184612,2002,1,0,"FELICIAN COLLEGE",NA,NA,208,151,57,45,8,37,0.245,0.216,0.14,12450,94
"6814",184612,2003,1,0,"FELICIAN COLLEGE",NA,NA,218,158,60,33,10,23,0.146,0.151,0.167,14500,111
"6815",184612,2004,1,0,"FELICIAN COLLEGE",NA,NA,232,170,62,38,13,25,0.147,0.164,0.21,15900,114
"6816",184612,2005,1,0,"Felician College",NA,NA,236,163,73,38,13,25,0.153,0.161,0.178,17300,101
"6817",184612,2006,1,0,"Felician College",NA,NA,251,172,79,58,20,38,0.221,0.231,0.253,18900,93
"6818",184612,2007,1,0,"Felician College",NA,NA,294,213,81,72,18,54,0.254,0.245,0.222,20500,106
"6819",184612,2008,1,0,"Felician College",NA,NA,245,170,75,42,9,33,0.194,0.171,0.12,22200,90
"6820",184612,2009,1,0,"Felician College",NA,NA,251,172,79,46,17,29,0.169,0.183,0.215,23650,71
"6821",184612,2010,1,0,"Felician College",NA,NA,324,236,88,66,21,45,0.191,0.204,0.239,24950,90
"6822",184782,1991,1,0,"GLASSBORO STATE COLLEGE",NA,NA,892,511,381,212,77,135,0.264,0.238,0.202,2715,646
"6823",184782,1992,1,0,"ROWAN COLLEGE OF NEW JERSEY",NA,NA,771,453,318,154,46,108,0.238,0.2,0.145,2870,568
"6824",184782,1993,1,0,"ROWAN COLLEGE OF NEW JERSEY",NA,NA,713,408,305,152,43,109,0.267,0.213,0.141,2843,489
"6825",184782,1995,1,0,"ROWAN COLLEGE OF NEW JERSEY",NA,NA,927,516,411,226,69,157,0.304,0.244,0.168,3393,702
"6826",184782,1996,1,0,"ROWAN COLLEGE OF NEW JERSEY",NA,NA,1132,609,523,414,173,241,0.396,0.366,0.331,3750,931
"6827",184782,1997,1,0,"ROWAN UNIVERSITY",NA,NA,1038,552,486,321,119,202,0.366,0.309,0.245,4240,814
"6828",184782,1998,1,0,"ROWAN UNIVERSITY",NA,NA,1118,624,494,414,160,254,0.407,0.37,0.324,4550,868
"6829",184782,1999,1,0,"ROWAN UNIVERSITY",NA,NA,1119,587,532,436,183,253,0.431,0.39,0.344,3750,910
"6830",184782,2000,1,0,"ROWAN UNIVERSITY",NA,NA,1053,561,492,444,173,271,0.483,0.422,0.352,4140,819
"6831",184782,2001,1,0,"ROWAN UNIVERSITY",NA,NA,1276,680,596,498,201,297,0.437,0.39,0.337,4500,1021
"6832",184782,2002,1,0,"ROWAN UNIVERSITY",NA,NA,1257,637,620,542,224,318,0.499,0.431,0.361,4950,1019
"6833",184782,2003,1,0,"ROWAN UNIVERSITY",NA,NA,1243,600,643,588,265,323,0.538,0.473,0.412,5396,1032
"6834",184782,2004,1,0,"ROWAN UNIVERSITY",NA,NA,1247,622,625,546,255,291,0.468,0.438,0.408,5828,970
"6835",184782,2005,1,0,"Rowan University",NA,NA,1239,607,632,554,270,284,0.468,0.447,0.427,6294,987
"6836",184782,2006,1,0,"Rowan University",NA,NA,1216,602,614,593,271,322,0.535,0.488,0.441,6798,925
"6837",184782,2007,1,0,"Rowan University",NA,NA,1226,506,720,561,301,260,0.514,0.458,0.418,7308,1053
"6838",184782,2008,1,0,"Rowan University",NA,NA,1174,516,658,502,269,233,0.452,0.428,0.409,7840,965
"6839",184782,2009,1,0,"Rowan University",NA,NA,1586,738,848,677,344,333,0.451,0.427,0.406,8074,1209
"6840",184782,2010,1,0,"Rowan University",NA,NA,1485,715,770,713,320,393,0.55,0.48,0.416,8396,1110
"6841",185129,1991,1,0,"JERSEY CITY STATE COLLEGE",NA,NA,618,322,296,34,17,17,0.053,0.055,0.057,2422,264
"6842",185129,1992,1,0,"JERSEY CITY STATE COLLEGE",NA,NA,663,324,339,28,16,12,0.037,0.042,0.047,2678,294
"6843",185129,1993,1,0,"JERSEY CITY STATE COLLEGE",NA,NA,514,276,238,27,11,16,0.058,0.053,0.046,2798,254
"6844",185129,1995,1,0,"JERSEY CITY STATE COLLEGE",NA,NA,457,246,211,40,11,29,0.118,0.088,0.052,3157,193
"6845",185129,1996,1,0,"JERSEY CITY STATE COLLEGE",NA,NA,531,283,248,32,10,22,0.078,0.06,0.04,3528,196
"6846",185129,1997,1,0,"JERSEY CITY STATE COLLEGE",NA,NA,455,237,218,34,13,21,0.089,0.075,0.06,3828,184
"6847",185129,1998,1,0,"NEW JERSEY CITY COLLEGE",NA,NA,549,305,244,40,13,27,0.088,0.073,0.053,4113,203
"6848",185129,1999,1,0,"NEW JERSEY CITY UNIVERSITY",NA,NA,603,331,272,54,18,36,0.109,0.09,0.066,3330,239
"6849",185129,2000,1,0,"NEW JERSEY CITY UNIVERSITY",NA,NA,661,357,304,46,20,26,0.073,0.07,0.066,3540,271
"6850",185129,2001,1,0,"NEW JERSEY CITY UNIVERSITY",NA,NA,540,304,236,43,14,29,0.095,0.08,0.059,3810,176
"6851",185129,2002,1,0,"NEW JERSEY CITY UNIVERSITY",NA,NA,566,293,273,34,9,25,0.085,0.06,0.033,4185,199
"6852",185129,2003,1,0,"NEW JERSEY CITY UNIVERSITY",NA,NA,652,380,272,49,15,34,0.09,0.075,0.055,4560,215
"6853",185129,2004,1,0,"NEW JERSEY CITY UNIVERSITY",NA,NA,512,300,212,40,12,28,0.093,0.078,0.057,4860,145
"6854",185129,2005,1,0,"New Jersey City University",NA,NA,601,334,267,39,17,22,0.066,0.065,0.064,5190,179
"6855",185129,2006,1,0,"New Jersey City University",NA,NA,646,379,267,45,13,32,0.084,0.07,0.049,5600,156
"6856",185129,2007,1,0,"New Jersey City University",NA,NA,649,340,309,32,16,16,0.047,0.049,0.052,5936,143
"6857",185129,2008,1,0,"New Jersey City University",NA,NA,563,306,257,42,19,23,0.075,0.075,0.074,6352,113
"6858",185129,2009,1,0,"New Jersey City University",NA,NA,634,358,276,32,12,20,0.056,0.05,0.043,6542,152
"6859",185129,2010,1,0,"New Jersey City University",NA,NA,681,380,301,45,21,24,0.063,0.066,0.07,6804,145
"6860",185572,1991,1,0,"MONMOUTH COLLEGE",NA,NA,387,216,171,74,23,51,0.236,0.191,0.135,10700,336
"6861",185572,1992,1,0,"MONMOUTH COLLEGE",NA,NA,436,230,206,94,39,55,0.239,0.216,0.189,11160,360
"6862",185572,1993,1,0,"MONMOUTH COLLEGE",NA,NA,477,220,257,94,43,51,0.232,0.197,0.167,11820,382
"6863",185572,1995,1,0,"MONMOUTH UNIVERSITY",NA,NA,764,412,352,234,82,152,0.369,0.306,0.233,13140,634
"6864",185572,1996,1,0,"MONMOUTH UNIVERSITY",NA,NA,799,411,388,261,99,162,0.394,0.327,0.255,13800,653
"6865",185572,1997,1,0,"MONMOUTH UNIVERSITY",NA,NA,801,432,369,264,87,177,0.41,0.33,0.236,14442,640
"6866",185572,1998,1,0,"MONMOUTH UNIVERSITY",NA,NA,834,429,405,253,98,155,0.361,0.303,0.242,15068,661
"6867",185572,1999,1,0,"MONMOUTH UNIVERSITY",NA,NA,833,457,376,295,99,196,0.429,0.354,0.263,15138,644
"6868",185572,2000,1,0,"MONMOUTH UNIVERSITY",NA,NA,1033,529,504,377,142,235,0.444,0.365,0.282,15758,863
"6869",185572,2001,1,0,"MONMOUTH UNIVERSITY",NA,NA,881,484,397,339,125,214,0.442,0.385,0.315,16506,708
"6870",185572,2002,1,0,"MONMOUTH UNIVERSITY",NA,NA,948,521,427,351,116,235,0.451,0.37,0.272,17332,788
"6871",185572,2003,1,0,"MONMOUTH UNIVERSITY",NA,NA,904,484,420,358,125,233,0.481,0.396,0.298,18198,757
"6872",185572,2004,1,0,"MONMOUTH UNIVERSITY",NA,NA,946,514,432,341,120,221,0.43,0.36,0.278,19108,727
"6873",185572,2005,1,0,"Monmouth University",NA,NA,942,503,439,436,176,260,0.517,0.463,0.401,20064,738
"6874",185572,2006,1,0,"Monmouth University",NA,NA,959,535,424,425,168,257,0.48,0.443,0.396,21248,747
"6875",185572,2007,1,0,"Monmouth University",NA,NA,944,538,406,393,165,228,0.424,0.416,0.406,22406,753
"6876",185572,2008,1,0,"Monmouth University",NA,NA,960,549,411,473,187,286,0.521,0.493,0.455,23470,795
"6877",185572,2009,1,0,"Monmouth University",NA,NA,998,581,417,504,191,313,0.539,0.505,0.458,24386,818
"6878",185572,2010,1,0,"Monmouth University",NA,NA,962,579,383,532,196,336,0.58,0.553,0.512,25728,764
"6879",185590,1991,1,0,"MONTCLAIR STATE COLLEGE",NA,NA,913,564,349,101,31,70,0.124,0.111,0.089,2612,544
"6880",185590,1992,1,0,"MONTCLAIR STATE COLLEGE",NA,NA,913,530,383,106,32,74,0.14,0.116,0.084,2686,560
"6881",185590,1993,1,0,"MONTCLAIR STATE COLLEGE",NA,NA,868,531,337,117,34,83,0.156,0.135,0.101,2844,523
"6882",185590,1995,1,0,"MONTCLAIR STATE UNIVERSITY",NA,NA,1068,651,417,216,69,147,0.226,0.202,0.165,3162,662
"6883",185590,1996,1,0,"MONTCLAIR STATE UNIVERSITY",NA,NA,1194,706,488,243,64,179,0.254,0.204,0.131,3466,746
"6884",185590,1997,1,0,"MONTCLAIR STATE UNIVERSITY",NA,NA,1148,709,439,230,62,168,0.237,0.2,0.141,3738,648
"6885",185590,1998,1,0,"MONTCLAIR STATE UNIVERSITY",NA,NA,1106,660,446,252,60,192,0.291,0.228,0.135,4120,637
"6886",185590,1999,1,0,"MONTCLAIR STATE UNIVERSITY",NA,NA,1319,823,496,308,81,227,0.276,0.234,0.163,3154,747
"6887",185590,2000,1,0,"MONTCLAIR STATE UNIVERSITY",NA,NA,1324,827,497,351,96,255,0.308,0.265,0.193,3470,776
"6888",185590,2001,1,0,"MONTCLAIR STATE UNIVERSITY",NA,NA,1378,826,552,371,102,269,0.326,0.269,0.185,4071,785
"6889",185590,2002,1,0,"MONTCLAIR STATE UNIVERSITY",NA,NA,1470,881,589,410,117,293,0.333,0.279,0.199,4390,925
"6890",185590,2003,1,0,"MONTCLAIR STATE UNIVERSITY",NA,NA,1594,934,660,471,134,337,0.361,0.295,0.203,4785,972
"6891",185590,2004,1,0,"MONTCLAIR STATE UNIVERSITY",NA,NA,1737,1015,722,534,164,370,0.365,0.307,0.227,5168,1056
"6892",185590,2005,1,0,"Montclair State University",NA,NA,1868,1065,803,635,188,447,0.42,0.34,0.234,5581,1146
"6893",185590,2006,1,0,"Montclair State University",NA,NA,2018,1197,821,702,214,488,0.408,0.348,0.261,6028,1261
"6894",185590,2007,1,0,"Montclair State University",NA,NA,2068,1276,792,711,205,506,0.397,0.344,0.259,6390,1174
"6895",185590,2008,1,0,"Montclair State University",NA,NA,2257,1365,892,817,230,587,0.43,0.362,0.258,6836,1190
"6896",185590,2009,1,0,"Montclair State University",NA,NA,2100,1284,816,757,219,538,0.419,0.36,0.268,7042,1069
"6897",185590,2010,1,0,"Montclair State University",NA,NA,2169,1248,921,850,304,546,0.438,0.392,0.33,7324,1079
"6898",185828,1991,1,0,"NEW JERSEY INSTITUTE OF TECHNOLOGY",NA,NA,541,96,445,30,18,12,0.125,0.055,0.04,4288,236
"6899",185828,1992,1,0,"NEW JERSEY INSTITUTE OF TECHNOLOGY",NA,NA,501,75,426,34,25,9,0.12,0.068,0.059,4524,247
"6900",185828,1993,1,0,"NEW JERSEY INSTITUTE OF TECHNOLOGY",NA,NA,476,90,386,33,22,11,0.122,0.069,0.057,4790,226
"6901",185828,1995,1,0,"NEW JERSEY INSTITUTE OF TECHNOLOGY",NA,NA,552,131,421,60,35,25,0.191,0.109,0.083,5220,263
"6902",185828,1996,1,0,"NEW JERSEY INSTITUTE OF TECHNOLOGY",NA,NA,599,116,483,60,39,21,0.181,0.1,0.081,5466,295
"6903",185828,1997,1,0,"NEW JERSEY INSTITUTE OF TECHNOLOGY",NA,NA,568,105,463,88,73,15,0.143,0.155,0.158,5802,276
"6904",185828,1998,1,0,"NEW JERSEY INSTITUTE OF TECHNOLOGY",NA,NA,563,120,443,93,64,29,0.242,0.165,0.144,6214,254
"6905",185828,1999,1,0,"NEW JERSEY INSTITUTE OF TECHNOLOGY",NA,NA,649,114,535,116,88,28,0.246,0.179,0.164,5508,261
"6906",185828,2000,1,0,"NEW JERSEY INSTITUTE OF TECHNOLOGY",NA,NA,685,117,568,130,98,32,0.274,0.19,0.173,5758,285
"6907",185828,2001,1,0,"NEW JERSEY INSTITUTE OF TECHNOLOGY",NA,NA,706,129,577,102,70,32,0.248,0.144,0.121,6158,297
"6908",185828,2002,1,0,"NEW JERSEY INSTITUTE OF TECHNOLOGY",NA,NA,658,113,545,106,81,25,0.221,0.161,0.149,6758,249
"6909",185828,2003,1,0,"NEW JERSEY INSTITUTE OF TECHNOLOGY",NA,NA,685,119,566,118,92,26,0.219,0.172,0.163,7332,283
"6910",185828,2004,1,0,"NEW JERSEY INSTITUTE OF TECHNOLOGY",NA,NA,663,130,533,108,74,34,0.262,0.163,0.139,7918,263
"6911",185828,2005,1,0,"New Jersey Institute of Technology",NA,NA,746,129,617,126,101,25,0.194,0.169,0.164,8472,295
"6912",185828,2006,1,0,"New Jersey Institute of Technology",NA,NA,795,146,649,150,102,48,0.329,0.189,0.157,9066,324
"6913",185828,2007,1,0,"New Jersey Institute of Technology",NA,NA,730,148,582,171,117,54,0.365,0.234,0.201,9700,300
"6914",185828,2008,1,0,"New Jersey Institute of Technology",NA,NA,779,158,621,185,136,49,0.31,0.237,0.219,10500,326
"6915",185828,2009,1,0,"New Jersey Institute of Technology",NA,NA,899,169,730,212,151,61,0.361,0.236,0.207,10816,370
"6916",185828,2010,1,0,"New Jersey Institute of Technology",NA,NA,828,187,641,209,141,68,0.364,0.252,0.22,11248,200
"6917",186131,1991,1,0,"PRINCETON UNIVERSITY",NA,NA,1122,474,648,1002,582,420,0.886,0.893,0.898,16570,794
"6918",186131,1992,1,0,"PRINCETON UNIVERSITY",NA,NA,1135,516,619,1023,544,479,0.928,0.901,0.879,17750,842
"6919",186131,1993,1,0,"PRINCETON UNIVERSITY",NA,NA,1152,514,638,1032,563,469,0.912,0.896,0.882,18940,816
"6920",186131,1995,1,0,"PRINCETON UNIVERSITY",NA,NA,1207,569,638,1105,579,526,0.924,0.915,0.908,20960,800
"6921",186131,1996,1,0,"PRINCETON UNIVERSITY",NA,NA,1123,525,598,1032,540,492,0.937,0.919,0.903,22000,747
"6922",186131,1997,1,0,"PRINCETON UNIVERSITY",NA,NA,1129,511,618,1033,562,471,0.922,0.915,0.909,22920,798
"6923",186131,1998,1,0,"PRINCETON UNIVERSITY",NA,NA,1167,560,607,1000,495,505,0.902,0.857,0.815,23820,788
"6924",186131,1999,1,0,"PRINCETON UNIVERSITY",NA,NA,1148,556,592,1030,530,500,0.899,0.897,0.895,24630,790
"6925",186131,2000,1,0,"PRINCETON UNIVERSITY",NA,NA,1159,569,590,1031,503,528,0.928,0.89,0.853,25430,757
"6926",186131,2001,1,0,"PRINCETON UNIVERSITY",NA,NA,1184,570,614,1051,526,525,0.921,0.888,0.857,26160,757
"6927",186131,2002,1,0,"PRINCETON UNIVERSITY",NA,NA,1164,557,607,1049,542,507,0.91,0.901,0.893,27230,737
"6928",186131,2003,1,0,"PRINCETON UNIVERSITY",NA,NA,1161,539,622,1044,549,495,0.918,0.899,0.883,28540,734
"6929",186131,2004,1,0,"PRINCETON UNIVERSITY",NA,NA,1170,548,622,1054,549,505,0.922,0.901,0.883,29910,729
"6930",186131,2005,1,0,"Princeton University",NA,NA,1224,558,666,1066,562,504,0.903,0.871,0.844,31450,709
"6931",186131,2006,1,0,"Princeton University",NA,NA,1228,576,652,1078,561,517,0.898,0.878,0.86,33000,603
"6932",186131,2007,1,0,"Princeton University",NA,NA,1243,593,650,1091,553,538,0.907,0.878,0.851,33000,592
"6933",186131,2008,1,0,"Princeton University",NA,NA,1243,620,623,1121,545,576,0.929,0.902,0.875,34290,610
"6934",186131,2009,1,0,"Princeton University",NA,NA,1297,643,654,1164,568,596,0.927,0.897,0.869,35340,635
"6935",186131,2010,1,0,"Princeton University",NA,NA,1311,649,662,1169,572,597,0.92,0.892,0.864,36640,653
"6936",186201,1991,1,0,"RAMAPO COLLEGE OF NEW JERSEY",NA,NA,423,205,218,55,17,38,0.185,0.13,0.078,2893,279
"6937",186201,1992,1,0,"RAMAPO COLLEGE OF NEW JERSEY",NA,NA,419,216,203,77,25,52,0.241,0.184,0.123,3024,290
"6938",186201,1993,1,0,"RAMAPO COLLEGE OF NEW JERSEY",NA,NA,361,199,162,62,21,41,0.206,0.172,0.13,3226,235
"6939",186201,1995,1,0,"RAMAPO COLLEGE OF NEW JERSEY",NA,NA,319,190,129,67,20,47,0.247,0.21,0.155,3521,190
"6940",186201,1996,1,0,"RAMAPO COLLEGE OF NEW JERSEY",NA,NA,413,240,173,101,29,72,0.3,0.245,0.168,3872,273
"6941",186201,1997,1,0,"RAMAPO COLLEGE OF NEW JERSEY",NA,NA,453,228,225,125,53,72,0.316,0.276,0.236,4206,331
"6942",186201,1998,1,0,"RAMAPO COLLEGE OF NEW JERSEY",NA,NA,472,271,201,169,56,113,0.417,0.358,0.279,4616,343
"6943",186201,1999,1,0,"RAMAPO COLLEGE OF NEW JERSEY",NA,NA,527,293,234,201,66,135,0.461,0.381,0.282,3822,380
"6944",186201,2000,1,0,"RAMAPO COLLEGE OF NEW JERSEY",NA,NA,636,392,244,282,87,195,0.497,0.443,0.357,4166,496
"6945",186201,2001,1,0,"RAMAPO COLLEGE OF NEW JERSEY",NA,NA,628,382,246,303,99,204,0.534,0.482,0.402,4416,474
"6946",186201,2002,1,0,"RAMAPO COLLEGE OF NEW JERSEY",NA,NA,684,420,264,363,109,254,0.605,0.531,0.413,4836,522
"6947",186201,2003,1,0,"RAMAPO COLLEGE OF NEW JERSEY",NA,NA,719,423,296,439,165,274,0.648,0.611,0.557,5270,570
"6948",186201,2004,1,0,"RAMAPO COLLEGE OF NEW JERSEY",NA,NA,746,451,295,486,165,321,0.712,0.651,0.559,5640,580
"6949",186201,2005,1,0,"Ramapo College of New Jersey",NA,NA,746,460,286,445,137,308,0.67,0.597,0.479,6091,564
"6950",186201,2006,1,0,"Ramapo College of New Jersey",NA,NA,811,475,336,488,182,306,0.644,0.602,0.542,6579,591
"6951",186201,2007,1,0,"Ramapo College of New Jersey",NA,NA,898,519,379,527,181,346,0.667,0.587,0.478,6904,694
"6952",186201,2008,1,0,"Ramapo College of New Jersey",NA,NA,877,513,364,511,177,334,0.651,0.583,0.486,7459,662
"6953",186201,2009,1,0,"Ramapo College of New Jersey",NA,NA,933,575,358,559,165,394,0.685,0.599,0.461,7683,702
"6954",186201,2010,1,0,"Ramapo College of New Jersey",NA,NA,893,522,371,547,188,359,0.688,0.613,0.507,7805,674
"6955",186283,1991,1,0,"RIDER COLLEGE",NA,NA,653,351,302,259,98,161,0.459,0.397,0.325,11010,516
"6956",186283,1992,1,0,"RIDER COLLEGE",NA,NA,731,402,329,305,113,192,0.478,0.417,0.343,12010,577
"6957",186283,1993,1,0,"RIDER COLLEGE",NA,NA,663,376,287,267,104,163,0.434,0.403,0.362,12860,515
"6958",186283,1995,1,0,"RIDER UNIVERSITY",NA,NA,612,329,283,242,103,139,0.422,0.395,0.364,13800,465
"6959",186283,1996,1,0,"RIDER UNIVERSITY",NA,NA,678,394,284,311,113,198,0.503,0.459,0.398,14400,504
"6960",186283,1997,1,0,"RIDER UNIVERSITY",NA,NA,751,435,316,340,135,205,0.471,0.453,0.427,15120,577
"6961",186283,1998,1,0,"RIDER UNIVERSITY",NA,NA,869,483,386,419,161,258,0.534,0.482,0.417,15880,666
"6962",186283,1999,1,0,"RIDER UNIVERSITY",NA,NA,735,386,349,310,128,182,0.472,0.422,0.367,16520,560
"6963",186283,2000,1,0,"RIDER UNIVERSITY",NA,NA,884,504,380,399,152,247,0.49,0.451,0.4,17180,680
"6964",186283,2001,1,0,"RIDER UNIVERSITY",NA,NA,839,472,367,361,143,218,0.462,0.43,0.39,17990,600
"6965",186283,2002,1,0,"RIDER UNIVERSITY",NA,NA,958,542,416,439,173,266,0.491,0.458,0.416,19240,754
"6966",186283,2003,1,0,"RIDER UNIVERSITY",NA,NA,944,575,369,443,154,289,0.503,0.469,0.417,20590,735
"6967",186283,2004,1,0,"RIDER UNIVERSITY",NA,NA,890,514,376,456,190,266,0.517,0.512,0.505,21820,663
"6968",186283,2005,1,0,"Rider University",NA,NA,934,526,408,482,183,299,0.568,0.516,0.449,22910,727
"6969",186283,2006,1,0,"Rider University",NA,NA,1016,619,397,576,206,370,0.598,0.567,0.519,24220,799
"6970",186283,2007,1,0,"Rider University",NA,NA,990,569,421,547,201,346,0.608,0.553,0.477,25650,750
"6971",186283,2008,1,0,"Rider University",NA,NA,875,516,359,460,167,293,0.568,0.526,0.465,27140,608
"6972",186283,2009,1,0,"Rider University",NA,NA,1027,611,416,557,216,341,0.558,0.542,0.519,28470,678
"6973",186283,2010,1,0,"Rider University",NA,NA,1007,601,406,585,227,358,0.596,0.581,0.559,29870,744
"6974",186584,1991,1,0,"SETON HALL UNIVERSITY",NA,NA,984,474,510,429,184,245,0.517,0.436,0.361,10450,668
"6975",186584,1992,1,0,"SETON HALL UNIVERSITY",NA,NA,985,484,501,384,161,223,0.461,0.39,0.321,10960,649
"6976",186584,1993,1,0,"SETON HALL UNIVERSITY",NA,NA,996,522,474,376,142,234,0.448,0.378,0.3,11380,650
"6977",186584,1995,1,0,"SETON HALL UNIVERSITY",NA,NA,955,527,428,371,145,226,0.429,0.388,0.339,12250,561
"6978",186584,1996,1,0,"SETON HALL UNIVERSITY",NA,NA,968,547,421,349,112,237,0.433,0.361,0.266,12850,548
"6979",186584,1997,1,0,"SETON HALL UNIVERSITY",NA,NA,1056,547,509,409,157,252,0.461,0.387,0.308,13600,627
"6980",186584,1998,1,0,"SETON HALL UNIVERSITY",NA,NA,1221,657,564,486,173,313,0.476,0.398,0.307,15680,694
"6981",186584,1999,1,0,"SETON HALL UNIVERSITY",NA,NA,1063,533,530,437,190,247,0.463,0.411,0.358,15480,588
"6982",186584,2000,1,0,"SETON HALL UNIVERSITY",NA,NA,1121,581,540,464,186,278,0.479,0.414,0.344,16410,537
"6983",186584,2001,1,0,"SETON HALL UNIVERSITY",NA,NA,1182,601,581,495,210,285,0.474,0.419,0.361,17400,636
"6984",186584,2002,1,0,"SETON HALL UNIVERSITY",NA,NA,1157,607,550,523,232,291,0.479,0.452,0.422,18780,620
"6985",186584,2003,1,0,"SETON HALL UNIVERSITY",NA,NA,1241,616,625,620,301,319,0.518,0.5,0.482,19530,716
"6986",186584,2004,1,0,"SETON HALL UNIVERSITY",NA,NA,1234,672,562,626,269,357,0.531,0.507,0.479,20490,667
"6987",186584,2005,1,0,"Seton Hall University",NA,NA,1115,582,533,576,236,340,0.584,0.517,0.443,21510,626
"6988",186584,2006,1,0,"Seton Hall University",NA,NA,1054,602,452,574,231,343,0.57,0.545,0.511,22770,547
"6989",186584,2007,1,0,"Seton Hall University",NA,NA,1256,664,592,631,277,354,0.533,0.502,0.468,25900,727
"6990",186584,2008,1,0,"Seton Hall University",NA,NA,1216,688,528,687,282,405,0.589,0.565,0.534,27680,705
"6991",186584,2009,1,0,"Seton Hall University",NA,NA,1124,659,465,570,232,338,0.513,0.507,0.499,28520,580
"6992",186584,2010,1,0,"Seton Hall University",NA,NA,1302,728,574,708,288,420,0.577,0.544,0.502,29940,704
"6993",186876,1991,1,0,"STOCKTON STATE COLLEGE",NA,NA,683,364,319,194,64,130,0.357,0.284,0.201,2456,526
"6994",186876,1992,1,0,"STOCKTON STATE COLLEGE",NA,NA,720,401,319,174,70,104,0.259,0.242,0.219,2657,598
"6995",186876,1993,1,0,"THE RICHARD STOCKTON COLLEGE OF NEW JERSEY",NA,NA,709,369,340,193,77,116,0.314,0.272,0.226,2880,576
"6996",186876,1995,1,0,"THE RICHARD STOCKTON COLLEGE OF NEW JERSEY",NA,NA,726,438,288,258,86,172,0.393,0.355,0.299,3152,605
"6997",186876,1996,1,0,"THE RICHARD STOCKTON COLLEGE OF NEW JERSEY",NA,NA,705,404,301,278,110,168,0.416,0.394,0.365,3472,555
"6998",186876,1997,1,0,"THE RICHARD STOCKTON COLLEGE OF NEW JERSEY",NA,NA,700,415,285,283,93,190,0.458,0.404,0.326,3776,555
"6999",186876,1998,1,0,"THE RICHARD STOCKTON COLLEGE OF NEW JERSEY",NA,NA,744,420,324,321,116,205,0.488,0.431,0.358,4144,593
"7000",186876,1999,1,0,"THE RICHARD STOCKTON COLLEGE OF NEW JERSEY",NA,NA,705,409,296,254,86,168,0.411,0.36,0.291,3280,547
"7001",186876,2000,1,0,"THE RICHARD STOCKTON COLLEGE OF NEW JERSEY",NA,NA,728,431,297,296,96,200,0.464,0.407,0.323,3600,589
"7002",186876,2001,1,0,"THE RICHARD STOCKTON COLLEGE OF NEW JERSEY",NA,NA,751,424,327,335,122,213,0.502,0.446,0.373,3952,612
"7003",186876,2002,1,0,"THE RICHARD STOCKTON COLLEGE OF NEW JERSEY",NA,NA,794,436,358,338,131,207,0.475,0.426,0.366,4352,674
"7004",186876,2003,1,0,"THE RICHARD STOCKTON COLLEGE OF NEW JERSEY",NA,NA,816,439,377,319,119,200,0.456,0.391,0.316,4736,698
"7005",186876,2004,1,0,"THE RICHARD STOCKTON COLLEGE OF NEW JERSEY",NA,NA,819,435,384,331,127,204,0.469,0.404,0.331,5091,686
"7006",186876,2005,1,0,"The Richard Stockton College of New Jersey",NA,NA,808,460,348,346,104,242,0.526,0.428,0.299,5498,653
"7007",186876,2006,1,0,"The Richard Stockton College of New Jersey",NA,NA,791,425,366,319,123,196,0.461,0.403,0.336,5938,631
"7008",186876,2007,1,0,"The Richard Stockton College of New Jersey",NA,NA,794,480,314,335,93,242,0.504,0.422,0.296,6353,613
"7009",186876,2008,1,0,"The Richard Stockton College of New Jersey",NA,NA,840,458,382,425,156,269,0.587,0.506,0.408,6861,641
"7010",186876,2009,1,0,"The Richard Stockton College of New Jersey",NA,NA,865,483,382,459,175,284,0.588,0.531,0.458,7067,646
"7011",186876,2010,1,0,"The Richard Stockton College of New Jersey",NA,NA,858,518,340,433,137,296,0.571,0.505,0.403,7349,651
"7012",187134,1991,1,0,"TRENTON STATE COLLEGE",NA,NA,860,560,300,445,108,337,0.602,0.517,0.36,3079,684
"7013",187134,1992,1,0,"TRENTON STATE COLLEGE",NA,NA,1068,712,356,628,174,454,0.638,0.588,0.489,3761,847
"7014",187134,1993,1,0,"TRENTON STATE COLLEGE",NA,NA,1064,628,436,576,186,390,0.621,0.541,0.427,3857,792
"7015",187134,1995,1,0,"THE COLLEGE OF NEW JERSEY",NA,NA,1087,670,417,638,212,426,0.636,0.587,0.508,4241,777
"7016",187134,1996,1,0,"THE COLLEGE OF NEW JERSEY",NA,NA,1009,675,334,648,187,461,0.683,0.642,0.56,4522,714
"7017",187134,1997,1,0,"THE COLLEGE OF NEW JERSEY",NA,NA,1396,847,549,870,305,565,0.667,0.623,0.556,4843,1037
"7018",187134,1998,1,0,"THE COLLEGE OF NEW JERSEY",NA,NA,1206,714,492,760,278,482,0.675,0.63,0.565,5318,846
"7019",187134,1999,1,0,"THE COLLEGE OF NEW JERSEY",NA,NA,1207,697,510,776,281,495,0.71,0.643,0.551,4445,901
"7020",187134,2000,1,0,"THE COLLEGE OF NEW JERSEY",NA,NA,1205,714,491,799,287,512,0.717,0.663,0.585,4654,927
"7021",187134,2001,1,0,"THE COLLEGE OF NEW JERSEY",NA,NA,1258,750,508,852,302,550,0.733,0.677,0.594,5022,988
"7022",187134,2002,1,0,"THE COLLEGE OF NEW JERSEY",NA,NA,1231,738,493,834,288,546,0.74,0.677,0.584,5625,914
"7023",187134,2003,1,0,"THE COLLEGE OF NEW JERSEY",NA,NA,1176,679,497,855,327,528,0.778,0.727,0.658,6131,898
"7024",187134,2004,1,0,"THE COLLEGE OF NEW JERSEY",NA,NA,1230,681,549,876,357,519,0.762,0.712,0.65,6621,941
"7025",187134,2005,1,0,"The College of New Jersey",NA,NA,1236,685,551,914,383,531,0.775,0.739,0.695,7051,917
"7026",187134,2006,1,0,"The College of New Jersey",NA,NA,1270,756,514,919,339,580,0.767,0.724,0.66,7615,817
"7027",187134,2007,1,0,"The College of New Jersey",NA,NA,1297,774,523,940,334,606,0.783,0.725,0.639,8072,852
"7028",187134,2008,1,0,"The College of New Jersey",NA,NA,1295,763,532,939,356,583,0.764,0.725,0.669,8718,815
"7029",187134,2009,1,0,"The College of New Jersey",NA,NA,1283,718,565,918,366,552,0.769,0.716,0.648,8980,828
"7030",187134,2010,1,0,"The College of New Jersey",NA,NA,1421,800,621,1065,443,622,0.777,0.749,0.713,9340,944
"7031",187444,1991,1,0,"WILLIAM PATERSON COLLEGE OF NEW JERSEY",NA,NA,967,551,416,100,19,81,0.147,0.103,0.046,2544,718
"7032",187444,1992,1,0,"WILLIAM PATERSON COLLEGE OF NEW JERSEY",NA,NA,962,536,426,94,24,70,0.131,0.098,0.056,2832,688
"7033",187444,1993,1,0,"WILLIAM PATERSON COLLEGE OF NEW JERSEY",NA,NA,1091,608,483,89,14,75,0.123,0.082,0.029,2928,755
"7034",187444,1995,1,0,"WILLIAM PATERSON COLLEGE OF NEW JERSEY",NA,NA,831,476,355,87,23,64,0.134,0.105,0.065,3120,518
"7035",187444,1996,1,0,"WILLIAM PATERSON COLLEGE OF NEW JERSEY",NA,NA,918,523,395,148,41,107,0.205,0.161,0.104,3380,568
"7036",187444,1997,1,0,"WILLIAM PATERSON UNIVERSITY OF NEW JERSEY",NA,NA,1032,563,469,154,51,103,0.183,0.149,0.109,3786,610
"7037",187444,1998,1,0,"WILLIAM PATERSON UNIVERSITY OF NEW JERSEY",NA,NA,1133,663,470,145,39,106,0.16,0.128,0.083,4150,696
"7038",187444,1999,1,0,"WILLIAM PATERSON UNIVERSITY OF NEW JERSEY",NA,NA,1105,614,491,177,56,121,0.197,0.16,0.114,3319,678
"7039",187444,2000,1,0,"WILLIAM PATERSON UNIVERSITY OF NEW JERSEY",NA,NA,1160,610,550,188,73,115,0.189,0.162,0.133,3554,675
"7040",187444,2001,1,0,"WILLIAM PATERSON UNIVERSITY OF NEW JERSEY",NA,NA,1247,697,550,185,59,126,0.181,0.148,0.107,3838,799
"7041",187444,2002,1,0,"WILLIAM PATERSON UNIVERSITY OF NEW JERSEY",NA,NA,1286,715,571,208,59,149,0.208,0.162,0.103,4218,747
"7042",187444,2003,1,0,"WILLIAM PATERSON UNIVERSITY OF NEW JERSEY",NA,NA,1269,711,558,262,86,176,0.248,0.206,0.154,4594,741
"7043",187444,2004,1,0,"WILLIAM PATERSON UNIVERSITY OF NEW JERSEY",NA,NA,1430,801,629,245,85,160,0.2,0.171,0.135,4961,813
"7044",187444,2005,1,0,"William Paterson University of New Jersey",NA,NA,1296,652,644,235,89,146,0.224,0.181,0.138,5358,685
"7045",187444,2006,1,0,"William Paterson University of New Jersey",NA,NA,1218,669,549,170,62,108,0.161,0.14,0.113,5782,613
"7046",187444,2007,1,0,"William Paterson University of New Jersey",NA,NA,1299,642,657,211,89,122,0.19,0.162,0.135,6072,671
"7047",187444,2008,1,0,"William Paterson University of New Jersey",NA,NA,1204,617,587,215,75,140,0.227,0.179,0.128,6375,589
"7048",187444,2009,1,0,"William Paterson University of New Jersey",NA,NA,1435,703,732,284,129,155,0.22,0.198,0.176,6567,726
"7049",187444,2010,1,0,"William Paterson University of New Jersey",NA,NA,1509,774,735,443,160,283,0.366,0.294,0.218,6830,751
"7050",187985,1991,1,0,"UNIVERSITY OF NEW MEXICO-MAIN CAMPUS",NA,NA,1716,915,801,147,61,86,0.094,0.086,0.076,1554,957
"7051",187985,1992,1,0,"UNIVERSITY OF NEW MEXICO-MAIN CAMPUS",NA,NA,1700,946,754,148,53,95,0.1,0.087,0.07,1656,917
"7052",187985,1993,1,0,"UNIVERSITY OF NEW MEXICO-MAIN CAMPUS",NA,NA,1910,1067,843,171,52,119,0.112,0.09,0.062,1788,1024
"7053",187985,1995,1,0,"UNIVERSITY OF NEW MEXICO-MAIN CAMPUS",NA,NA,1712,956,756,221,76,145,0.152,0.129,0.101,1996,897
"7054",187985,1996,1,0,"UNIVERSITY OF NEW MEXICO-MAIN CAMPUS",NA,NA,1600,875,725,217,67,150,0.171,0.136,0.092,2071,813
"7055",187985,1997,1,0,"UNIVERSITY OF NEW MEXICO-MAIN CAMPUS",NA,NA,2047,1132,915,244,71,173,0.153,0.119,0.078,2164,1119
"7056",187985,1998,1,0,"UNIVERSITY OF NEW MEXICO-MAIN CAMPUS",NA,NA,2617,1475,1142,281,96,185,0.125,0.107,0.084,2242,1290
"7057",187985,1999,1,0,"UNIVERSITY OF NEW MEXICO-MAIN CAMPUS",NA,NA,2715,1517,1198,276,85,191,0.126,0.102,0.071,1942,1397
"7058",187985,2000,1,0,"UNIVERSITY OF NEW MEXICO-MAIN CAMPUS",NA,NA,2587,1474,1113,311,106,205,0.139,0.12,0.095,2259,1286
"7059",187985,2001,1,0,"UNIVERSITY OF NEW MEXICO-MAIN CAMPUS",NA,NA,2364,1323,1041,280,103,177,0.134,0.118,0.099,2490,1127
"7060",187985,2002,1,0,"UNIVERSITY OF NEW MEXICO-MAIN CAMPUS",NA,NA,2758,1565,1193,314,100,214,0.137,0.114,0.084,2621,1344
"7061",187985,2003,1,0,"UNIVERSITY OF NEW MEXICO-MAIN CAMPUS",NA,NA,2940,1660,1280,300,76,224,0.135,0.102,0.059,2740,1349
"7062",187985,2004,1,0,"UNIVERSITY OF NEW MEXICO-MAIN CAMPUS",NA,NA,3018,1720,1298,370,98,272,0.158,0.123,0.076,3112,1352
"7063",187985,2005,1,0,"University of New Mexico-Main Campus",NA,NA,3010,1717,1293,372,130,242,0.141,0.124,0.101,3360,1367
"7064",187985,2006,1,0,"University of New Mexico-Main Campus",NA,NA,2955,1619,1336,356,124,232,0.143,0.12,0.093,3475,1332
"7065",187985,2007,1,0,"University of New Mexico-Main Campus",NA,NA,2850,1637,1213,415,147,268,0.164,0.146,0.121,3640,1260
"7066",187985,2008,1,0,"University of New Mexico-Main Campus",NA,NA,3148,1737,1411,459,161,298,0.172,0.146,0.114,3817,1309
"7067",187985,2009,1,0,"University of New Mexico-Main Campus",NA,NA,3344,1762,1582,516,193,323,0.183,0.154,0.122,4007,1255
"7068",187985,2010,1,0,"University of New Mexico-Main Campus",NA,NA,3488,1951,1537,574,204,370,0.19,0.165,0.133,4348,1274
"7069",188030,1991,1,0,"NEW MEXICO STATE UNIVERSITY MAIN CAMPUS",NA,NA,1656,846,810,127,45,82,0.097,0.077,0.056,1594,945
"7070",188030,1992,1,0,"NEW MEXICO STATE UNIVERSITY MAIN CAMPUS",NA,NA,1598,830,768,152,58,94,0.113,0.095,0.076,1708,871
"7071",188030,1993,1,0,"NEW MEXICO STATE UNIVERSITY-MAIN CAMPUS",NA,NA,1602,780,822,153,64,89,0.114,0.096,0.078,1824,867
"7072",188030,1995,1,0,"NEW MEXICO STATE UNIVERSITY-MAIN CAMPUS",NA,NA,1419,726,693,146,51,95,0.131,0.103,0.074,2088,743
"7073",188030,1996,1,0,"NEW MEXICO STATE UNIVERSITY-MAIN CAMPUS",NA,NA,1510,807,703,188,51,137,0.17,0.125,0.073,2196,803
"7074",188030,1997,1,0,"NEW MEXICO STATE UNIVERSITY-MAIN CAMPUS",NA,NA,1694,901,793,201,70,131,0.145,0.119,0.088,2196,843
"7075",188030,1998,1,0,"NEW MEXICO STATE UNIVERSITY-MAIN CAMPUS",NA,NA,2077,1070,1007,254,77,177,0.165,0.122,0.076,2346,1074
"7076",188030,1999,1,0,"NEW MEXICO STATE UNIVERSITY-MAIN CAMPUS",NA,NA,2210,1223,987,272,88,184,0.15,0.123,0.089,1740,1081
"7077",188030,2000,1,0,"NEW MEXICO STATE UNIVERSITY-MAIN CAMPUS",NA,NA,1959,1082,877,238,83,155,0.143,0.121,0.095,1956,160
"7078",188030,2001,1,0,"NEW MEXICO STATE UNIVERSITY-MAIN CAMPUS",NA,NA,2051,1075,976,250,76,174,0.162,0.122,0.078,2148,769
"7079",188030,2002,1,0,"NEW MEXICO STATE UNIVERSITY-MAIN CAMPUS",NA,NA,1977,1111,866,257,78,179,0.161,0.13,0.09,2328,826
"7080",188030,2003,1,0,"NEW MEXICO STATE UNIVERSITY-MAIN CAMPUS",NA,NA,2016,1087,929,257,90,167,0.154,0.127,0.097,2418,840
"7081",188030,2004,1,0,"NEW MEXICO STATE UNIVERSITY-MAIN CAMPUS",NA,NA,2061,1125,936,260,92,168,0.149,0.126,0.098,2828,831
"7082",188030,2005,1,0,"New Mexico State University-Main Campus",NA,NA,1945,1092,853,289,96,193,0.177,0.149,0.113,2868,785
"7083",188030,2006,1,0,"New Mexico State University-Main Campus",NA,NA,2073,1105,968,286,80,206,0.186,0.138,0.083,3124,854
"7084",188030,2007,1,0,"New Mexico State University-Main Campus",NA,NA,2105,1123,982,329,94,235,0.209,0.156,0.096,3274,802
"7085",188030,2008,1,0,"New Mexico State University-Main Campus",NA,NA,2171,1175,996,337,130,207,0.176,0.155,0.131,3540,794
"7086",188030,2009,1,0,"New Mexico State University-Main Campus",NA,NA,2446,1306,1140,328,116,212,0.162,0.134,0.102,3720,849
"7087",188030,2010,1,0,"New Mexico State University-Main Campus",NA,NA,2255,1181,1074,381,151,230,0.195,0.169,0.141,4128,700
"7088",188429,1991,1,0,"ADELPHI UNIVERSITY",NA,NA,658,417,241,259,74,185,0.444,0.394,0.307,10420,352
"7089",188429,1992,1,0,"ADELPHI UNIVERSITY",NA,NA,591,356,235,153,40,113,0.317,0.259,0.17,11420,291
"7090",188429,1993,1,0,"ADELPHI UNIVERSITY",NA,NA,464,282,182,154,48,106,0.376,0.332,0.264,12250,237
"7091",188429,1995,1,0,"ADELPHI UNIVERSITY",NA,NA,370,212,158,140,52,88,0.415,0.378,0.329,13350,207
"7092",188429,1996,1,0,"ADELPHI UNIVERSITY",NA,NA,316,204,112,128,40,88,0.431,0.405,0.357,14000,182
"7093",188429,1997,1,0,"ADELPHI UNIVERSITY",NA,NA,289,174,115,130,49,81,0.465,0.45,0.426,14000,150
"7094",188429,1998,1,0,"ADELPHI UNIVERSITY",NA,NA,525,343,182,214,67,147,0.429,0.408,0.368,14250,251
"7095",188429,1999,1,0,"ADELPHI UNIVERSITY",NA,NA,532,366,166,233,64,169,0.462,0.438,0.386,14920,316
"7096",188429,2000,1,0,"ADELPHI UNIVERSITY",NA,NA,616,416,200,314,82,232,0.558,0.51,0.41,15520,349
"7097",188429,2001,1,0,"ADELPHI UNIVERSITY",NA,NA,664,469,195,367,89,278,0.593,0.553,0.456,16270,373
"7098",188429,2002,1,0,"ADELPHI UNIVERSITY",NA,NA,666,463,203,373,97,276,0.596,0.56,0.478,16980,365
"7099",188429,2003,1,0,"ADELPHI UNIVERSITY",NA,NA,772,514,258,402,117,285,0.554,0.521,0.453,17800,395
"7100",188429,2004,1,0,"ADELPHI UNIVERSITY",NA,NA,801,549,252,463,119,344,0.627,0.578,0.472,17700,367
"7101",188429,2005,1,0,"Adelphi University",NA,NA,754,505,249,416,121,295,0.584,0.552,0.486,18620,327
"7102",188429,2006,1,0,"Adelphi University",NA,NA,826,587,239,446,108,338,0.576,0.54,0.452,19800,488
"7103",188429,2007,1,0,"Adelphi University",NA,NA,883,603,280,464,134,330,0.547,0.525,0.479,21000,517
"7104",188429,2008,1,0,"Adelphi University",NA,NA,944,614,330,510,146,364,0.593,0.54,0.442,22725,554
"7105",188429,2009,1,0,"Adelphi University",NA,NA,985,690,295,539,131,408,0.591,0.547,0.444,24100,577
"7106",188429,2010,1,0,"Adelphi University",NA,NA,909,634,275,521,133,388,0.612,0.573,0.484,25465,499
"7107",188641,1991,1,0,"ALFRED UNIVERSITY",NA,NA,256,110,146,132,67,65,0.591,0.516,0.459,14110,231
"7108",188641,1992,1,0,"ALFRED UNIVERSITY",NA,NA,300,136,164,151,73,78,0.574,0.503,0.445,14998,269
"7109",188641,1993,1,0,"ALFRED UNIVERSITY",NA,NA,314,148,166,165,74,91,0.615,0.525,0.446,15648,273
"7110",188641,1995,1,0,"ALFRED UNIVERSITY",NA,NA,326,158,168,153,56,97,0.614,0.469,0.333,17948,287
"7111",188641,1996,1,0,"ALFRED UNIVERSITY",NA,NA,330,166,164,178,76,102,0.615,0.539,0.463,18972,295
"7112",188641,1997,1,0,"ALFRED UNIVERSITY",NA,NA,467,205,262,204,99,105,0.512,0.437,0.378,19916,424
"7113",188641,1998,1,0,"ALFRED UNIVERSITY",NA,NA,554,275,279,272,118,154,0.56,0.491,0.423,20212,492
"7114",188641,1999,1,0,"ALFRED UNIVERSITY",NA,NA,549,277,272,242,98,144,0.52,0.441,0.36,18498,478
"7115",188641,2000,1,0,"ALFRED UNIVERSITY",NA,NA,504,280,224,246,81,165,0.589,0.488,0.362,18498,386
"7116",188641,2001,1,0,"ALFRED UNIVERSITY",NA,NA,500,243,257,232,97,135,0.556,0.464,0.377,18498,369
"7117",188641,2002,1,0,"ALFRED UNIVERSITY",NA,NA,474,223,251,247,111,136,0.61,0.521,0.442,19918,348
"7118",188641,2003,1,0,"ALFRED UNIVERSITY",NA,NA,472,250,222,237,89,148,0.592,0.502,0.401,19918,364
"7119",188641,2004,1,0,"ALFRED UNIVERSITY",NA,NA,505,226,279,218,99,119,0.526,0.432,0.355,20106,367
"7120",188641,2005,1,0,"Alfred University",NA,NA,429,188,241,186,85,101,0.537,0.434,0.353,20515,306
"7121",188641,2006,1,0,"Alfred University",NA,NA,490,257,233,229,86,143,0.556,0.467,0.369,21284,332
"7122",188641,2007,1,0,"Alfred University",NA,NA,518,239,279,231,107,124,0.519,0.446,0.384,22312,345
"7123",188641,2008,1,0,"Alfred University",NA,NA,502,219,283,193,99,94,0.429,0.384,0.35,23428,344
"7124",188641,2009,1,0,"Alfred University",NA,NA,465,234,231,204,85,119,0.509,0.439,0.368,24366,313
"7125",188641,2010,1,0,"Alfred University",NA,NA,526,240,286,225,91,134,0.558,0.428,0.318,25096,372
"7126",190044,1991,1,0,"CLARKSON UNIVERSITY",NA,NA,634,134,500,338,266,72,0.537,0.533,0.532,13675,554
"7127",190044,1992,1,0,"CLARKSON UNIVERSITY",NA,NA,549,138,411,294,210,84,0.609,0.536,0.511,14510,479
"7128",190044,1993,1,0,"CLARKSON UNIVERSITY",NA,NA,557,120,437,285,221,64,0.533,0.512,0.506,15060,502
"7129",190044,1995,1,0,"CLARKSON UNIVERSITY",NA,NA,645,170,475,305,221,84,0.494,0.473,0.465,17113,573
"7130",190044,1996,1,0,"CLARKSON UNIVERSITY",NA,NA,664,176,488,349,253,96,0.545,0.526,0.518,17500,577
"7131",190044,1997,1,0,"CLARKSON UNIVERSITY",NA,NA,612,136,476,378,297,81,0.596,0.618,0.624,18593,546
"7132",190044,1998,1,0,"CLARKSON UNIVERSITY",NA,NA,616,138,478,292,216,76,0.551,0.474,0.452,19418,553
"7133",190044,1999,1,0,"CLARKSON UNIVERSITY",NA,NA,706,225,481,407,264,143,0.636,0.576,0.549,19825,645
"7134",190044,2000,1,0,"CLARKSON UNIVERSITY",NA,NA,638,149,489,325,242,83,0.557,0.509,0.495,20600,568
"7135",190044,2001,1,0,"CLARKSON UNIVERSITY",NA,NA,722,164,558,382,290,92,0.561,0.529,0.52,21400,631
"7136",190044,2002,1,0,"CLARKSON UNIVERSITY",NA,NA,723,164,559,391,296,95,0.579,0.541,0.53,22235,673
"7137",190044,2003,1,0,"CLARKSON UNIVERSITY",NA,NA,720,193,527,372,257,115,0.596,0.517,0.488,23100,641
"7138",190044,2004,1,0,"CLARKSON UNIVERSITY",NA,NA,658,142,516,364,275,89,0.627,0.553,0.533,24100,610
"7139",190044,2005,1,0,"Clarkson University",NA,NA,630,173,457,380,274,106,0.613,0.603,0.6,25185,579
"7140",190044,2006,1,0,"Clarkson University",NA,NA,646,176,470,354,246,108,0.614,0.548,0.523,26650,556
"7141",190044,2007,1,0,"Clarkson University",NA,NA,682,189,493,418,289,129,0.682,0.613,0.586,28470,582
"7142",190044,2008,1,0,"Clarkson University",NA,NA,734,204,530,407,274,133,0.652,0.554,0.517,30320,615
"7143",190044,2009,1,0,"Clarkson University",NA,NA,774,220,554,405,262,143,0.65,0.523,0.473,32220,645
"7144",190044,2010,1,0,"Clarkson University",NA,NA,712,182,530,399,279,120,0.659,0.56,0.526,34070,612
"7145",190099,1991,1,0,"COLGATE UNIVERSITY",NA,NA,694,330,364,554,265,289,0.876,0.798,0.728,16150,587
"7146",190099,1992,1,0,"COLGATE UNIVERSITY",NA,NA,690,368,322,589,257,332,0.902,0.854,0.798,17415,586
"7147",190099,1993,1,0,"COLGATE UNIVERSITY",NA,NA,726,378,348,603,269,334,0.884,0.831,0.773,18620,625
"7148",190099,1995,1,0,"COLGATE UNIVERSITY",NA,NA,722,361,361,604,290,314,0.87,0.837,0.803,20650,632
"7149",190099,1996,1,0,"COLGATE UNIVERSITY",NA,NA,718,351,367,592,282,310,0.883,0.825,0.768,21675,600
"7150",190099,1997,1,0,"COLGATE UNIVERSITY",NA,NA,711,364,347,599,276,323,0.887,0.842,0.795,22765,593
"7151",190099,1998,1,0,"COLGATE UNIVERSITY",NA,NA,751,407,344,641,283,358,0.88,0.854,0.823,23880,620
"7152",190099,1999,1,0,"COLGATE UNIVERSITY",NA,NA,750,397,353,662,306,356,0.897,0.883,0.867,24575,619
"7153",190099,2000,1,0,"COLGATE UNIVERSITY",NA,NA,711,339,372,600,308,292,0.861,0.844,0.828,25565,601
"7154",190099,2001,1,0,"COLGATE UNIVERSITY",NA,NA,740,392,348,631,282,349,0.89,0.853,0.81,26845,597
"7155",190099,2002,1,0,"COLGATE UNIVERSITY",NA,NA,728,386,342,629,292,337,0.873,0.864,0.854,28165,565
"7156",190099,2003,1,0,"COLGATE UNIVERSITY",NA,NA,725,355,370,615,301,314,0.885,0.848,0.814,29740,562
"7157",190099,2004,1,0,"COLGATE UNIVERSITY",NA,NA,738,396,342,616,277,339,0.856,0.835,0.81,31230,544
"7158",190099,2005,1,0,"Colgate University",NA,NA,729,368,361,640,311,329,0.894,0.878,0.861,32885,571
"7159",190099,2006,1,0,"Colgate University",NA,NA,743,417,326,630,278,352,0.844,0.848,0.853,34795,552
"7160",190099,2007,1,0,"Colgate University",NA,NA,744,382,362,644,297,347,0.908,0.866,0.82,37405,552
"7161",190099,2008,1,0,"Colgate University",NA,NA,737,386,351,661,307,354,0.917,0.897,0.875,39275,553
"7162",190099,2009,1,0,"Colgate University",NA,NA,750,400,350,644,299,345,0.863,0.859,0.854,40690,556
"7163",190099,2010,1,0,"Colgate University",NA,NA,849,466,383,721,312,409,0.878,0.849,0.815,41585,568
"7164",190150,1991,1,0,"COLUMBIA UNIVERSITY IN THE CITY OF NEW YORK",NA,NA,1085,464,621,851,481,370,0.797,0.784,0.775,16318,572
"7165",190150,1992,1,0,"COLUMBIA UNIVERSITY IN THE CITY OF NEW YORK",NA,NA,1113,458,655,880,511,369,0.806,0.791,0.78,16918,478
"7166",190150,1993,1,0,"COLUMBIA UNIVERSITY IN THE CITY OF NEW YORK",NA,NA,1626,997,629,1243,482,761,0.763,0.764,0.766,17948,848
"7167",190150,1995,1,0,"COLUMBIA UNIVERSITY IN THE CITY OF NEW YORK",NA,NA,1157,505,652,918,501,417,0.826,0.793,0.768,20292,561
"7168",190150,1996,1,0,"COLUMBIA UNIVERSITY IN THE CITY OF NEW YORK",NA,NA,1260,576,684,1041,542,499,0.866,0.826,0.792,21444,595
"7169",190150,1997,1,0,"COLUMBIA UNIVERSITY IN THE CITY OF NEW YORK",NA,NA,1271,583,688,1036,547,489,0.839,0.815,0.795,22652,583
"7170",190150,1998,1,0,"COLUMBIA UNIVERSITY IN THE CITY OF NEW YORK",NA,NA,1283,619,664,1061,545,516,0.834,0.827,0.821,23244,589
"7171",190150,1999,1,0,"COLUMBIA UNIVERSITY IN THE CITY OF NEW YORK",NA,NA,1298,573,725,1068,586,482,0.841,0.823,0.808,24150,625
"7172",190150,2000,1,0,"COLUMBIA UNIVERSITY IN THE CITY OF NEW YORK",NA,NA,1339,610,729,1136,602,534,0.875,0.848,0.826,25044,630
"7173",190150,2001,1,0,"COLUMBIA UNIVERSITY IN THE CITY OF NEW YORK",NA,NA,1330,607,723,1108,612,496,0.817,0.833,0.846,25790,661
"7174",190150,2002,1,0,"COLUMBIA UNIVERSITY IN THE CITY OF NEW YORK",NA,NA,1386,636,750,1168,630,538,0.846,0.843,0.84,27190,678
"7175",190150,2003,1,0,"COLUMBIA UNIVERSITY IN THE CITY OF NEW YORK",NA,NA,1355,626,729,1131,606,525,0.839,0.835,0.831,28686,611
"7176",190150,2004,1,0,"COLUMBIA UNIVERSITY IN THE CITY OF NEW YORK",NA,NA,1366,632,734,1133,604,529,0.837,0.829,0.823,30260,604
"7177",190150,2005,1,0,"Columbia University in the City of New York",NA,NA,1403,660,743,1189,621,568,0.861,0.847,0.836,31924,644
"7178",190150,2006,1,0,"Columbia University in the City of New York",NA,NA,1353,646,707,1191,604,587,0.909,0.88,0.854,33664,564
"7179",190150,2007,1,0,"Columbia University in the City of New York",NA,NA,1371,671,700,1173,586,587,0.875,0.856,0.837,35516,567
"7180",190150,2008,1,0,"Columbia University in the City of New York",NA,NA,1374,653,721,1208,613,595,0.911,0.879,0.85,37470,549
"7181",190150,2009,1,0,"Columbia University in the City of New York",NA,NA,1432,701,731,1260,629,631,0.9,0.88,0.86,39296,491
"7182",190150,2010,1,0,"Columbia University in the City of New York",NA,NA,1392,676,716,1188,595,593,0.877,0.853,0.831,41160,495
"7183",190248,1991,1,0,"CONCORDIA COLLEGE",NA,NA,85,43,42,29,10,19,0.442,0.341,0.238,8370,73
"7184",190248,1992,1,0,"CONCORDIA COLLEGE",NA,NA,106,62,44,28,8,20,0.323,0.264,0.182,9370,79
"7185",190248,1993,1,0,"CONCORDIA COLLEGE",NA,NA,81,40,41,27,12,15,0.375,0.333,0.293,9990,61
"7186",190248,1995,1,0,"CONCORDIA COLLEGE",NA,NA,118,63,55,29,13,16,0.254,0.246,0.236,10696,81
"7187",190248,1996,1,0,"CONCORDIA COLLEGE",NA,NA,94,43,51,19,7,12,0.279,0.202,0.137,11400,69
"7188",190248,1997,1,0,"CONCORDIA COLLEGE",NA,NA,113,71,42,41,13,28,0.394,0.363,0.31,11990,90
"7189",190248,1998,1,0,"CONCORDIA COLLEGE",NA,NA,114,68,46,40,17,23,0.338,0.351,0.37,12650,75
"7190",190248,1999,1,0,"CONCORDIA COLLEGE",NA,NA,111,72,39,33,6,27,0.375,0.297,0.154,13350,66
"7191",190248,2000,1,0,"CONCORDIA COLLEGE",NA,NA,122,68,54,55,23,32,0.471,0.451,0.426,14350,82
"7192",190248,2001,1,0,"CONCORDIA COLLEGE",NA,NA,132,88,44,50,9,41,0.466,0.379,0.205,15550,97
"7193",190248,2002,1,0,"CONCORDIA COLLEGE",NA,NA,135,75,60,43,16,27,0.36,0.319,0.267,16800,86
"7194",190248,2003,1,0,"CONCORDIA COLLEGE",NA,NA,137,85,52,37,12,25,0.294,0.27,0.231,17640,80
"7195",190248,2004,1,0,"CONCORDIA COLLEGE",NA,NA,143,61,82,38,13,25,0.41,0.266,0.159,18700,84
"7196",190248,2005,1,0,"Concordia College",NA,NA,140,83,57,49,12,37,0.446,0.35,0.211,19800,92
"7197",190248,2006,1,0,"Concordia College",NA,NA,171,90,81,57,26,31,0.344,0.333,0.321,20700,109
"7198",190248,2007,1,0,"Concordia College",NA,NA,127,76,51,35,9,26,0.342,0.276,0.176,21950,68
"7199",190248,2008,1,0,"Concordia College",NA,NA,104,58,46,40,12,28,0.483,0.385,0.261,22930,51
"7200",190248,2009,1,0,"Concordia College-New York",NA,NA,101,54,47,27,7,20,0.37,0.267,0.149,23950,45
"7201",190248,2010,1,0,"Concordia College-New York",NA,NA,138,76,62,62,22,40,0.526,0.449,0.355,24670,67
"7202",190415,1991,1,0,"CORNELL UNIVERSITY-ENDOWED COLLEGES",NA,NA,2949,1345,1604,2336,1218,1118,0.831,0.792,0.759,16214,1705
"7203",190415,1992,1,0,"CORNELL UNIVERSITY-ENDOWED COLLEGES",NA,NA,2893,1382,1511,2354,1179,1175,0.85,0.814,0.78,17276,1597
"7204",190415,1993,1,0,"CORNELL UNIVERSITY-ENDOWED COLLEGES",NA,NA,3172,1423,1749,2612,1400,1212,0.852,0.823,0.8,18226,1802
"7205",190415,1995,1,0,"CORNELL UNIVERSITY-ENDOWED COLLEGES",NA,NA,2070,842,1228,1625,931,694,0.824,0.785,0.758,20066,1196
"7206",190415,1996,1,0,"CORNELL UNIVERSITY-ENDOWED COLLEGES",NA,NA,2001,870,1131,1570,872,698,0.802,0.785,0.771,20974,1108
"7207",190415,1997,1,0,"CORNELL UNIVERSITY-ENDOWED COLLEGES",NA,NA,2998,1405,1593,2551,1307,1244,0.885,0.851,0.82,21914,1750
"7208",190415,1998,1,0,"CORNELL UNIVERSITY-ENDOWED COLLEGES",NA,NA,3084,1452,1632,2633,1358,1275,0.878,0.854,0.832,22868,1920
"7209",190415,1999,1,0,"CORNELL UNIVERSITY-ENDOWED COLLEGES",NA,NA,3158,1497,1661,2660,1341,1319,0.881,0.842,0.807,23760,1939
"7210",190415,2000,1,0,"CORNELL UNIVERSITY-ENDOWED COLLEGES",NA,NA,3047,1438,1609,2569,1308,1261,0.877,0.843,0.813,24760,1814
"7211",190415,2001,1,0,"CORNELL UNIVERSITY-ENDOWED COLLEGES",NA,NA,2984,1471,1513,2524,1246,1278,0.869,0.846,0.824,25970,1815
"7212",190415,2002,1,0,"CORNELL UNIVERSITY-ENDOWED COLLEGES",NA,NA,2999,1530,1469,2605,1253,1352,0.884,0.869,0.853,27270,1878
"7213",190415,2003,1,0,"CORNELL UNIVERSITY-ENDOWED COLLEGES",NA,NA,3131,1533,1598,2672,1322,1350,0.881,0.853,0.827,28630,1782
"7214",190415,2004,1,0,"CORNELL UNIVERSITY-ENDOWED COLLEGES",NA,NA,3051,1494,1557,2621,1289,1332,0.892,0.859,0.828,30000,1724
"7215",190415,2005,1,0,"Cornell University",NA,NA,3071,1541,1530,2664,1286,1378,0.894,0.867,0.841,31300,1838
"7216",190415,2006,1,0,"Cornell University",NA,NA,3186,1538,1648,2779,1375,1404,0.913,0.872,0.834,32800,1576
"7217",190415,2007,1,0,"Cornell University",NA,NA,3005,1454,1551,2601,1285,1316,0.905,0.866,0.828,34600,1363
"7218",190415,2008,1,0,"Cornell University",NA,NA,3132,1573,1559,2718,1307,1411,0.897,0.868,0.838,36300,1514
"7219",190415,2009,1,0,"Cornell University",NA,NA,3174,1597,1577,2742,1327,1415,0.886,0.864,0.841,37750,1471
"7220",190415,2010,1,0,"Cornell University",NA,NA,3172,1579,1593,2763,1325,1438,0.911,0.871,0.832,39450,1467
"7221",190512,1991,1,0,"CUNY BERNARD BARUCH COLLEGE",NA,NA,1170,746,424,56,19,37,0.05,0.048,0.045,1950,194
"7222",190512,1992,1,0,"CUNY BERNARD BARUCH COLLEGE",NA,NA,1359,830,529,52,20,32,0.039,0.038,0.038,2552,260
"7223",190512,1993,1,0,"CUNY BERNARD M BARUCH COLLEGE",NA,NA,1300,798,502,63,25,38,0.048,0.048,0.05,2562,284
"7224",190512,1995,1,0,"CUNY BERNARD M BARUCH COLLEGE",NA,NA,1445,839,606,149,55,94,0.112,0.103,0.091,3320,323
"7225",190512,1996,1,0,"CUNY BERNARD M BARUCH COLLEGE",NA,NA,1365,797,568,196,82,114,0.143,0.144,0.144,3320,349
"7226",190512,1997,1,0,"CUNY BERNARD M BARUCH COLLEGE",NA,NA,1109,608,501,202,75,127,0.209,0.182,0.15,3330,261
"7227",190512,1998,1,0,"CUNY BERNARD M BARUCH COLLEGE",NA,NA,946,493,453,231,83,148,0.3,0.244,0.183,3330,276
"7228",190512,1999,1,0,"CUNY BERNARD M BARUCH COLLEGE",NA,NA,1133,593,540,312,124,188,0.317,0.275,0.23,3200,358
"7229",190512,2000,1,0,"CUNY BERNARD M BARUCH COLLEGE",NA,NA,1295,701,594,351,137,214,0.305,0.271,0.231,3200,417
"7230",190512,2001,1,0,"CUNY BERNARD M BARUCH COLLEGE",NA,NA,1688,921,767,554,231,323,0.351,0.328,0.301,3200,571
"7231",190512,2002,1,0,"CUNY BERNARD M BARUCH COLLEGE",NA,NA,1654,830,824,554,217,337,0.406,0.335,0.263,3200,615
"7232",190512,2003,1,0,"CUNY BERNARD M BARUCH COLLEGE",NA,NA,1659,819,840,544,214,330,0.403,0.328,0.255,4000,564
"7233",190512,2004,1,0,"CUNY BERNARD M BARUCH COLLEGE",NA,NA,1693,865,828,569,233,336,0.388,0.336,0.281,4000,575
"7234",190512,2005,1,0,"CUNY Bernard M Baruch College",NA,NA,1625,784,841,577,266,311,0.397,0.355,0.316,4000,513
"7235",190512,2006,1,0,"CUNY Bernard M Baruch College",NA,NA,1493,650,843,497,248,249,0.383,0.333,0.294,4000,448
"7236",190512,2007,1,0,"CUNY Bernard M Baruch College",NA,NA,1470,695,775,578,259,319,0.459,0.393,0.334,4000,492
"7237",190512,2008,1,0,"CUNY Bernard M Baruch College",NA,NA,1497,693,804,530,250,280,0.404,0.354,0.311,4000,469
"7238",190512,2009,1,0,"CUNY Bernard M Baruch College",NA,NA,1430,619,811,598,294,304,0.491,0.418,0.363,4600,444
"7239",190512,2010,1,0,"CUNY Bernard M Baruch College",NA,NA,1255,527,728,483,242,241,0.457,0.385,0.332,4600,378
"7240",190549,1991,1,0,"CUNY BROOKLYN COLLEGE",NA,NA,1475,843,632,135,42,93,0.11,0.092,0.066,2005,828
"7241",190549,1992,1,0,"CUNY BROOKLYN COLLEGE",NA,NA,1341,765,576,122,40,82,0.107,0.091,0.069,2607,728
"7242",190549,1993,1,0,"CUNY BROOKLYN COLLEGE",NA,NA,1269,748,521,143,40,103,0.138,0.113,0.077,2629,646
"7243",190549,1995,1,0,"CUNY BROOKLYN COLLEGE",NA,NA,1167,685,482,182,60,122,0.178,0.156,0.124,3387,549
"7244",190549,1996,1,0,"CUNY BROOKLYN COLLEGE",NA,NA,1211,739,472,183,49,134,0.181,0.151,0.104,3387,591
"7245",190549,1997,1,0,"CUNY BROOKLYN COLLEGE",NA,NA,1344,774,570,194,75,119,0.154,0.144,0.132,3393,636
"7246",190549,1998,1,0,"CUNY BROOKLYN COLLEGE",NA,NA,1029,615,414,184,56,128,0.208,0.179,0.135,3393,521
"7247",190549,1999,1,0,"CUNY BROOKLYN COLLEGE",NA,NA,982,591,391,166,55,111,0.188,0.169,0.141,3200,504
"7248",190549,2000,1,0,"CUNY BROOKLYN COLLEGE",NA,NA,1238,717,521,218,79,139,0.194,0.176,0.152,3200,589
"7249",190549,2001,1,0,"CUNY BROOKLYN COLLEGE",NA,NA,1017,591,426,209,64,145,0.245,0.206,0.15,3200,528
"7250",190549,2002,1,0,"CUNY BROOKLYN COLLEGE",NA,NA,1194,679,515,235,78,157,0.231,0.197,0.151,3200,579
"7251",190549,2003,1,0,"CUNY BROOKLYN COLLEGE",NA,NA,1296,679,617,220,73,147,0.216,0.17,0.118,4000,653
"7252",190549,2004,1,0,"CUNY BROOKLYN COLLEGE",NA,NA,1170,653,517,268,90,178,0.273,0.229,0.174,4000,545
"7253",190549,2005,1,0,"CUNY Brooklyn College",NA,NA,1372,757,615,294,109,185,0.244,0.214,0.177,4000,588
"7254",190549,2006,1,0,"CUNY Brooklyn College",NA,NA,1354,766,588,355,120,235,0.307,0.262,0.204,4000,579
"7255",190549,2007,1,0,"CUNY Brooklyn College",NA,NA,1300,743,557,305,103,202,0.272,0.235,0.185,4000,531
"7256",190549,2008,1,0,"CUNY Brooklyn College",NA,NA,1330,792,538,319,107,212,0.268,0.24,0.199,4000,522
"7257",190549,2009,1,0,"CUNY Brooklyn College",NA,NA,952,541,411,223,94,129,0.238,0.234,0.229,4600,388
"7258",190549,2010,1,0,"CUNY Brooklyn College",NA,NA,1143,661,482,284,95,189,0.286,0.248,0.197,4600,505
"7259",190558,1991,1,0,"CUNY COLLEGE OF STATEN ISLAND",NA,NA,1153,599,554,16,4,12,0.02,0.014,0.007,1949,843
"7260",190558,1992,1,0,"CUNY COLLEGE OF STATEN ISLAND",NA,NA,1126,593,533,17,3,14,0.024,0.015,0.006,2558,811
"7261",190558,1993,1,0,"CUNY COLLEGE OF STATEN ISLAND",NA,NA,1100,579,521,23,9,14,0.024,0.021,0.017,2558,784
"7262",190558,1995,1,0,"CUNY COLLEGE OF STATEN ISLAND",NA,NA,1426,728,698,33,17,16,0.022,0.023,0.024,3316,1007
"7263",190558,1996,1,0,"CUNY COLLEGE OF STATEN ISLAND",NA,NA,1434,727,707,32,9,23,0.032,0.022,0.013,3316,956
"7264",190558,1997,1,0,"CUNY COLLEGE OF STATEN ISLAND",NA,NA,1418,729,689,32,7,25,0.034,0.023,0.01,3316,944
"7265",190558,1998,1,0,"CUNY COLLEGE OF STATEN ISLAND",NA,NA,1510,786,724,36,14,22,0.028,0.024,0.019,3316,956
"7266",190558,1999,1,0,"CUNY COLLEGE OF STATEN ISLAND",NA,NA,1532,782,750,63,21,42,0.054,0.041,0.028,3200,942
"7267",190558,2000,1,0,"CUNY COLLEGE OF STATEN ISLAND",NA,NA,1488,796,692,44,10,34,0.043,0.03,0.014,3200,982
"7268",190558,2001,1,0,"CUNY COLLEGE OF STATEN ISLAND",NA,NA,1600,817,783,57,22,35,0.043,0.036,0.028,3200,1045
"7269",190558,2002,1,0,"CUNY COLLEGE OF STATEN ISLAND",NA,NA,1743,905,838,66,25,41,0.045,0.038,0.03,3200,1131
"7270",190558,2003,1,0,"CUNY COLLEGE OF STATEN ISLAND",NA,NA,1885,1013,872,67,17,50,0.049,0.036,0.019,4000,1210
"7271",190558,2004,1,0,"CUNY COLLEGE OF STATEN ISLAND",NA,NA,2020,1147,873,67,12,55,0.048,0.033,0.014,4000,1243
"7272",190558,2005,1,0,"CUNY College of Staten Island",NA,NA,1888,1048,840,62,31,31,0.03,0.033,0.037,4000,1120
"7273",190558,2006,1,0,"CUNY College of Staten Island",NA,NA,2072,1124,948,108,41,67,0.06,0.052,0.043,4000,1265
"7274",190558,2007,1,0,"CUNY College of Staten Island",NA,NA,2273,1272,1001,122,48,74,0.058,0.054,0.048,4000,1342
"7275",190558,2008,1,0,"CUNY College of Staten Island",NA,NA,2282,1209,1073,112,47,65,0.054,0.049,0.044,4000,1340
"7276",190558,2009,1,0,"CUNY College of Staten Island",NA,NA,2407,1245,1162,127,52,75,0.06,0.053,0.045,4600,1430
"7277",190558,2010,1,0,"CUNY College of Staten Island",NA,NA,2237,1184,1053,146,52,94,0.079,0.065,0.049,4600,1299
"7278",190567,1991,1,0,"CUNY CITY COLLEGE",NA,NA,1126,505,621,19,11,8,0.016,0.017,0.018,1945,68
"7279",190567,1992,1,0,"CUNY CITY COLLEGE",NA,NA,1071,454,617,18,12,6,0.013,0.017,0.019,2547,53
"7280",190567,1993,1,0,"CUNY CITY COLLEGE",NA,NA,1167,507,660,25,13,12,0.024,0.021,0.02,2547,94
"7281",190567,1995,1,0,"CUNY CITY COLLEGE",NA,NA,865,449,416,31,18,13,0.029,0.036,0.043,3304,55
"7282",190567,1996,1,0,"CUNY CITY COLLEGE",NA,NA,768,352,416,28,14,14,0.04,0.036,0.034,3309,39
"7283",190567,1997,1,0,"CUNY CITY COLLEGE",NA,NA,947,464,483,44,17,27,0.058,0.046,0.035,3309,49
"7284",190567,1998,1,0,"CUNY CITY COLLEGE",NA,NA,901,462,439,31,11,20,0.043,0.034,0.025,3309,51
"7285",190567,1999,1,0,"CUNY CITY COLLEGE",NA,NA,773,341,432,45,16,29,0.085,0.058,0.037,3200,64
"7286",190567,2000,1,0,"CUNY CITY COLLEGE",NA,NA,852,399,453,27,8,19,0.048,0.032,0.018,3200,69
"7287",190567,2001,1,0,"CUNY CITY COLLEGE",NA,NA,705,310,395,54,17,37,0.119,0.077,0.043,3200,72
"7288",190567,2002,1,0,"CUNY CITY COLLEGE",NA,NA,961,435,526,65,28,37,0.085,0.068,0.053,3200,134
"7289",190567,2003,1,0,"CUNY CITY COLLEGE",NA,NA,1124,547,577,62,20,42,0.077,0.055,0.035,4000,138
"7290",190567,2004,1,0,"CUNY CITY COLLEGE",NA,NA,1168,531,637,106,45,61,0.115,0.091,0.071,4000,137
"7291",190567,2005,1,0,"CUNY City College",NA,NA,1278,592,686,78,39,39,0.066,0.061,0.057,4000,164
"7292",190567,2006,1,0,"CUNY City College",NA,NA,1529,760,769,114,43,71,0.093,0.075,0.056,4000,224
"7293",190567,2007,1,0,"CUNY City College",NA,NA,1771,916,855,166,65,101,0.11,0.094,0.076,4000,270
"7294",190567,2008,1,0,"CUNY City College",NA,NA,1744,919,825,182,67,115,0.125,0.104,0.081,4000,271
"7295",190567,2009,1,0,"CUNY City College",NA,NA,1753,909,844,195,75,120,0.132,0.111,0.089,4600,323
"7296",190567,2010,1,0,"CUNY City College",NA,NA,1368,685,683,171,58,113,0.165,0.125,0.085,4600,241
"7297",190594,1991,1,0,"CUNY HUNTER COLLEGE",NA,NA,808,617,191,30,3,27,0.044,0.037,0.016,1953,163
"7298",190594,1992,1,0,"CUNY HUNTER COLLEGE",NA,NA,936,710,226,35,10,25,0.035,0.037,0.044,2555,200
"7299",190594,1993,1,0,"CUNY HUNTER COLLEGE",NA,NA,1308,1011,297,62,7,55,0.054,0.047,0.024,2555,284
"7300",190594,1995,1,0,"CUNY HUNTER COLLEGE",NA,NA,1091,807,284,82,13,69,0.086,0.075,0.046,3313,356
"7301",190594,1996,1,0,"CUNY HUNTER COLLEGE",NA,NA,1456,1008,448,127,28,99,0.098,0.087,0.062,3323,456
"7302",190594,1997,1,0,"CUNY HUNTER COLLEGE",NA,NA,1630,1137,493,136,26,110,0.097,0.083,0.053,3329,551
"7303",190594,1998,1,0,"CUNY HUNTER COLLEGE",NA,NA,1468,1026,442,134,29,105,0.102,0.091,0.066,3329,486
"7304",190594,1999,1,0,"CUNY HUNTER COLLEGE",NA,NA,1806,1281,525,176,36,140,0.109,0.097,0.069,3200,585
"7305",190594,2000,1,0,"CUNY HUNTER COLLEGE",NA,NA,1741,1227,514,188,43,145,0.118,0.108,0.084,3200,619
"7306",190594,2001,1,0,"CUNY HUNTER COLLEGE",NA,NA,1877,1284,593,234,41,193,0.15,0.125,0.069,3200,670
"7307",190594,2002,1,0,"CUNY HUNTER COLLEGE",NA,NA,1445,1010,435,256,50,206,0.204,0.177,0.115,3200,573
"7308",190594,2003,1,0,"CUNY HUNTER COLLEGE",NA,NA,1661,1113,548,280,63,217,0.195,0.169,0.115,4000,641
"7309",190594,2004,1,0,"CUNY HUNTER COLLEGE",NA,NA,1824,1235,589,312,81,231,0.187,0.171,0.138,4000,683
"7310",190594,2005,1,0,"CUNY Hunter College",NA,NA,1776,1199,577,356,97,259,0.216,0.2,0.168,4000,692
"7311",190594,2006,1,0,"CUNY Hunter College",NA,NA,1813,1202,611,349,86,263,0.219,0.192,0.141,4000,658
"7312",190594,2007,1,0,"CUNY Hunter College",NA,NA,1854,1226,628,402,89,313,0.255,0.217,0.142,4000,699
"7313",190594,2008,1,0,"CUNY Hunter College",NA,NA,1988,1273,715,445,108,337,0.265,0.224,0.151,4000,698
"7314",190594,2009,1,0,"CUNY Hunter College",NA,NA,1983,1241,742,487,115,372,0.3,0.246,0.155,4600,708
"7315",190594,2010,1,0,"CUNY Hunter College",NA,NA,1740,1141,599,413,100,313,0.274,0.237,0.167,4600,661
"7316",190637,1991,1,0,"CUNY LEHMAN COLLEGE",NA,NA,711,470,241,15,8,7,0.015,0.021,0.033,1960,74
"7317",190637,1992,1,0,"CUNY LEHMAN COLLEGE",NA,NA,692,468,224,21,6,15,0.032,0.03,0.027,2562,60
"7318",190637,1993,1,0,"CUNY LEHMAN COLLEGE",NA,NA,663,455,208,15,1,14,0.031,0.023,0.005,2562,56
"7319",190637,1995,1,0,"CUNY LEHMAN COLLEGE",NA,NA,506,345,161,32,7,25,0.072,0.063,0.043,3320,43
"7320",190637,1996,1,0,"CUNY LEHMAN COLLEGE",NA,NA,605,422,183,45,8,37,0.088,0.074,0.044,3320,47
"7321",190637,1997,1,0,"CUNY LEHMAN COLLEGE",NA,NA,736,519,217,45,11,34,0.066,0.061,0.051,3320,56
"7322",190637,1998,1,0,"CUNY LEHMAN COLLEGE",NA,NA,581,398,183,28,8,20,0.05,0.048,0.044,3320,48
"7323",190637,1999,1,0,"CUNY LEHMAN COLLEGE",NA,NA,604,416,188,44,19,25,0.06,0.073,0.101,3200,51
"7324",190637,2000,1,0,"CUNY LEHMAN COLLEGE",NA,NA,542,367,175,45,11,34,0.093,0.083,0.063,3200,41
"7325",190637,2001,1,0,"CUNY LEHMAN COLLEGE",NA,NA,642,441,201,77,18,59,0.134,0.12,0.09,3200,39
"7326",190637,2002,1,0,"CUNY LEHMAN COLLEGE",NA,NA,729,485,244,73,21,52,0.107,0.1,0.086,3200,49
"7327",190637,2003,1,0,"CUNY LEHMAN COLLEGE",NA,NA,790,529,261,85,20,65,0.123,0.108,0.077,4000,59
"7328",190637,2004,1,0,"CUNY LEHMAN COLLEGE",NA,NA,852,571,281,100,27,73,0.128,0.117,0.096,4000,64
"7329",190637,2005,1,0,"CUNY Lehman College",NA,NA,788,551,237,110,33,77,0.14,0.14,0.139,4000,52
"7330",190637,2006,1,0,"CUNY Lehman College",NA,NA,911,674,237,131,24,107,0.159,0.144,0.101,4000,64
"7331",190637,2007,1,0,"CUNY Lehman College",NA,NA,874,610,264,129,35,94,0.154,0.148,0.133,4000,59
"7332",190637,2008,1,0,"CUNY Lehman College",NA,NA,987,654,333,139,40,99,0.151,0.141,0.12,4000,63
"7333",190637,2009,1,0,"CUNY Lehman College",NA,NA,754,461,293,111,34,77,0.167,0.147,0.116,4600,55
"7334",190637,2010,1,0,"CUNY Lehman College",NA,NA,619,386,233,116,33,83,0.215,0.187,0.142,4600,45
"7335",190664,1991,1,0,"CUNY QUEENS COLLEGE",NA,NA,1603,889,714,165,49,116,0.13,0.103,0.069,2033,848
"7336",190664,1992,1,0,"QUEENS COLLEGE",NA,NA,1448,819,629,146,35,111,0.136,0.101,0.056,2635,808
"7337",190664,1993,1,0,"QUEENS COLLEGE",NA,NA,1526,831,695,180,55,125,0.15,0.118,0.079,2635,809
"7338",190664,1995,1,0,"QUEENS COLLEGE",NA,NA,1444,805,639,228,81,147,0.183,0.158,0.127,3392,777
"7339",190664,1996,1,0,"QUEENS COLLEGE",NA,NA,1040,621,419,225,56,169,0.272,0.216,0.134,3393,547
"7340",190664,1997,1,0,"CUNY QUEENS COLLEGE",NA,NA,1153,675,478,227,65,162,0.24,0.197,0.136,3393,578
"7341",190664,1998,1,0,"CUNY QUEENS COLLEGE",NA,NA,1133,711,422,235,59,176,0.248,0.207,0.14,3393,558
"7342",190664,1999,1,0,"CUNY QUEENS COLLEGE",NA,NA,876,528,348,200,50,150,0.284,0.228,0.144,3200,448
"7343",190664,2000,1,0,"CUNY QUEENS COLLEGE",NA,NA,1085,639,446,254,65,189,0.296,0.234,0.146,3200,496
"7344",190664,2001,1,0,"CUNY QUEENS COLLEGE",NA,NA,1204,704,500,325,100,225,0.32,0.27,0.2,3200,557
"7345",190664,2002,1,0,"CUNY QUEENS COLLEGE",NA,NA,1178,693,485,325,90,235,0.339,0.276,0.186,3200,596
"7346",190664,2003,1,0,"CUNY QUEENS COLLEGE",NA,NA,1290,790,500,327,88,239,0.302,0.253,0.176,4000,626
"7347",190664,2004,1,0,"CUNY QUEENS COLLEGE",NA,NA,1352,815,537,352,102,250,0.307,0.26,0.19,4000,629
"7348",190664,2005,1,0,"CUNY Queens College",NA,NA,1470,884,586,381,101,280,0.317,0.259,0.172,4000,708
"7349",190664,2006,1,0,"CUNY Queens College",NA,NA,1627,991,636,418,113,305,0.308,0.257,0.178,4000,762
"7350",190664,2007,1,0,"CUNY Queens College",NA,NA,1755,1064,691,440,112,328,0.308,0.251,0.162,4000,776
"7351",190664,2008,1,0,"CUNY Queens College",NA,NA,1642,961,681,445,125,320,0.333,0.271,0.184,4000,667
"7352",190664,2009,1,0,"CUNY Queens College",NA,NA,1684,944,740,473,153,320,0.339,0.281,0.207,4600,781
"7353",190664,2010,1,0,"CUNY Queens College",NA,NA,1471,821,650,452,133,319,0.389,0.307,0.205,4600,679
"7354",190691,1991,1,0,"CUNY YORK COLLEGE",NA,NA,431,276,155,22,10,12,0.044,0.051,0.065,1932,17
"7355",190691,1992,1,0,"CUNY YORK COLLEGE",NA,NA,640,392,248,22,12,10,0.025,0.034,0.048,2534,27
"7356",190691,1993,1,0,"CUNY YORK COLLEGE",NA,NA,607,359,248,29,13,16,0.045,0.048,0.052,2534,28
"7357",190691,1995,1,0,"CUNY YORK COLLEGE",NA,NA,486,294,192,22,7,15,0.051,0.045,0.036,3291,27
"7358",190691,1996,1,0,"CUNY YORK COLLEGE",NA,NA,543,368,175,47,16,31,0.084,0.087,0.091,3292,29
"7359",190691,1997,1,0,"CUNY YORK COLLEGE",NA,NA,500,323,177,38,12,26,0.08,0.076,0.068,3292,26
"7360",190691,1998,1,0,"CUNY YORK COLLEGE",NA,NA,383,235,148,22,8,14,0.06,0.057,0.054,3292,27
"7361",190691,1999,1,0,"CUNY YORK COLLEGE",NA,NA,425,261,164,31,11,20,0.077,0.073,0.067,3200,23
"7362",190691,2000,1,0,"CUNY YORK COLLEGE",NA,NA,458,314,144,29,6,23,0.073,0.063,0.042,3200,30
"7363",190691,2001,1,0,"CUNY YORK COLLEGE",NA,NA,464,320,144,35,11,24,0.075,0.075,0.076,3200,28
"7364",190691,2002,1,0,"CUNY YORK COLLEGE",NA,NA,563,385,178,34,8,26,0.068,0.06,0.045,3200,27
"7365",190691,2003,1,0,"CUNY YORK COLLEGE",NA,NA,565,366,199,30,8,22,0.06,0.053,0.04,4000,37
"7366",190691,2004,1,0,"CUNY YORK COLLEGE",NA,NA,727,453,274,27,8,19,0.042,0.037,0.029,4000,45
"7367",190691,2005,1,0,"CUNY York College",NA,NA,746,481,265,27,5,22,0.046,0.036,0.019,4000,40
"7368",190691,2006,1,0,"CUNY York College",NA,NA,668,428,240,27,10,17,0.04,0.04,0.042,4000,46
"7369",190691,2007,1,0,"CUNY York College",NA,NA,983,636,347,50,11,39,0.061,0.051,0.032,4000,53
"7370",190691,2008,1,0,"CUNY York College",NA,NA,1024,673,351,80,26,54,0.08,0.078,0.074,4000,77
"7371",190691,2009,1,0,"CUNY York College",NA,NA,1028,627,401,50,12,38,0.061,0.049,0.03,4600,88
"7372",190691,2010,1,0,"CUNY York College",NA,NA,1085,652,433,71,16,55,0.084,0.065,0.037,4600,82
"7373",190725,1991,1,0,"DAEMEN COLLEGE",NA,NA,244,164,80,40,14,26,0.158,0.164,0.175,7980,207
"7374",190725,1992,1,0,"DAEMEN COLLEGE",NA,NA,302,205,97,45,9,36,0.176,0.149,0.093,8330,244
"7375",190725,1993,1,0,"DAEMEN COLLEGE",NA,NA,405,271,134,58,19,39,0.144,0.143,0.142,8730,358
"7376",190725,1995,1,0,"DAEMEN COLLEGE",NA,NA,398,269,129,77,20,57,0.212,0.193,0.155,9780,362
"7377",190725,1996,1,0,"DAEMEN COLLEGE",NA,NA,372,259,113,69,11,58,0.224,0.185,0.097,10330,336
"7378",190725,1997,1,0,"DAEMEN COLLEGE",NA,NA,416,313,103,87,22,65,0.208,0.209,0.214,10980,360
"7379",190725,1998,1,0,"DAEMEN COLLEGE",NA,NA,345,262,83,80,20,60,0.229,0.232,0.241,11100,293
"7380",190725,1999,1,0,"DAEMEN COLLEGE",NA,NA,293,230,63,70,17,53,0.23,0.239,0.27,11800,222
"7381",190725,2000,1,0,"DAEMEN COLLEGE",NA,NA,317,254,63,77,13,64,0.252,0.243,0.206,12500,247
"7382",190725,2001,1,0,"DAEMEN COLLEGE",NA,NA,340,278,62,88,12,76,0.273,0.259,0.194,13200,243
"7383",190725,2002,1,0,"DAEMEN COLLEGE",NA,NA,316,246,70,84,16,68,0.276,0.266,0.229,13850,254
"7384",190725,2003,1,0,"DAEMEN COLLEGE",NA,NA,356,252,104,108,23,85,0.337,0.303,0.221,14700,269
"7385",190725,2004,1,0,"DAEMEN COLLEGE",NA,NA,264,198,66,62,11,51,0.258,0.235,0.167,15570,191
"7386",190725,2005,1,0,"Daemen College",NA,NA,366,288,78,91,12,79,0.274,0.249,0.154,16350,300
"7387",190725,2006,1,0,"Daemen College",NA,NA,368,284,84,100,22,78,0.275,0.272,0.262,17240,315
"7388",190725,2007,1,0,"Daemen College",NA,NA,361,268,93,99,19,80,0.299,0.274,0.204,18300,299
"7389",190725,2008,1,0,"Daemen College",NA,NA,405,309,96,110,24,86,0.278,0.272,0.25,19400,324
"7390",190725,2009,1,0,"Daemen College",NA,NA,400,306,94,103,29,74,0.242,0.258,0.309,20250,320
"7391",190725,2010,1,0,"Daemen College",NA,NA,441,325,116,148,36,112,0.345,0.336,0.31,20950,314
"7392",191241,1991,1,0,"FORDHAM UNIVERSITY",NA,NA,952,507,445,641,292,349,0.688,0.673,0.656,11100,677
"7393",191241,1992,1,0,"FORDHAM UNIVERSITY",NA,NA,1039,546,493,623,294,329,0.603,0.6,0.596,12170,693
"7394",191241,1993,1,0,"FORDHAM UNIVERSITY",NA,NA,989,532,457,587,271,316,0.594,0.594,0.593,13375,629
"7395",191241,1995,1,0,"FORDHAM UNIVERSITY",NA,NA,1120,620,500,794,323,471,0.76,0.709,0.646,14900,777
"7396",191241,1996,1,0,"FORDHAM UNIVERSITY",NA,NA,1206,694,512,822,338,484,0.697,0.682,0.66,15800,789
"7397",191241,1997,1,0,"FORDHAM UNIVERSITY",NA,NA,1459,849,610,1075,445,630,0.742,0.737,0.73,16800,971
"7398",191241,1998,1,0,"FORDHAM UNIVERSITY",NA,NA,1532,912,620,1111,422,689,0.755,0.725,0.681,18435,992
"7399",191241,1999,1,0,"FORDHAM UNIVERSITY",NA,NA,1538,891,647,1105,443,662,0.743,0.718,0.685,19200,1008
"7400",191241,2000,1,0,"FORDHAM UNIVERSITY",NA,NA,1632,975,657,1183,468,715,0.733,0.725,0.712,20200,1008
"7401",191241,2001,1,0,"FORDHAM UNIVERSITY",NA,NA,1610,950,660,1218,470,748,0.787,0.757,0.712,21210,1022
"7402",191241,2002,1,0,"FORDHAM UNIVERSITY",NA,NA,1694,1020,674,1263,478,785,0.77,0.746,0.709,22913,1042
"7403",191241,2003,1,0,"FORDHAM UNIVERSITY",NA,NA,1687,961,726,1265,547,718,0.747,0.75,0.753,24001,1045
"7404",191241,2004,1,0,"FORDHAM UNIVERSITY",NA,NA,1674,997,677,1269,486,783,0.785,0.758,0.718,26085,986
"7405",191241,2005,1,0,"Fordham University",NA,NA,1734,983,751,1282,548,734,0.747,0.739,0.73,27769,1069
"7406",191241,2006,1,0,"Fordham University",NA,NA,1697,929,768,1300,578,722,0.777,0.766,0.753,29715,1083
"7407",191241,2007,1,0,"Fordham University",NA,NA,1760,910,850,1338,645,693,0.762,0.76,0.759,31375,1056
"7408",191241,2008,1,0,"Fordham University",NA,NA,1852,991,861,1385,629,756,0.763,0.748,0.731,34099,1078
"7409",191241,2009,1,0,"Fordham University",NA,NA,1811,926,885,1358,647,711,0.768,0.75,0.731,35717,1169
"7410",191241,2010,1,0,"Fordham University",NA,NA,1865,1021,844,1388,607,781,0.765,0.744,0.719,37050,1223
"7411",191515,1991,1,0,"HAMILTON COLLEGE",NA,NA,462,207,255,384,204,180,0.87,0.831,0.8,16650,391
"7412",191515,1992,1,0,"HAMILTON COLLEGE",NA,NA,461,223,238,373,178,195,0.874,0.809,0.748,17650,385
"7413",191515,1993,1,0,"HAMILTON COLLEGE",NA,NA,452,195,257,361,192,169,0.867,0.799,0.747,18650,378
"7414",191515,1995,1,0,"HAMILTON COLLEGE",NA,NA,488,237,251,392,194,198,0.835,0.803,0.773,20700,435
"7415",191515,1996,1,0,"HAMILTON COLLEGE",NA,NA,497,239,258,392,196,196,0.82,0.789,0.76,21700,446
"7416",191515,1997,1,0,"HAMILTON COLLEGE",NA,NA,457,239,218,381,172,209,0.875,0.834,0.789,22700,400
"7417",191515,1998,1,0,"HAMILTON COLLEGE",NA,NA,464,238,226,372,170,202,0.849,0.802,0.752,23600,396
"7418",191515,1999,1,0,"HAMILTON COLLEGE",NA,NA,500,254,246,408,190,218,0.858,0.816,0.772,25000,418
"7419",191515,2000,1,0,"HAMILTON COLLEGE",NA,NA,467,251,216,386,172,214,0.853,0.827,0.796,26000,383
"7420",191515,2001,1,0,"HAMILTON COLLEGE",NA,NA,465,233,232,386,185,201,0.863,0.83,0.797,27250,389
"7421",191515,2002,1,0,"HAMILTON COLLEGE",NA,NA,492,252,240,418,195,223,0.885,0.85,0.812,28610,403
"7422",191515,2003,1,0,"HAMILTON COLLEGE",NA,NA,464,234,230,383,185,198,0.846,0.825,0.804,30000,370
"7423",191515,2004,1,0,"HAMILTON COLLEGE",NA,NA,457,236,221,385,180,205,0.869,0.842,0.814,31500,281
"7424",191515,2005,1,0,"Hamilton College",NA,NA,496,248,248,417,198,219,0.883,0.841,0.798,33150,342
"7425",191515,2006,1,0,"Hamilton College",NA,NA,501,267,234,424,195,229,0.858,0.846,0.833,34780,360
"7426",191515,2007,1,0,"Hamilton College",NA,NA,468,247,221,419,193,226,0.915,0.895,0.873,36500,338
"7427",191515,2008,1,0,"Hamilton College",NA,NA,461,257,204,396,164,232,0.903,0.859,0.804,38220,309
"7428",191515,2009,1,0,"Hamilton College",NA,NA,466,241,225,407,180,227,0.942,0.873,0.8,39370,291
"7429",191515,2010,1,0,"Hamilton College",NA,NA,467,252,215,414,185,229,0.909,0.887,0.86,40870,279
"7430",191533,1991,1,0,"HARTWICK COLLEGE",NA,NA,370,217,153,201,74,127,0.585,0.543,0.484,13350,341
"7431",191533,1992,1,0,"HARTWICK COLLEGE",NA,NA,446,228,218,248,108,140,0.614,0.556,0.495,14350,410
"7432",191533,1993,1,0,"HARTWICK COLLEGE",NA,NA,429,217,212,201,80,121,0.558,0.469,0.377,16400,383
"7433",191533,1995,1,0,"HARTWICK COLLEGE",NA,NA,453,229,224,227,88,139,0.607,0.501,0.393,19300,396
"7434",191533,1996,1,0,"HARTWICK COLLEGE",NA,NA,482,257,225,228,93,135,0.525,0.473,0.413,20805,411
"7435",191533,1997,1,0,"HARTWICK COLLEGE",NA,NA,388,197,191,209,94,115,0.584,0.539,0.492,21065,283
"7436",191533,1998,1,0,"HARTWICK COLLEGE",NA,NA,440,227,213,204,82,122,0.537,0.464,0.385,23090,305
"7437",191533,1999,1,0,"HARTWICK COLLEGE",NA,NA,407,210,197,192,75,117,0.557,0.472,0.381,23745,287
"7438",191533,2000,1,0,"HARTWICK COLLEGE",NA,NA,425,245,180,188,61,127,0.518,0.442,0.339,24760,290
"7439",191533,2001,1,0,"HARTWICK COLLEGE",NA,NA,433,232,201,200,73,127,0.547,0.462,0.363,25715,272
"7440",191533,2002,1,0,"HARTWICK COLLEGE",NA,NA,375,224,151,165,56,109,0.487,0.44,0.371,26615,255
"7441",191533,2003,1,0,"HARTWICK COLLEGE",NA,NA,447,236,211,210,77,133,0.564,0.47,0.365,27400,279
"7442",191533,2004,1,0,"HARTWICK COLLEGE",NA,NA,409,219,190,189,80,109,0.498,0.462,0.421,25830,254
"7443",191533,2005,1,0,"Hartwick College",NA,NA,405,212,193,182,77,105,0.495,0.449,0.399,26480,256
"7444",191533,2006,1,0,"Hartwick College",NA,NA,464,270,194,235,88,147,0.544,0.506,0.454,27450,302
"7445",191533,2007,1,0,"Hartwick College",NA,NA,452,256,196,243,92,151,0.59,0.538,0.469,30125,290
"7446",191533,2008,1,0,"Hartwick College",NA,NA,444,250,194,224,91,133,0.532,0.505,0.469,31330,292
"7447",191533,2009,1,0,"Hartwick College",NA,NA,402,239,163,202,66,136,0.569,0.502,0.405,32550,253
"7448",191533,2010,1,0,"Hartwick College",NA,NA,487,270,217,241,104,137,0.507,0.495,0.479,33850,344
"7449",191630,1991,0,1,"HOBART WILLIAM SMITH COLLEGES",2000,0,503,211,292,334,174,160,0.758,0.664,0.596,16396,419
"7450",191630,1992,0,1,"HOBART WILLIAM SMITH COLLEGES",2000,0,564,261,303,349,167,182,0.697,0.619,0.551,17291,481
"7451",191630,1993,0,1,"HOBART WILLIAM SMITH COLLEGES",2000,0,493,236,257,325,146,179,0.758,0.659,0.568,18309,435
"7452",191630,1995,0,1,"HOBART WILLIAM SMITH COLLEGES",2000,0,458,244,214,318,137,181,0.742,0.694,0.64,20393,399
"7453",191630,1996,0,1,"HOBART WILLIAM SMITH COLLEGES",2000,0,530,267,263,356,161,195,0.73,0.672,0.612,21381,445
"7454",191630,1997,0,1,"HOBART WILLIAM SMITH COLLEGES",2000,0,549,284,265,354,174,180,0.634,0.645,0.657,22380,448
"7455",191630,1998,0,1,"HOBART WILLIAM SMITH COLLEGES",2000,0,488,280,208,347,129,218,0.779,0.711,0.62,23448,416
"7456",191630,1999,0,1,"HOBART WILLIAM SMITH COLLEGES",2000,0,502,255,247,307,133,174,0.682,0.612,0.538,23865,440
"7457",191630,2000,1,0,"HOBART WILLIAM SMITH COLLEGES",2000,1,521,282,239,353,144,209,0.741,0.678,0.603,24700,445
"7458",191630,2001,1,0,"HOBART WILLIAM SMITH COLLEGES",2000,1,548,313,235,368,137,231,0.738,0.672,0.583,25664,473
"7459",191630,2002,1,0,"HOBART WILLIAM SMITH COLLEGES",2000,1,532,283,249,367,151,216,0.763,0.69,0.606,26818,457
"7460",191630,2003,1,0,"HOBART WILLIAM SMITH COLLEGES",2000,1,516,267,249,383,176,207,0.775,0.742,0.707,28400,448
"7461",191630,2004,1,0,"HOBART WILLIAM SMITH COLLEGES",2000,1,482,255,227,337,142,195,0.765,0.699,0.626,30076,428
"7462",191630,2005,1,0,"Hobart William Smith Colleges",2000,1,545,283,262,377,159,218,0.77,0.692,0.607,31850,475
"7463",191630,2006,1,0,"Hobart William Smith Colleges",2000,1,597,319,278,428,182,246,0.771,0.717,0.655,33730,534
"7464",191630,2007,1,0,"Hobart William Smith Colleges",2000,1,600,338,262,444,172,272,0.805,0.74,0.656,35720,419
"7465",191630,2008,1,0,"Hobart William Smith Colleges",2000,1,544,288,256,404,179,225,0.781,0.743,0.699,37820,262
"7466",191630,2009,1,0,"Hobart William Smith Colleges",2000,1,545,315,230,416,161,255,0.809,0.763,0.7,39144,311
"7467",191630,2010,1,0,"Hobart William Smith Colleges",2000,1,618,339,279,448,182,266,0.785,0.725,0.652,40592,442
"7468",191649,1991,1,0,"HOFSTRA UNIVERSITY",NA,NA,1338,747,591,567,190,377,0.505,0.424,0.321,9790,628
"7469",191649,1992,1,0,"HOFSTRA UNIVERSITY",NA,NA,1403,769,634,571,196,375,0.488,0.407,0.309,10490,656
"7470",191649,1993,1,0,"HOFSTRA UNIVERSITY",NA,NA,1349,705,644,524,191,333,0.472,0.388,0.297,11080,902
"7471",191649,1995,1,0,"HOFSTRA UNIVERSITY",NA,NA,1518,830,688,559,201,358,0.431,0.368,0.292,12360,970
"7472",191649,1996,1,0,"HOFSTRA UNIVERSITY",NA,NA,1735,996,739,653,217,436,0.438,0.376,0.294,12966,664
"7473",191649,1997,1,0,"HOFSTRA UNIVERSITY",NA,NA,1743,928,815,648,221,427,0.46,0.372,0.271,13544,924
"7474",191649,1998,1,0,"HOFSTRA UNIVERSITY",NA,NA,1749,907,842,593,217,376,0.415,0.339,0.258,14000,972
"7475",191649,1999,1,0,"HOFSTRA UNIVERSITY",NA,NA,1876,1015,861,675,242,433,0.427,0.36,0.281,13750,1105
"7476",191649,2000,1,0,"HOFSTRA UNIVERSITY",NA,NA,1937,1036,901,703,266,437,0.422,0.363,0.295,14280,1101
"7477",191649,2001,1,0,"HOFSTRA UNIVERSITY",NA,NA,1974,1037,937,685,248,437,0.421,0.347,0.265,14920,1232
"7478",191649,2002,1,0,"HOFSTRA UNIVERSITY",NA,NA,1764,912,852,693,254,439,0.481,0.393,0.298,15740,1181
"7479",191649,2003,1,0,"HOFSTRA UNIVERSITY",NA,NA,1855,979,876,768,290,478,0.488,0.414,0.331,17410,1181
"7480",191649,2004,1,0,"HOFSTRA UNIVERSITY",NA,NA,1713,885,828,750,303,447,0.505,0.438,0.366,19010,1102
"7481",191649,2005,1,0,"Hofstra University",NA,NA,1759,961,798,763,281,482,0.502,0.434,0.352,20500,1065
"7482",191649,2006,1,0,"Hofstra University",NA,NA,1706,865,841,768,335,433,0.501,0.45,0.398,22200,1067
"7483",191649,2007,1,0,"Hofstra University",NA,NA,1716,907,809,850,344,506,0.558,0.495,0.425,25700,1131
"7484",191649,2008,1,0,"Hofstra University",NA,NA,1637,864,773,816,344,472,0.546,0.498,0.445,27600,1137
"7485",191649,2009,1,0,"Hofstra University",NA,NA,1554,834,720,755,297,458,0.549,0.486,0.412,29080,1045
"7486",191649,2010,1,0,"Hofstra University",NA,NA,1435,819,616,764,289,475,0.58,0.532,0.469,30750,884
"7487",191676,1991,1,0,"HOUGHTON COLLEGE",NA,NA,244,152,92,119,46,73,0.48,0.488,0.5,8676,219
"7488",191676,1992,1,0,"HOUGHTON COLLEGE",NA,NA,296,195,101,141,44,97,0.497,0.476,0.436,9230,264
"7489",191676,1993,1,0,"HOUGHTON COLLEGE",NA,NA,287,182,105,147,50,97,0.533,0.512,0.476,9720,254
"7490",191676,1995,1,0,"HOUGHTON COLLEGE",NA,NA,293,213,80,171,52,119,0.559,0.584,0.65,10890,263
"7491",191676,1996,1,0,"HOUGHTON COLLEGE",NA,NA,288,194,94,164,47,117,0.603,0.569,0.5,12060,252
"7492",191676,1997,1,0,"HOUGHTON COLLEGE",NA,NA,310,198,112,179,65,114,0.576,0.577,0.58,12764,277
"7493",191676,1998,1,0,"HOUGHTON COLLEGE",NA,NA,309,204,105,180,50,130,0.637,0.583,0.476,12776,272
"7494",191676,1999,1,0,"HOUGHTON COLLEGE",NA,NA,294,186,108,166,56,110,0.591,0.565,0.519,14590,273
"7495",191676,2000,1,0,"HOUGHTON COLLEGE",NA,NA,358,226,132,217,75,142,0.628,0.606,0.568,15180,330
"7496",191676,2001,1,0,"HOUGHTON COLLEGE",NA,NA,355,229,126,222,77,145,0.633,0.625,0.611,16290,328
"7497",191676,2002,1,0,"HOUGHTON COLLEGE",NA,NA,289,201,88,187,54,133,0.662,0.647,0.614,17160,262
"7498",191676,2003,1,0,"HOUGHTON COLLEGE",NA,NA,299,203,96,179,53,126,0.621,0.599,0.552,17984,272
"7499",191676,2004,1,0,"HOUGHTON COLLEGE",NA,NA,320,212,108,186,56,130,0.613,0.581,0.519,18660,290
"7500",191676,2005,1,0,"Houghton College",NA,NA,321,211,110,180,57,123,0.583,0.561,0.518,19420,299
"7501",191676,2006,1,0,"Houghton College",NA,NA,306,195,111,177,58,119,0.61,0.578,0.523,20400,276
"7502",191676,2007,1,0,"Houghton College",NA,NA,264,174,90,171,54,117,0.672,0.648,0.6,21620,239
"7503",191676,2008,1,0,"Houghton College",NA,NA,327,211,116,193,56,137,0.649,0.59,0.483,22990,284
"7504",191676,2009,1,0,"Houghton College",NA,NA,282,199,83,186,53,133,0.668,0.66,0.639,24440,245
"7505",191676,2010,1,0,"Houghton College",NA,NA,253,178,75,154,46,108,0.607,0.609,0.613,25360,221
"7506",191931,1991,1,0,"IONA COLLEGE",NA,NA,1046,526,520,290,122,168,0.319,0.277,0.235,9000,646
"7507",191931,1992,1,0,"IONA COLLEGE",NA,NA,1012,522,490,322,136,186,0.356,0.318,0.278,9500,663
"7508",191931,1993,1,0,"IONA COLLEGE",NA,NA,951,455,496,260,117,143,0.314,0.273,0.236,10210,641
"7509",191931,1995,1,0,"IONA COLLEGE",NA,NA,609,288,321,203,73,130,0.451,0.333,0.227,11330,369
"7510",191931,1996,1,0,"IONA COLLEGE",NA,NA,662,320,342,260,100,160,0.5,0.393,0.292,12200,422
"7511",191931,1997,1,0,"IONA COLLEGE",NA,NA,695,312,383,263,98,165,0.529,0.378,0.256,13420,439
"7512",191931,1998,1,0,"IONA COLLEGE",NA,NA,696,302,394,279,117,162,0.536,0.401,0.297,14000,501
"7513",191931,1999,1,0,"IONA COLLEGE",NA,NA,790,349,441,335,147,188,0.539,0.424,0.333,14700,540
"7514",191931,2000,1,0,"IONA COLLEGE",NA,NA,723,351,372,337,132,205,0.584,0.466,0.355,15500,518
"7515",191931,2001,1,0,"IONA COLLEGE",NA,NA,768,376,392,360,144,216,0.575,0.469,0.367,16500,503
"7516",191931,2002,1,0,"IONA COLLEGE",NA,NA,731,379,352,337,123,214,0.565,0.461,0.349,17326,492
"7517",191931,2003,1,0,"IONA COLLEGE",NA,NA,811,434,377,409,152,257,0.592,0.504,0.403,17750,553
"7518",191931,2004,1,0,"IONA COLLEGE",NA,NA,854,458,396,448,175,273,0.596,0.525,0.442,18990,617
"7519",191931,2005,1,0,"Iona College",NA,NA,776,419,357,375,150,225,0.537,0.483,0.42,20110,537
"7520",191931,2006,1,0,"Iona College",NA,NA,903,504,399,506,181,325,0.645,0.56,0.454,21518,622
"7521",191931,2007,1,0,"Iona College",NA,NA,906,486,420,476,195,281,0.578,0.525,0.464,23024,623
"7522",191931,2008,1,0,"Iona College",NA,NA,921,498,423,469,167,302,0.606,0.509,0.395,24406,620
"7523",191931,2009,1,0,"Iona College",NA,NA,792,480,312,448,150,298,0.621,0.566,0.481,25600,518
"7524",191931,2010,1,0,"Iona College",NA,NA,871,504,367,525,202,323,0.641,0.603,0.55,26850,556
"7525",191968,1991,1,0,"ITHACA COLLEGE",NA,NA,1638,831,807,1036,477,559,0.673,0.632,0.591,11946,1519
"7526",191968,1992,1,0,"ITHACA COLLEGE",NA,NA,1566,832,734,978,425,553,0.665,0.625,0.579,12870,1455
"7527",191968,1993,1,0,"ITHACA COLLEGE",NA,NA,1365,721,644,813,345,468,0.649,0.596,0.536,13642,1266
"7528",191968,1995,1,0,"ITHACA COLLEGE",NA,NA,1625,878,747,1052,440,612,0.697,0.647,0.589,15250,1472
"7529",191968,1996,1,0,"ITHACA COLLEGE",NA,NA,1426,820,606,908,355,553,0.674,0.637,0.586,16130,1302
"7530",191968,1997,1,0,"ITHACA COLLEGE",NA,NA,1417,801,616,909,362,547,0.683,0.641,0.588,16900,1286
"7531",191968,1998,1,0,"ITHACA COLLEGE",NA,NA,1337,759,578,909,379,530,0.698,0.68,0.656,17662,1232
"7532",191968,1999,1,0,"ITHACA COLLEGE",NA,NA,1586,885,701,1022,418,604,0.682,0.644,0.596,18410,1411
"7533",191968,2000,1,0,"ITHACA COLLEGE",NA,NA,1675,940,735,1149,474,675,0.718,0.686,0.645,19192,1468
"7534",191968,2001,1,0,"ITHACA COLLEGE",NA,NA,1755,1002,753,1230,501,729,0.728,0.701,0.665,20104,1569
"7535",191968,2002,1,0,"ITHACA COLLEGE",NA,NA,1515,896,619,1083,441,642,0.717,0.715,0.712,21102,1354
"7536",191968,2003,1,0,"ITHACA COLLEGE",NA,NA,1581,912,669,1118,456,662,0.726,0.707,0.682,22264,1332
"7537",191968,2004,1,0,"ITHACA COLLEGE",NA,NA,1458,831,627,1013,411,602,0.724,0.695,0.656,23690,1242
"7538",191968,2005,1,0,"Ithaca College",NA,NA,1679,885,794,1117,521,596,0.673,0.665,0.656,25194,1436
"7539",191968,2006,1,0,"Ithaca College",NA,NA,1519,819,700,1059,466,593,0.724,0.697,0.666,26832,1180
"7540",191968,2007,1,0,"Ithaca College",NA,NA,1794,1055,739,1241,488,753,0.714,0.692,0.66,28670,1422
"7541",191968,2008,1,0,"Ithaca College",NA,NA,1441,862,579,1017,397,620,0.719,0.706,0.686,30606,972
"7542",191968,2009,1,0,"Ithaca College",NA,NA,2024,1144,880,1390,571,819,0.716,0.687,0.649,32060,1452
"7543",191968,2010,1,0,"Ithaca College",NA,NA,1614,869,745,1071,442,629,0.724,0.664,0.593,33630,1132
"7544",192192,1991,1,0,"KEUKA COLLEGE",NA,NA,139,112,27,65,15,50,0.446,0.468,0.556,7900,128
"7545",192192,1992,1,0,"KEUKA COLLEGE",NA,NA,160,121,39,53,12,41,0.339,0.331,0.308,8770,154
"7546",192192,1993,1,0,"KEUKA COLLEGE",NA,NA,172,124,48,47,13,34,0.274,0.273,0.271,9100,155
"7547",192192,1995,1,0,"KEUKA COLLEGE",NA,NA,200,154,46,69,10,59,0.383,0.345,0.217,9960,189
"7548",192192,1996,1,0,"KEUKA COLLEGE",NA,NA,234,168,66,61,17,44,0.262,0.261,0.258,10490,217
"7549",192192,1997,1,0,"KEUKA COLLEGE",NA,NA,141,112,29,69,12,57,0.509,0.489,0.414,11040,139
"7550",192192,1998,1,0,"KEUKA COLLEGE",NA,NA,226,180,46,75,15,60,0.333,0.332,0.326,12185,214
"7551",192192,1999,1,0,"KEUKA COLLEGE",NA,NA,268,192,76,90,23,67,0.349,0.336,0.303,12730,236
"7552",192192,2000,1,0,"KEUKA COLLEGE",NA,NA,281,183,98,83,28,55,0.3,0.295,0.286,13490,218
"7553",192192,2001,1,0,"KEUKA COLLEGE",NA,NA,253,188,65,88,14,74,0.394,0.348,0.215,14050,225
"7554",192192,2002,1,0,"KEUKA COLLEGE",NA,NA,195,138,57,81,21,60,0.435,0.415,0.368,14890,167
"7555",192192,2003,1,0,"KEUKA COLLEGE",NA,NA,239,168,71,107,29,78,0.464,0.448,0.408,15790,209
"7556",192192,2004,1,0,"KEUKA COLLEGE",NA,NA,245,170,75,120,29,91,0.535,0.49,0.387,16820,208
"7557",192192,2005,1,0,"Keuka College",NA,NA,268,179,89,111,31,80,0.447,0.414,0.348,17800,229
"7558",192192,2006,1,0,"Keuka College",NA,NA,232,147,85,106,44,62,0.422,0.457,0.518,18850,195
"7559",192192,2007,1,0,"Keuka College",NA,NA,274,192,82,98,28,70,0.365,0.358,0.341,19960,217
"7560",192192,2008,1,0,"Keuka College",NA,NA,270,200,70,98,21,77,0.385,0.363,0.3,21140,220
"7561",192192,2009,1,0,"Keuka College",NA,NA,254,175,79,57,24,33,0.189,0.224,0.304,22040,210
"7562",192192,2010,1,0,"Keuka College",NA,NA,270,196,74,141,32,109,0.556,0.522,0.432,23130,210
"7563",192323,1991,1,0,"LE MOYNE COLLEGE",NA,NA,404,212,192,261,118,143,0.674,0.646,0.615,9290,354
"7564",192323,1992,1,0,"LE MOYNE COLLEGE",NA,NA,371,215,156,254,105,149,0.693,0.685,0.673,9620,328
"7565",192323,1993,1,0,"LE MOYNE COLLEGE",NA,NA,415,213,202,254,107,147,0.69,0.612,0.53,10640,362
"7566",192323,1995,1,0,"LE MOYNE COLLEGE",NA,NA,397,236,161,258,98,160,0.678,0.65,0.609,12015,329
"7567",192323,1996,1,0,"LE MOYNE COLLEGE",NA,NA,434,255,179,305,115,190,0.745,0.703,0.642,12750,395
"7568",192323,1997,1,0,"LE MOYNE COLLEGE",NA,NA,453,292,161,299,101,198,0.678,0.66,0.627,13520,389
"7569",192323,1998,1,0,"LE MOYNE COLLEGE",NA,NA,471,279,192,309,114,195,0.699,0.656,0.594,14230,406
"7570",192323,1999,1,0,"LE MOYNE COLLEGE",NA,NA,471,264,207,304,121,183,0.693,0.645,0.585,14580,389
"7571",192323,2000,1,0,"LE MOYNE COLLEGE",NA,NA,510,291,219,298,119,179,0.615,0.584,0.543,15370,413
"7572",192323,2001,1,0,"LE MOYNE COLLEGE",NA,NA,502,292,210,311,122,189,0.647,0.62,0.581,16350,428
"7573",192323,2002,1,0,"LE MOYNE COLLEGE",NA,NA,561,333,228,388,144,244,0.733,0.692,0.632,17410,458
"7574",192323,2003,1,0,"LE MOYNE COLLEGE",NA,NA,503,310,193,323,115,208,0.671,0.642,0.596,18440,422
"7575",192323,2004,1,0,"LE MOYNE COLLEGE",NA,NA,473,277,196,305,115,190,0.686,0.645,0.587,19640,384
"7576",192323,2005,1,0,"Le Moyne College",NA,NA,519,308,211,320,123,197,0.64,0.617,0.583,20770,425
"7577",192323,2006,1,0,"Le Moyne College",NA,NA,544,330,214,329,120,209,0.633,0.605,0.561,21860,451
"7578",192323,2007,1,0,"Le Moyne College",NA,NA,577,348,229,362,125,237,0.681,0.627,0.546,23040,483
"7579",192323,2008,1,0,"Le Moyne College",NA,NA,541,335,206,331,114,217,0.648,0.612,0.553,24280,456
"7580",192323,2009,1,0,"Le Moyne College",NA,NA,605,394,211,344,102,242,0.614,0.569,0.483,25110,495
"7581",192323,2010,1,0,"Le Moyne College",NA,NA,615,372,243,355,130,225,0.605,0.577,0.535,26350,511
"7582",192439,1991,1,0,"LONG ISLAND UNIVERSITY BROOKLYN CAMPUS",NA,NA,665,436,229,30,12,18,0.041,0.045,0.052,9280,91
"7583",192439,1992,1,0,"LONG ISLAND UNIVERSITY BROOKLYN CAMPUS",NA,NA,837,552,285,34,15,19,0.034,0.041,0.053,10670,156
"7584",192439,1993,1,0,"LONG ISLAND UNIVERSITY-BROOKLYN CAMPUS",NA,NA,918,633,285,36,13,23,0.036,0.039,0.046,10670,158
"7585",192439,1995,1,0,"LONG ISLAND UNIVERSITY-BROOKLYN CAMPUS",NA,NA,1043,700,343,55,17,38,0.054,0.053,0.05,12215,185
"7586",192439,1996,1,0,"LONG ISLAND UNIVERSITY-BROOKLYN CAMPUS",NA,NA,956,654,302,51,17,34,0.052,0.053,0.056,12840,165
"7587",192439,1997,1,0,"LONG ISLAND UNIVERSITY-BROOKLYN CAMPUS",NA,NA,915,595,320,33,13,20,0.034,0.036,0.041,13570,147
"7588",192439,1998,1,0,"LONG ISLAND UNIVERSITY-BROOKLYN CAMPUS",NA,NA,1061,689,372,44,8,36,0.052,0.041,0.022,14310,130
"7589",192439,1999,1,0,"LONG ISLAND UNIVERSITY-BROOKLYN CAMPUS",NA,NA,1010,719,291,38,12,26,0.036,0.038,0.041,14340,152
"7590",192439,2000,1,0,"LONG ISLAND UNIVERSITY-BROOKLYN CAMPUS",NA,NA,863,578,285,36,9,27,0.047,0.042,0.032,16100,112
"7591",192439,2001,1,0,"LONG ISLAND UNIVERSITY-BROOKLYN CAMPUS",NA,NA,825,574,251,55,20,35,0.061,0.067,0.08,17220,97
"7592",192439,2002,1,0,"LONG ISLAND UNIVERSITY-BROOKLYN CAMPUS",NA,NA,776,561,215,48,9,39,0.07,0.062,0.042,18250,85
"7593",192439,2003,1,0,"LONG ISLAND UNIVERSITY-BROOKLYN CAMPUS",NA,NA,680,480,200,45,10,35,0.073,0.066,0.05,19510,89
"7594",192439,2004,1,0,"LONG ISLAND UNIVERSITY-BROOKLYN CAMPUS",NA,NA,912,629,283,39,12,27,0.043,0.043,0.042,21150,152
"7595",192439,2005,1,0,"Long Island University-Brooklyn Campus",NA,NA,959,643,316,51,10,41,0.064,0.053,0.032,22048,175
"7596",192439,2006,1,0,"Long Island University-Brooklyn Campus",NA,NA,1079,730,349,56,14,42,0.058,0.052,0.04,23328,200
"7597",192439,2007,1,0,"Long Island University-Brooklyn Campus",NA,NA,1021,721,300,61,16,45,0.062,0.06,0.053,24672,166
"7598",192439,2008,1,0,"Long Island University-Brooklyn Campus",NA,NA,992,706,286,73,18,55,0.078,0.074,0.063,26048,187
"7599",192439,2009,1,0,"Long Island University-Brooklyn Campus",NA,NA,1005,692,313,81,19,62,0.09,0.081,0.061,27328,179
"7600",192439,2010,1,0,"Long Island University-Brooklyn Campus",NA,NA,883,618,265,58,13,45,0.073,0.066,0.049,25088,154
"7601",192703,1991,1,0,"MANHATTAN COLLEGE",NA,NA,548,258,290,298,137,161,0.624,0.544,0.472,11100,406
"7602",192703,1992,1,0,"MANHATTAN COLLEGE",NA,NA,577,250,327,244,120,124,0.496,0.423,0.367,11900,429
"7603",192703,1993,1,0,"MANHATTAN COLLEGE",NA,NA,546,254,292,307,152,155,0.61,0.562,0.521,12700,385
"7604",192703,1995,1,0,"MANHATTAN COLLEGE",NA,NA,572,256,316,321,160,161,0.629,0.561,0.506,14220,396
"7605",192703,1996,1,0,"MANHATTAN COLLEGE",NA,NA,557,258,299,313,143,170,0.659,0.562,0.478,14900,372
"7606",192703,1997,1,0,"MANHATTAN COLLEGE",NA,NA,527,235,292,269,134,135,0.575,0.51,0.459,15500,363
"7607",192703,1998,1,0,"MANHATTAN COLLEGE",NA,NA,547,274,273,328,159,169,0.617,0.6,0.582,16100,358
"7608",192703,1999,1,0,"MANHATTAN COLLEGE",NA,NA,645,289,356,386,195,191,0.661,0.598,0.548,15500,473
"7609",192703,2000,1,0,"MANHATTAN COLLEGE",NA,NA,623,315,308,361,153,208,0.66,0.579,0.497,16000,442
"7610",192703,2001,1,0,"MANHATTAN COLLEGE",NA,NA,597,276,321,344,162,182,0.659,0.576,0.505,16500,441
"7611",192703,2002,1,0,"MANHATTAN COLLEGE",NA,NA,769,401,368,501,228,273,0.681,0.651,0.62,17100,549
"7612",192703,2003,1,0,"MANHATTAN COLLEGE",NA,NA,638,342,296,400,173,227,0.664,0.627,0.584,17800,502
"7613",192703,2004,1,0,"MANHATTAN COLLEGE",NA,NA,657,343,314,420,182,238,0.694,0.639,0.58,18600,521
"7614",192703,2005,1,0,"Manhattan College",NA,NA,700,368,332,456,198,258,0.701,0.651,0.596,19400,555
"7615",192703,2006,1,0,"Manhattan College",NA,NA,710,353,357,466,234,232,0.657,0.656,0.655,20350,562
"7616",192703,2007,1,0,"Manhattan College",NA,NA,708,356,352,427,201,226,0.635,0.603,0.571,21640,571
"7617",192703,2008,1,0,"Manhattan College",NA,NA,726,351,375,475,226,249,0.709,0.654,0.603,22940,524
"7618",192703,2009,1,0,"Manhattan College",NA,NA,693,343,350,412,183,229,0.668,0.595,0.523,25100,493
"7619",192703,2010,1,0,"Manhattan College",NA,NA,658,300,358,375,190,185,0.617,0.57,0.531,25335,465
"7620",192749,1991,1,0,"MANHATTANVILLE COLLEGE",NA,NA,192,143,49,96,22,74,0.517,0.5,0.449,12760,123
"7621",192749,1992,1,0,"MANHATTANVILLE COLLEGE",NA,NA,183,139,44,106,23,83,0.597,0.579,0.523,13605,103
"7622",192749,1993,1,0,"MANHATTANVILLE COLLEGE",NA,NA,214,133,81,86,30,56,0.421,0.402,0.37,14450,132
"7623",192749,1995,1,0,"MANHATTANVILLE COLLEGE",NA,NA,161,115,46,87,18,69,0.6,0.54,0.391,15500,89
"7624",192749,1996,1,0,"MANHATTANVILLE COLLEGE",NA,NA,271,181,90,117,33,84,0.464,0.432,0.367,16120,148
"7625",192749,1997,1,0,"MANHATTANVILLE COLLEGE",NA,NA,294,202,92,148,40,108,0.535,0.503,0.435,17300,146
"7626",192749,1998,1,0,"MANHATTANVILLE COLLEGE",NA,NA,338,225,113,126,35,91,0.404,0.373,0.31,18130,184
"7627",192749,1999,1,0,"MANHATTANVILLE COLLEGE",NA,NA,387,266,121,195,57,138,0.519,0.504,0.471,18130,230
"7628",192749,2000,1,0,"MANHATTANVILLE COLLEGE",NA,NA,403,277,126,213,58,155,0.56,0.529,0.46,18860,241
"7629",192749,2001,1,0,"MANHATTANVILLE COLLEGE",NA,NA,404,277,127,226,65,161,0.581,0.559,0.512,19620,243
"7630",192749,2002,1,0,"MANHATTANVILLE COLLEGE",NA,NA,420,287,133,212,50,162,0.565,0.505,0.376,20600,249
"7631",192749,2003,1,0,"MANHATTANVILLE COLLEGE",NA,NA,422,295,127,223,68,155,0.525,0.528,0.535,22150,240
"7632",192749,2004,1,0,"MANHATTANVILLE COLLEGE",NA,NA,450,312,138,261,78,183,0.587,0.58,0.565,23620,259
"7633",192749,2005,1,0,"Manhattanville College",NA,NA,506,327,179,264,73,191,0.584,0.522,0.408,24920,316
"7634",192749,2006,1,0,"Manhattanville College",NA,NA,507,329,178,274,91,183,0.556,0.54,0.511,26920,289
"7635",192749,2007,1,0,"Manhattanville College",NA,NA,463,315,148,249,59,190,0.603,0.538,0.399,28540,229
"7636",192749,2008,1,0,"Manhattanville College",NA,NA,476,326,150,270,82,188,0.577,0.567,0.547,30400,223
"7637",192749,2009,1,0,"Manhattanville College",NA,NA,490,298,192,250,86,164,0.55,0.51,0.448,31490,202
"7638",192749,2010,1,0,"Manhattanville College",NA,NA,428,274,154,181,57,124,0.453,0.423,0.37,33030,199
"7639",192819,1991,1,0,"MARIST COLLEGE",NA,NA,881,489,392,441,166,275,0.562,0.501,0.423,9205,806
"7640",192819,1992,1,0,"MARIST COLLEGE",NA,NA,820,451,369,514,201,313,0.694,0.627,0.545,9826,697
"7641",192819,1993,1,0,"MARIST COLLEGE",NA,NA,806,460,346,371,134,237,0.515,0.46,0.387,10397,692
"7642",192819,1995,1,0,"MARIST COLLEGE",NA,NA,926,527,399,472,181,291,0.552,0.51,0.454,11590,513
"7643",192819,1996,1,0,"MARIST COLLEGE",NA,NA,839,482,357,510,187,323,0.67,0.608,0.524,12450,706
"7644",192819,1997,1,0,"MARIST COLLEGE",NA,NA,973,532,441,570,232,338,0.635,0.586,0.526,13098,755
"7645",192819,1998,1,0,"MARIST COLLEGE",NA,NA,834,430,404,547,240,307,0.714,0.656,0.594,13818,691
"7646",192819,1999,1,0,"MARIST COLLEGE",NA,NA,975,548,427,665,260,405,0.739,0.682,0.609,14374,803
"7647",192819,2000,1,0,"MARIST COLLEGE",NA,NA,993,589,404,690,272,418,0.71,0.695,0.673,15366,860
"7648",192819,2001,1,0,"MARIST COLLEGE",NA,NA,908,484,424,632,281,351,0.725,0.696,0.663,16364,764
"7649",192819,2002,1,0,"MARIST COLLEGE",NA,NA,956,576,380,693,252,441,0.766,0.725,0.663,17444,781
"7650",192819,2003,1,0,"MARIST COLLEGE",NA,NA,961,528,433,732,310,422,0.799,0.762,0.716,18432,807
"7651",192819,2004,1,0,"MARIST COLLEGE",NA,NA,955,536,419,699,282,417,0.778,0.732,0.673,19540,728
"7652",192819,2005,1,0,"Marist College",NA,NA,1017,585,432,697,258,439,0.75,0.685,0.597,20712,810
"7653",192819,2006,1,0,"Marist College",NA,NA,1038,573,465,737,309,428,0.747,0.71,0.665,22066,852
"7654",192819,2007,1,0,"Marist College",NA,NA,1019,561,458,713,295,418,0.745,0.7,0.644,23560,754
"7655",192819,2008,1,0,"Marist College",NA,NA,1018,611,407,697,249,448,0.733,0.685,0.612,25100,781
"7656",192819,2009,1,0,"Marist College",NA,NA,1041,577,464,708,279,429,0.743,0.68,0.601,26105,836
"7657",192819,2010,1,0,"Marist College",NA,NA,1088,612,476,814,331,483,0.789,0.748,0.695,27150,886
"7658",192925,1991,1,0,"MEDAILLE COLLEGE",NA,NA,143,79,64,23,6,17,0.215,0.161,0.094,7180,82
"7659",192925,1992,1,0,"MEDAILLE COLLEGE",NA,NA,185,86,99,21,4,17,0.198,0.114,0.04,7750,110
"7660",192925,1993,1,0,"MEDAILLE COLLEGE",NA,NA,202,94,108,38,16,22,0.234,0.188,0.148,8350,124
"7661",192925,1995,1,0,"MEDAILLE COLLEGE",NA,NA,78,50,28,15,5,10,0.2,0.192,0.179,9560,60
"7662",192925,1996,1,0,"MEDAILLE COLLEGE",NA,NA,81,58,23,6,2,4,0.069,0.074,0.087,9990,55
"7663",192925,1997,1,0,"MEDAILLE COLLEGE",NA,NA,164,102,62,19,6,13,0.128,0.116,0.097,10470,121
"7664",192925,1998,1,0,"MEDAILLE COLLEGE",NA,NA,153,113,40,45,15,30,0.266,0.294,0.375,10950,101
"7665",192925,1999,1,0,"MEDAILLE COLLEGE",NA,NA,143,104,39,31,6,25,0.24,0.217,0.154,11190,115
"7666",192925,2000,1,0,"MEDAILLE COLLEGE",NA,NA,208,153,55,36,10,26,0.17,0.173,0.182,11700,148
"7667",192925,2001,1,0,"MEDAILLE COLLEGE",NA,NA,208,166,42,53,12,41,0.247,0.255,0.286,12240,161
"7668",192925,2002,1,0,"MEDAILLE COLLEGE",NA,NA,308,204,104,69,25,44,0.216,0.224,0.24,12720,199
"7669",192925,2003,1,0,"MEDAILLE COLLEGE",NA,NA,241,146,95,100,42,58,0.397,0.415,0.442,13350,184
"7670",192925,2004,1,0,"MEDAILLE COLLEGE",NA,NA,296,179,117,85,36,49,0.274,0.287,0.308,14010,233
"7671",192925,2005,1,0,"Medaille College",NA,NA,203,126,77,62,27,35,0.278,0.305,0.351,15030,165
"7672",192925,2006,1,0,"Medaille College",NA,NA,320,198,122,87,38,49,0.248,0.272,0.311,15780,239
"7673",192925,2007,1,0,"Medaille College",NA,NA,409,255,154,131,56,75,0.294,0.32,0.364,16590,308
"7674",192925,2008,1,0,"Medaille College",NA,NA,408,253,155,105,49,56,0.221,0.257,0.316,17420,283
"7675",192925,2009,1,0,"Medaille College",NA,NA,402,257,145,104,35,69,0.268,0.259,0.241,19590,272
"7676",192925,2010,1,0,"Medaille College",NA,NA,377,234,143,112,46,66,0.282,0.297,0.322,20570,259
"7677",193016,1991,1,0,"MERCY COLLEGE - MAIN CAMPUS",NA,NA,619,329,290,19,5,14,0.043,0.031,0.017,6990,153
"7678",193016,1992,1,0,"MERCY COLLEGE-MAIN CAMPUS",NA,NA,867,534,333,19,7,12,0.022,0.022,0.021,7200,230
"7679",193016,1993,1,0,"MERCY COLLEGE-MAIN CAMPUS",NA,NA,733,403,330,16,6,10,0.025,0.022,0.018,7380,124
"7680",193016,1995,1,0,"MERCY COLLEGE-MAIN CAMPUS",NA,NA,1002,623,379,4,2,2,0.003,0.004,0.005,6600,429
"7681",193016,1996,1,0,"MERCY COLLEGE-MAIN CAMPUS",NA,NA,551,336,215,62,12,50,0.149,0.113,0.056,7200,143
"7682",193016,1997,1,0,"MERCY COLLEGE-MAIN CAMPUS",NA,NA,1052,692,360,46,16,30,0.043,0.044,0.044,7600,271
"7683",193016,1998,1,0,"MERCY COLLEGE-MAIN CAMPUS",NA,NA,907,582,325,53,14,39,0.067,0.058,0.043,7800,161
"7684",193016,1999,1,0,"MERCY COLLEGE-MAIN CAMPUS",NA,NA,953,630,323,68,18,50,0.079,0.071,0.056,7950,115
"7685",193016,2000,1,0,"MERCY COLLEGE-MAIN CAMPUS",NA,NA,637,421,216,69,10,59,0.14,0.108,0.046,8500,94
"7686",193016,2001,1,0,"MERCY COLLEGE-MAIN CAMPUS",NA,NA,618,412,206,61,10,51,0.124,0.099,0.049,8950,95
"7687",193016,2002,1,0,"MERCY COLLEGE-MAIN CAMPUS",NA,NA,680,425,255,69,14,55,0.129,0.101,0.055,10000,140
"7688",193016,2003,1,0,"MERCY COLLEGE-MAIN CAMPUS",NA,NA,611,379,232,58,10,48,0.127,0.095,0.043,10700,132
"7689",193016,2004,1,0,"MERCY COLLEGE-MAIN CAMPUS",NA,NA,649,421,228,79,18,61,0.145,0.122,0.079,11230,165
"7690",193016,2005,1,0,"Mercy College-Main Campus",NA,NA,485,324,161,53,11,42,0.13,0.109,0.068,11792,102
"7691",193016,2006,1,0,"Mercy College-Main Campus",NA,NA,614,390,224,79,22,57,0.146,0.129,0.098,12370,152
"7692",193016,2007,1,0,"Mercy College-Main Campus",NA,NA,532,343,189,111,21,90,0.262,0.209,0.111,13730,185
"7693",193016,2008,1,0,"Mercy College",NA,NA,677,441,236,92,14,78,0.177,0.136,0.059,14990,178
"7694",193016,2009,1,0,"Mercy College",NA,NA,880,552,328,157,39,118,0.214,0.178,0.119,15990,248
"7695",193016,2010,1,0,"Mercy College",NA,NA,1086,708,378,212,45,167,0.236,0.195,0.119,16490,247
"7696",193292,1991,1,0,"MOLLOY COLLEGE",NA,NA,123,100,23,55,6,49,0.49,0.447,0.261,7800,102
"7697",193292,1992,1,0,"MOLLOY COLLEGE",NA,NA,1417,1055,362,65,7,58,0.055,0.046,0.019,8390,929
"7698",193292,1993,1,0,"MOLLOY COLLEGE",NA,NA,175,139,36,74,8,66,0.475,0.423,0.222,8700,138
"7699",193292,1995,1,0,"MOLLOY COLLEGE",NA,NA,135,108,27,30,5,25,0.231,0.222,0.185,9700,109
"7700",193292,1996,1,0,"MOLLOY COLLEGE",NA,NA,183,125,58,21,5,16,0.128,0.115,0.086,10000,139
"7701",193292,1997,1,0,"MOLLOY COLLEGE",NA,NA,156,112,44,46,6,40,0.357,0.295,0.136,10400,127
"7702",193292,1998,1,0,"MOLLOY COLLEGE",NA,NA,180,117,63,72,21,51,0.436,0.4,0.333,11270,146
"7703",193292,1999,1,0,"MOLLOY COLLEGE",NA,NA,209,156,53,84,11,73,0.468,0.402,0.208,11900,159
"7704",193292,2000,1,0,"MOLLOY COLLEGE",NA,NA,195,133,62,56,13,43,0.323,0.287,0.21,12500,140
"7705",193292,2001,1,0,"MOLLOY COLLEGE",NA,NA,210,145,65,66,16,50,0.345,0.314,0.246,13190,153
"7706",193292,2002,1,0,"MOLLOY COLLEGE",NA,NA,229,168,61,77,19,58,0.345,0.336,0.311,13940,151
"7707",193292,2003,1,0,"MOLLOY COLLEGE",NA,NA,262,185,77,89,29,60,0.324,0.34,0.377,14430,181
"7708",193292,2004,1,0,"MOLLOY COLLEGE",NA,NA,311,231,80,105,17,88,0.381,0.338,0.212,15150,206
"7709",193292,2005,1,0,"Molloy College",NA,NA,274,190,84,109,31,78,0.41,0.398,0.369,15760,194
"7710",193292,2006,1,0,"Molloy College",NA,NA,269,196,73,90,22,68,0.347,0.335,0.301,16560,172
"7711",193292,2007,1,0,"Molloy College",NA,NA,370,282,88,140,31,109,0.386,0.378,0.352,17640,246
"7712",193292,2008,1,0,"Molloy College",NA,NA,393,288,105,156,32,124,0.431,0.397,0.305,18700,271
"7713",193292,2009,1,0,"Molloy College",NA,NA,414,307,107,189,42,147,0.479,0.457,0.393,19970,269
"7714",193292,2010,1,0,"Molloy College",NA,NA,387,257,130,180,59,121,0.471,0.465,0.454,21170,271
"7715",193353,1991,1,0,"MOUNT SAINT MARY COLLEGE",NA,NA,248,188,60,96,16,80,0.426,0.387,0.267,7020,208
"7716",193353,1992,1,0,"MOUNT SAINT MARY COLLEGE",NA,NA,254,180,74,97,25,72,0.4,0.382,0.338,7810,218
"7717",193353,1993,1,0,"MOUNT SAINT MARY COLLEGE",NA,NA,239,164,75,90,29,61,0.372,0.377,0.387,8110,195
"7718",193353,1995,1,0,"MOUNT SAINT MARY COLLEGE",NA,NA,258,196,62,114,24,90,0.459,0.442,0.387,8955,207
"7719",193353,1996,1,0,"MOUNT SAINT MARY COLLEGE",NA,NA,266,199,67,105,20,85,0.427,0.395,0.299,9495,226
"7720",193353,1997,1,0,"MOUNT SAINT MARY COLLEGE",NA,NA,260,177,83,121,43,78,0.441,0.465,0.518,10215,202
"7721",193353,1998,1,0,"MOUNT SAINT MARY COLLEGE",NA,NA,304,230,74,122,27,95,0.413,0.401,0.365,10855,239
"7722",193353,1999,1,0,"MOUNT SAINT MARY COLLEGE",NA,NA,323,247,76,156,25,131,0.53,0.483,0.329,11100,253
"7723",193353,2000,1,0,"MOUNT SAINT MARY COLLEGE",NA,NA,328,251,77,124,15,109,0.434,0.378,0.195,11580,266
"7724",193353,2001,1,0,"MOUNT SAINT MARY COLLEGE",NA,NA,343,239,104,143,33,110,0.46,0.417,0.317,12270,282
"7725",193353,2002,1,0,"MOUNT SAINT MARY COLLEGE",NA,NA,361,261,100,151,33,118,0.452,0.418,0.33,12930,291
"7726",193353,2003,1,0,"MOUNT SAINT MARY COLLEGE",NA,NA,347,246,101,137,31,106,0.431,0.395,0.307,13830,285
"7727",193353,2004,1,0,"MOUNT SAINT MARY COLLEGE",NA,NA,419,314,105,180,45,135,0.43,0.43,0.429,15180,345
"7728",193353,2005,1,0,"Mount Saint Mary College",NA,NA,356,247,109,154,45,109,0.441,0.433,0.413,16410,285
"7729",193353,2006,1,0,"Mount Saint Mary College",NA,NA,400,295,105,162,41,121,0.41,0.405,0.39,17730,308
"7730",193353,2007,1,0,"Mount Saint Mary College",NA,NA,364,252,112,150,31,119,0.472,0.412,0.277,18900,307
"7731",193353,2008,1,0,"Mount Saint Mary College",NA,NA,432,318,114,191,50,141,0.443,0.442,0.439,20040,334
"7732",193353,2009,1,0,"Mount Saint Mary College",NA,NA,474,362,112,217,42,175,0.483,0.458,0.375,21210,383
"7733",193353,2010,1,0,"Mount Saint Mary College",NA,NA,443,301,142,187,60,127,0.422,0.422,0.423,22350,340
"7734",193399,1991,1,0,"COLLEGE OF MOUNT SAINT VINCENT",NA,NA,188,147,41,91,20,71,0.483,0.484,0.488,9810,107
"7735",193399,1992,1,0,"COLLEGE OF MOUNT SAINT VINCENT",NA,NA,185,153,32,88,12,76,0.497,0.476,0.375,10460,100
"7736",193399,1993,1,0,"COLLEGE OF MOUNT SAINT VINCENT",NA,NA,174,136,38,71,9,62,0.456,0.408,0.237,11190,104
"7737",193399,1995,1,0,"COLLEGE OF MOUNT SAINT VINCENT",NA,NA,217,164,53,107,27,80,0.488,0.493,0.509,12450,115
"7738",193399,1996,1,0,"COLLEGE OF MOUNT SAINT VINCENT",NA,NA,208,162,46,111,26,85,0.525,0.534,0.565,13060,95
"7739",193399,1997,1,0,"COLLEGE OF MOUNT SAINT VINCENT",NA,NA,225,168,57,95,18,77,0.458,0.422,0.316,13580,97
"7740",193399,1998,1,0,"COLLEGE OF MOUNT SAINT VINCENT",NA,NA,266,200,66,124,26,98,0.49,0.466,0.394,14360,92
"7741",193399,1999,1,0,"COLLEGE OF MOUNT SAINT VINCENT",NA,NA,240,167,73,76,18,58,0.347,0.317,0.247,14910,82
"7742",193399,2000,1,0,"COLLEGE OF MOUNT SAINT VINCENT",NA,NA,236,174,62,83,16,67,0.385,0.352,0.258,16030,77
"7743",193399,2001,1,0,"COLLEGE OF MOUNT SAINT VINCENT",NA,NA,286,214,72,111,21,90,0.421,0.388,0.292,17030,101
"7744",193399,2002,1,0,"COLLEGE OF MOUNT SAINT VINCENT",NA,NA,326,239,87,128,21,107,0.448,0.393,0.241,17880,140
"7745",193399,2003,1,0,"COLLEGE OF MOUNT SAINT VINCENT",NA,NA,336,272,64,136,13,123,0.452,0.405,0.203,18600,155
"7746",193399,2004,1,0,"COLLEGE OF MOUNT SAINT VINCENT",NA,NA,355,229,126,166,53,113,0.493,0.468,0.421,19100,177
"7747",193399,2005,1,0,"College of Mount Saint Vincent",NA,NA,343,247,96,136,32,104,0.421,0.397,0.333,19950,168
"7748",193399,2006,1,0,"College of Mount Saint Vincent",NA,NA,390,294,96,159,37,122,0.415,0.408,0.385,21000,153
"7749",193399,2007,1,0,"College of Mount Saint Vincent",NA,NA,394,272,122,144,39,105,0.386,0.365,0.32,22150,152
"7750",193399,2008,1,0,"College of Mount Saint Vincent",NA,NA,374,267,107,146,34,112,0.42,0.39,0.318,23270,151
"7751",193399,2009,1,0,"College of Mount Saint Vincent",NA,NA,390,275,115,131,30,101,0.367,0.336,0.261,24400,132
"7752",193399,2010,1,0,"College of Mount Saint Vincent",NA,NA,377,249,128,147,41,106,0.426,0.39,0.32,25600,115
"7753",193584,1991,1,0,"NAZARETH COLLEGE OF ROCHESTER",NA,NA,246,177,69,124,27,97,0.548,0.504,0.391,8940,228
"7754",193584,1992,1,0,"NAZARETH COLLEGE OF ROCHESTER",NA,NA,211,159,52,129,24,105,0.66,0.611,0.462,9790,195
"7755",193584,1993,1,0,"NAZARETH COLLEGE OF ROCHESTER",NA,NA,266,192,74,142,29,113,0.589,0.534,0.392,10390,252
"7756",193584,1995,1,0,"NAZARETH COLLEGE OF ROCHESTER",NA,NA,302,227,75,182,36,146,0.643,0.603,0.48,11380,284
"7757",193584,1996,1,0,"NAZARETH COLLEGE OF ROCHESTER",NA,NA,337,242,95,208,55,153,0.632,0.617,0.579,12130,310
"7758",193584,1997,1,0,"NAZARETH COLLEGE OF ROCHESTER",NA,NA,351,257,94,214,59,155,0.603,0.61,0.628,12966,327
"7759",193584,1998,1,0,"NAZARETH COLLEGE OF ROCHESTER",NA,NA,321,246,75,199,38,161,0.655,0.62,0.507,13526,296
"7760",193584,1999,1,0,"NAZARETH COLLEGE OF ROCHESTER",NA,NA,334,244,90,205,51,154,0.631,0.614,0.567,13620,304
"7761",193584,2000,1,0,"NAZARETH COLLEGE OF ROCHESTER",NA,NA,402,304,98,244,56,188,0.618,0.607,0.571,14230,368
"7762",193584,2001,1,0,"NAZARETH COLLEGE OF ROCHESTER",NA,NA,358,274,84,239,50,189,0.69,0.668,0.595,14940,329
"7763",193584,2002,1,0,"NAZARETH COLLEGE OF ROCHESTER",NA,NA,385,292,93,230,49,181,0.62,0.597,0.527,15910,335
"7764",193584,2003,1,0,"NAZARETH COLLEGE OF ROCHESTER",NA,NA,383,284,99,236,54,182,0.641,0.616,0.545,17020,325
"7765",193584,2004,1,0,"NAZARETH COLLEGE OF ROCHESTER",NA,NA,449,335,114,285,60,225,0.672,0.635,0.526,18040,377
"7766",193584,2005,1,0,"Nazareth College of Rochester",NA,NA,451,342,109,303,56,247,0.722,0.672,0.514,19214,392
"7767",193584,2006,1,0,"Nazareth College of Rochester",NA,NA,481,364,117,293,62,231,0.635,0.609,0.53,20656,419
"7768",193584,2007,1,0,"Nazareth College of Rochester",NA,NA,456,335,121,268,60,208,0.621,0.588,0.496,21844,374
"7769",193584,2008,1,0,"Nazareth College",NA,NA,471,361,110,306,62,244,0.676,0.65,0.564,23046,381
"7770",193584,2009,1,0,"Nazareth College",NA,NA,491,387,104,315,68,247,0.638,0.642,0.654,24082,386
"7771",193584,2010,1,0,"Nazareth College",NA,NA,467,353,114,273,60,213,0.603,0.585,0.526,25046,331
"7772",193645,1991,1,0,"COLLEGE OF NEW ROCHELLE",NA,NA,645,563,82,93,2,91,0.162,0.144,0.024,10050,86
"7773",193645,1992,1,0,"COLLEGE OF NEW ROCHELLE",NA,NA,935,777,158,85,7,78,0.1,0.091,0.044,10200,72
"7774",193645,1993,1,0,"COLLEGE OF NEW ROCHELLE",NA,NA,821,677,144,89,14,75,0.111,0.108,0.097,10600,88
"7775",193645,1995,1,0,"COLLEGE OF NEW ROCHELLE",NA,NA,718,595,123,120,13,107,0.18,0.167,0.106,12200,65
"7776",193645,1996,1,0,"COLLEGE OF NEW ROCHELLE",NA,NA,931,787,144,129,13,116,0.147,0.139,0.09,11000,41
"7777",193645,1997,1,0,"COLLEGE OF NEW ROCHELLE",NA,NA,758,643,115,165,18,147,0.229,0.218,0.157,11000,53
"7778",193645,1998,1,0,"COLLEGE OF NEW ROCHELLE",NA,NA,852,738,114,161,11,150,0.203,0.189,0.096,11300,58
"7779",193645,1999,1,0,"COLLEGE OF NEW ROCHELLE",NA,NA,814,670,144,152,16,136,0.203,0.187,0.111,11600,58
"7780",193645,2000,1,0,"THE COLLEGE OF NEW ROCHELLE",NA,NA,755,662,93,159,13,146,0.22,0.211,0.14,11900,48
"7781",193645,2001,1,0,"THE COLLEGE OF NEW ROCHELLE",NA,NA,774,650,124,169,13,156,0.24,0.218,0.105,12320,39
"7782",193645,2002,1,0,"THE COLLEGE OF NEW ROCHELLE",NA,NA,850,733,117,151,12,139,0.19,0.178,0.103,13000,16
"7783",193645,2003,1,0,"THE COLLEGE OF NEW ROCHELLE",NA,NA,769,668,101,121,5,116,0.174,0.157,0.05,14400,39
"7784",193645,2004,1,0,"THE COLLEGE OF NEW ROCHELLE",NA,NA,952,815,137,152,11,141,0.173,0.16,0.08,16500,32
"7785",193645,2005,1,0,"The College of New Rochelle",NA,NA,943,883,60,168,1,167,0.189,0.178,0.017,17950,32
"7786",193645,2006,1,0,"The College of New Rochelle",NA,NA,821,757,64,133,6,127,0.168,0.162,0.094,20800,33
"7787",193645,2007,1,0,"The College of New Rochelle",NA,NA,805,733,72,126,2,124,0.169,0.157,0.028,23200,25
"7788",193645,2008,1,0,"The College of New Rochelle",NA,NA,504,461,43,86,2,84,0.182,0.171,0.047,24592,26
"7789",193645,2009,1,0,"The College of New Rochelle",NA,NA,530,465,65,86,8,78,0.168,0.162,0.123,25576,15
"7790",193645,2010,1,0,"The College of New Rochelle",NA,NA,635,566,69,140,10,130,0.23,0.22,0.145,27110,19
"7791",193654,1991,1,0,"NEW SCHOOL FOR SOCIAL RESEARCH",NA,NA,265,182,83,81,25,56,0.308,0.306,0.301,12200,105
"7792",193654,1992,1,0,"NEW SCHOOL FOR SOCIAL RESEARCH",NA,NA,423,275,148,155,41,114,0.415,0.366,0.277,12600,171
"7793",193654,1993,1,0,"NEW SCHOOL FOR SOCIAL RESEARCH",NA,NA,441,282,159,142,50,92,0.326,0.322,0.314,14210,174
"7794",193654,1995,1,0,"NEW SCHOOL FOR SOCIAL RESEARCH",NA,NA,445,275,170,178,54,124,0.451,0.4,0.318,16070,161
"7795",193654,1996,1,0,"NEW SCHOOL FOR SOCIAL RESEARCH",NA,NA,401,272,129,132,27,105,0.386,0.329,0.209,17660,159
"7796",193654,1997,1,0,"NEW SCHOOL FOR SOCIAL RESEARCH",NA,NA,465,308,157,205,56,149,0.484,0.441,0.357,18200,182
"7797",193654,1998,1,0,"NEW SCHOOL FOR SOCIAL RESEARCH",NA,NA,581,394,187,240,51,189,0.48,0.413,0.273,19370,213
"7798",193654,1999,1,0,"NEW SCHOOL UNIVERSITY",NA,NA,573,399,174,234,55,179,0.449,0.408,0.316,20410,219
"7799",193654,2000,1,0,"NEW SCHOOL UNIVERSITY",NA,NA,595,402,193,245,69,176,0.438,0.412,0.358,20600,245
"7800",193654,2001,1,0,"NEW SCHOOL UNIVERSITY",NA,NA,617,422,195,269,74,195,0.462,0.436,0.379,22630,263
"7801",193654,2002,1,0,"NEW SCHOOL UNIVERSITY",NA,NA,605,415,190,328,89,239,0.576,0.542,0.468,23900,255
"7802",193654,2003,1,0,"NEW SCHOOL UNIVERSITY",NA,NA,581,409,172,288,81,207,0.506,0.496,0.471,25330,248
"7803",193654,2004,1,0,"NEW SCHOOL UNIVERSITY",NA,NA,815,612,203,371,86,285,0.466,0.455,0.424,26820,339
"7804",193654,2005,1,0,"The New School",NA,NA,789,558,231,355,86,269,0.482,0.45,0.372,28560,336
"7805",193654,2006,1,0,"The New School",NA,NA,883,622,261,409,110,299,0.481,0.463,0.421,28853,375
"7806",193654,2007,1,0,"The New School",NA,NA,999,740,259,482,118,364,0.492,0.482,0.456,30550,416
"7807",193654,2008,1,0,"The New School",NA,NA,1058,746,312,482,113,369,0.495,0.456,0.362,32695,400
"7808",193654,2009,1,0,"The New School",NA,NA,1136,836,300,533,113,420,0.502,0.469,0.377,34081,422
"7809",193654,2010,1,0,"The New School",NA,NA,1166,859,307,603,139,464,0.54,0.517,0.453,35607,441
"7810",193900,1991,1,0,"NEW YORK UNIVERSITY",NA,NA,2338,1279,1059,1173,508,665,0.52,0.502,0.48,15620,1303
"7811",193900,1992,1,0,"NEW YORK UNIVERSITY",NA,NA,2669,1511,1158,1355,571,784,0.519,0.508,0.493,16650,1278
"7812",193900,1993,1,0,"NEW YORK UNIVERSITY",NA,NA,2752,1592,1160,1395,546,849,0.533,0.507,0.471,17640,1423
"7813",193900,1995,1,0,"NEW YORK UNIVERSITY",NA,NA,3156,1851,1305,1652,681,971,0.525,0.523,0.522,19748,1569
"7814",193900,1996,1,0,"NEW YORK UNIVERSITY",NA,NA,3393,2002,1391,1838,770,1068,0.533,0.542,0.554,20756,1489
"7815",193900,1997,1,0,"NEW YORK UNIVERSITY",NA,NA,3557,2054,1503,1963,775,1188,0.578,0.552,0.516,21730,1409
"7816",193900,1998,1,0,"NEW YORK UNIVERSITY",NA,NA,3722,2224,1498,2028,805,1223,0.55,0.545,0.537,22586,1432
"7817",193900,1999,1,0,"NEW YORK UNIVERSITY",NA,NA,3845,2323,1522,2245,868,1377,0.593,0.584,0.57,22256,1535
"7818",193900,2000,1,0,"NEW YORK UNIVERSITY",NA,NA,3966,2424,1542,2416,966,1450,0.598,0.609,0.626,23090,1571
"7819",193900,2001,1,0,"NEW YORK UNIVERSITY",NA,NA,4136,2525,1611,2574,1016,1558,0.617,0.622,0.631,23986,1844
"7820",193900,2002,1,0,"NEW YORK UNIVERSITY",NA,NA,4126,2577,1549,2564,963,1601,0.621,0.621,0.622,24950,2160
"7821",193900,2003,1,0,"NEW YORK UNIVERSITY",NA,NA,4203,2563,1640,2664,1069,1595,0.622,0.634,0.652,26766,1867
"7822",193900,2004,1,0,"NEW YORK UNIVERSITY",NA,NA,4568,2792,1776,2860,1121,1739,0.623,0.626,0.631,28328,2331
"7823",193900,2005,1,0,"New York University",NA,NA,4639,2853,1786,2941,1168,1773,0.622,0.634,0.654,29890,2439
"7824",193900,2006,1,0,"New York University",NA,NA,4704,2895,1809,2879,1141,1738,0.6,0.612,0.631,31534,2445
"7825",193900,2007,1,0,"New York University",NA,NA,4884,3064,1820,2973,1082,1891,0.617,0.609,0.595,33268,2462
"7826",193900,2008,1,0,"New York University",NA,NA,4786,2738,2048,2740,1134,1606,0.587,0.573,0.554,35230,2182
"7827",193900,2009,1,0,"New York University",NA,NA,5367,3037,2330,3359,1449,1910,0.629,0.626,0.622,36586,2245
"7828",193900,2010,1,0,"New York University",NA,NA,5434,3100,2334,3417,1477,1940,0.626,0.629,0.633,37866,2301
"7829",193973,1991,1,0,"NIAGARA UNIVERSITY",NA,NA,447,272,175,176,53,123,0.452,0.394,0.303,9030,367
"7830",193973,1992,1,0,"NIAGARA UNIVERSITY",NA,NA,517,334,183,184,60,124,0.371,0.356,0.328,9523,445
"7831",193973,1993,1,0,"NIAGARA UNIVERSITY",NA,NA,432,259,173,202,68,134,0.517,0.468,0.393,10070,359
"7832",193973,1995,1,0,"NIAGARA UNIVERSITY",NA,NA,424,264,160,204,67,137,0.519,0.481,0.419,11560,327
"7833",193973,1996,1,0,"NIAGARA UNIVERSITY",NA,NA,552,314,238,253,107,146,0.465,0.458,0.45,12256,458
"7834",193973,1997,1,0,"NIAGARA UNIVERSITY",NA,NA,705,417,288,299,102,197,0.472,0.424,0.354,12890,576
"7835",193973,1998,1,0,"NIAGARA UNIVERSITY",NA,NA,543,332,211,271,93,178,0.536,0.499,0.441,13406,449
"7836",193973,1999,1,0,"NIAGARA UNIVERSITY",NA,NA,575,345,230,315,127,188,0.545,0.548,0.552,13400,500
"7837",193973,2000,1,0,"NIAGARA UNIVERSITY",NA,NA,628,371,257,350,122,228,0.615,0.557,0.475,14000,527
"7838",193973,2001,1,0,"NIAGARA UNIVERSITY",NA,NA,598,362,236,322,117,205,0.566,0.538,0.496,14700,497
"7839",193973,2002,1,0,"NIAGARA UNIVERSITY",NA,NA,735,440,295,409,148,261,0.593,0.556,0.502,15900,604
"7840",193973,2003,1,0,"NIAGARA UNIVERSITY",NA,NA,686,417,269,403,152,251,0.602,0.587,0.565,16700,568
"7841",193973,2004,1,0,"NIAGARA UNIVERSITY",NA,NA,725,467,258,443,141,302,0.647,0.611,0.547,17700,604
"7842",193973,2005,1,0,"Niagara University",NA,NA,730,444,286,435,160,275,0.619,0.596,0.559,19000,626
"7843",193973,2006,1,0,"Niagara University",NA,NA,705,421,284,437,169,268,0.637,0.62,0.595,20400,606
"7844",193973,2007,1,0,"Niagara University",NA,NA,737,435,302,440,164,276,0.635,0.597,0.543,21400,476
"7845",193973,2008,1,0,"Niagara University",NA,NA,738,454,284,435,146,289,0.637,0.589,0.514,22500,582
"7846",193973,2009,1,0,"Niagara University",NA,NA,671,404,267,378,141,237,0.587,0.563,0.528,23700,547
"7847",193973,2010,1,0,"Niagara University",NA,NA,668,377,291,397,163,234,0.621,0.594,0.56,24600,521
"7848",194161,1991,1,0,"NYACK COLLEGE",NA,NA,108,77,31,26,4,22,0.286,0.241,0.129,7100,61
"7849",194161,1992,1,0,"NYACK COLLEGE",NA,NA,104,60,44,37,14,23,0.383,0.356,0.318,7910,60
"7850",194161,1993,1,0,"NYACK COLLEGE",NA,NA,109,69,40,30,8,22,0.319,0.275,0.2,8400,72
"7851",194161,1995,1,0,"NYACK COLLEGE",NA,NA,160,92,68,56,21,35,0.38,0.35,0.309,9450,72
"7852",194161,1996,1,0,"NYACK COLLEGE",NA,NA,208,129,79,69,23,46,0.357,0.332,0.291,10360,143
"7853",194161,1997,1,0,"NYACK COLLEGE",NA,NA,208,114,94,46,17,29,0.254,0.221,0.181,11100,126
"7854",194161,1998,1,0,"NYACK COLLEGE",NA,NA,258,159,99,73,20,53,0.333,0.283,0.202,11650,133
"7855",194161,1999,1,0,"NYACK COLLEGE",NA,NA,322,182,140,107,39,68,0.374,0.332,0.279,11440,149
"7856",194161,2000,1,0,"NYACK COLLEGE",NA,NA,373,233,140,105,35,70,0.3,0.282,0.25,11990,141
"7857",194161,2001,1,0,"NYACK COLLEGE",NA,NA,320,206,114,103,35,68,0.33,0.322,0.307,12480,131
"7858",194161,2002,1,0,"NYACK COLLEGE",NA,NA,295,183,112,109,40,69,0.377,0.369,0.357,12990,133
"7859",194161,2003,1,0,"NYACK COLLEGE",NA,NA,267,166,101,79,26,53,0.319,0.296,0.257,13500,122
"7860",194161,2004,1,0,"NYACK COLLEGE",NA,NA,260,162,98,78,29,49,0.302,0.3,0.296,13990,96
"7861",194161,2005,1,0,"Nyack College",NA,NA,256,137,119,60,21,39,0.285,0.234,0.176,14750,105
"7862",194161,2006,1,0,"Nyack College",NA,NA,308,178,130,85,30,55,0.309,0.276,0.231,15400,113
"7863",194161,2007,1,0,"Nyack College",NA,NA,304,172,132,74,22,52,0.302,0.243,0.167,15800,99
"7864",194161,2008,1,0,"Nyack College",NA,NA,253,140,113,61,22,39,0.279,0.241,0.195,17500,83
"7865",194161,2009,1,0,"Nyack College",NA,NA,260,151,109,68,26,42,0.278,0.262,0.239,18500,69
"7866",194161,2010,1,0,"Nyack College",NA,NA,314,181,133,67,28,39,0.216,0.213,0.211,19500,82
"7867",194310,1991,1,0,"PACE UNIVERSITY-NEW YORK",NA,NA,510,290,220,178,56,122,0.421,0.349,0.255,9494,366
"7868",194310,1992,1,0,"PACE UNIVERSITY-NEW YORK",NA,NA,543,357,186,151,42,109,0.305,0.278,0.226,10100,192
"7869",194310,1993,1,0,"PACE UNIVERSITY-NEW YORK",NA,NA,659,430,229,228,64,164,0.381,0.346,0.279,10780,256
"7870",194310,1995,1,0,"PACE UNIVERSITY-NEW YORK",NA,NA,1139,681,458,420,139,281,0.413,0.369,0.303,12120,498
"7871",194310,1996,1,0,"PACE UNIVERSITY-NEW YORK",NA,NA,1388,788,600,487,180,307,0.39,0.351,0.3,13080,670
"7872",194310,1997,1,0,"PACE UNIVERSITY-NEW YORK",NA,NA,1476,859,617,588,203,385,0.448,0.398,0.329,13820,723
"7873",194310,1998,1,0,"PACE UNIVERSITY-NEW YORK",NA,NA,1536,911,625,602,220,382,0.419,0.392,0.352,14690,697
"7874",194310,1999,1,0,"PACE UNIVERSITY-NEW YORK",NA,NA,1500,895,605,604,205,399,0.446,0.403,0.339,15130,646
"7875",194310,2000,1,0,"PACE UNIVERSITY-NEW YORK",NA,NA,1602,976,626,612,204,408,0.418,0.382,0.326,15870,713
"7876",194310,2001,1,0,"PACE UNIVERSITY-NEW YORK",NA,NA,1573,948,625,567,192,375,0.396,0.36,0.307,16650,607
"7877",194310,2002,1,0,"PACE UNIVERSITY-NEW YORK",NA,NA,1508,916,592,592,190,402,0.439,0.393,0.321,17800,686
"7878",194310,2003,1,0,"PACE UNIVERSITY-NEW YORK",NA,NA,1553,997,556,653,214,439,0.44,0.42,0.385,20540,783
"7879",194310,2004,1,0,"PACE UNIVERSITY-NEW YORK",NA,NA,1437,900,537,577,194,383,0.426,0.402,0.361,22100,663
"7880",194310,2005,1,0,"Pace University-New York",NA,NA,1474,954,520,584,186,398,0.417,0.396,0.358,24752,741
"7881",194310,2006,1,0,"Pace University-New York",NA,NA,1131,738,393,441,126,315,0.427,0.39,0.321,29454,589
"7882",194310,2007,1,0,"Pace University-New York",NA,NA,1537,937,600,528,183,345,0.368,0.344,0.305,29454,696
"7883",194310,2008,1,0,"Pace University-New York",NA,NA,1616,1002,614,589,208,381,0.38,0.364,0.339,30632,717
"7884",194310,2009,1,0,"Pace University-New York",NA,NA,1637,1036,601,603,194,409,0.395,0.368,0.323,31860,768
"7885",194310,2010,1,0,"Pace University-New York",NA,NA,1766,1089,677,696,240,456,0.419,0.394,0.355,32656,491
"7886",194824,1991,1,0,"RENSSELAER POLYTECHNIC INSTITUTE",NA,NA,971,193,778,428,334,94,0.487,0.441,0.429,15633,669
"7887",194824,1992,1,0,"RENSSELAER POLYTECHNIC INSTITUTE",NA,NA,1083,216,867,483,368,115,0.532,0.446,0.424,16402,762
"7888",194824,1993,1,0,"RENSSELAER POLYTECHNIC INSTITUTE",NA,NA,936,168,768,408,303,105,0.625,0.436,0.395,17335,638
"7889",194824,1995,1,0,"RENSSELAER POLYTECHNIC INSTITUTE",NA,NA,962,243,719,425,296,129,0.531,0.442,0.412,18656,725
"7890",194824,1996,1,0,"RENSSELAER POLYTECHNIC INSTITUTE",NA,NA,898,225,673,454,318,136,0.604,0.506,0.473,19685,654
"7891",194824,1997,1,0,"RENSSELAER POLYTECHNIC INSTITUTE",NA,NA,1069,267,802,584,414,170,0.637,0.546,0.516,20960,719
"7892",194824,1998,1,0,"RENSSELAER POLYTECHNIC INSTITUTE",NA,NA,1138,258,880,654,483,171,0.663,0.575,0.549,21655,765
"7893",194824,1999,1,0,"RENSSELAER POLYTECHNIC INSTITUTE",NA,NA,1323,295,1028,812,611,201,0.681,0.614,0.594,22300,928
"7894",194824,2000,1,0,"RENSSELAER POLYTECHNIC INSTITUTE",NA,NA,1303,334,969,833,603,230,0.689,0.639,0.622,23525,871
"7895",194824,2001,1,0,"RENSSELAER POLYTECHNIC INSTITUTE",NA,NA,1109,283,826,730,532,198,0.7,0.658,0.644,24820,770
"7896",194824,2002,1,0,"RENSSELAER POLYTECHNIC INSTITUTE",NA,NA,1047,263,784,672,490,182,0.692,0.642,0.625,26400,751
"7897",194824,2003,1,0,"RENSSELAER POLYTECHNIC INSTITUTE",NA,NA,1341,320,1021,856,626,230,0.719,0.638,0.613,27700,973
"7898",194824,2004,1,0,"RENSSELAER POLYTECHNIC INSTITUTE",NA,NA,1079,259,820,696,521,175,0.676,0.645,0.635,28950,792
"7899",194824,2005,1,0,"Rensselaer Polytechnic Institute",NA,NA,1236,283,953,745,550,195,0.689,0.603,0.577,31000,937
"7900",194824,2006,1,0,"Rensselaer Polytechnic Institute",NA,NA,1269,362,907,766,544,222,0.613,0.604,0.6,32600,966
"7901",194824,2007,1,0,"Rensselaer Polytechnic Institute",NA,NA,1288,389,899,836,576,260,0.668,0.649,0.641,34900,985
"7902",194824,2008,1,0,"Rensselaer Polytechnic Institute",NA,NA,1355,380,975,833,599,234,0.616,0.615,0.614,36950,980
"7903",194824,2009,1,0,"Rensselaer Polytechnic Institute",NA,NA,1337,360,977,840,599,241,0.669,0.628,0.613,38100,967
"7904",194824,2010,1,0,"Rensselaer Polytechnic Institute",NA,NA,1152,322,830,703,494,209,0.649,0.61,0.595,39600,834
"7905",195003,1991,0,1,"ROCHESTER INSTITUTE OF TECHNOLOGY",9999,0,1265,370,895,287,162,125,0.338,0.227,0.181,12058,1034
"7906",195003,1992,0,1,"ROCHESTER INSTITUTE OF TECHNOLOGY",9999,0,1482,432,1050,323,172,151,0.35,0.218,0.164,12760,1144
"7907",195003,1993,0,1,"ROCHESTER INSTITUTE OF TECHNOLOGY",9999,0,1343,425,918,310,146,164,0.386,0.231,0.159,13555,1062
"7908",195003,1995,0,1,"ROCHESTER INSTITUTE OF TECHNOLOGY",9999,0,1634,502,1132,621,379,242,0.482,0.38,0.335,14977,1218
"7909",195003,1996,0,1,"ROCHESTER INSTITUTE OF TECHNOLOGY",9999,0,1725,571,1154,690,419,271,0.475,0.4,0.363,15691,1400
"7910",195003,1997,0,1,"ROCHESTER INSTITUTE OF TECHNOLOGY",9999,0,1836,617,1219,727,446,281,0.455,0.396,0.366,16399,1457
"7911",195003,1998,0,1,"ROCHESTER INSTITUTE OF TECHNOLOGY",9999,0,1980,609,1371,816,526,290,0.476,0.412,0.384,17067,1369
"7912",195003,1999,0,1,"ROCHESTER INSTITUTE OF TECHNOLOGY",9999,0,2107,602,1505,366,187,179,0.297,0.174,0.124,17328,1614
"7913",195003,2000,0,1,"ROCHESTER INSTITUTE OF TECHNOLOGY",9999,0,2278,636,1642,453,244,209,0.329,0.199,0.149,17934,1758
"7914",195003,2001,0,1,"ROCHESTER INSTITUTE OF TECHNOLOGY",9999,0,2227,574,1653,451,249,202,0.352,0.203,0.151,18633,1630
"7915",195003,2002,0,1,"ROCHESTER INSTITUTE OF TECHNOLOGY",9999,0,2327,614,1713,563,299,264,0.43,0.242,0.175,19470,1685
"7916",195003,2003,0,1,"ROCHESTER INSTITUTE OF TECHNOLOGY",9999,0,2121,567,1554,538,286,252,0.444,0.254,0.184,21027,1522
"7917",195003,2004,0,1,"ROCHESTER INSTITUTE OF TECHNOLOGY",9999,0,2233,562,1671,577,316,261,0.464,0.258,0.189,22056,1659
"7918",195003,2005,0,1,"Rochester Institute of Technology",9999,0,2184,656,1528,587,289,298,0.454,0.269,0.189,23247,1582
"7919",195003,2006,0,1,"Rochester Institute of Technology",9999,0,2355,675,1680,589,315,274,0.406,0.25,0.188,24627,1787
"7920",195003,2007,0,1,"Rochester Institute of Technology",9999,0,2497,788,1709,648,306,342,0.434,0.26,0.179,26085,1881
"7921",195003,2008,0,1,"Rochester Institute of Technology",9999,0,2594,848,1746,706,357,349,0.412,0.272,0.204,27624,1945
"7922",195003,2009,0,1,"Rochester Institute of Technology",9999,0,2582,798,1784,796,413,383,0.48,0.308,0.232,28866,1858
"7923",195003,2010,0,1,"Rochester Institute of Technology",9999,0,2583,820,1763,699,346,353,0.43,0.271,0.196,30282,1395
"7924",195030,1991,1,0,"UNIVERSITY OF ROCHESTER",NA,NA,1215,537,678,805,440,365,0.68,0.663,0.649,15513,856
"7925",195030,1992,1,0,"UNIVERSITY OF ROCHESTER",NA,NA,1266,585,681,824,425,399,0.682,0.651,0.624,16444,910
"7926",195030,1993,1,0,"UNIVERSITY OF ROCHESTER",NA,NA,1229,599,630,754,365,389,0.649,0.614,0.579,17345,867
"7927",195030,1995,1,0,"UNIVERSITY OF ROCHESTER",NA,NA,1205,583,622,751,354,397,0.681,0.623,0.569,19165,837
"7928",195030,1996,1,0,"UNIVERSITY OF ROCHESTER",NA,NA,1011,501,510,719,336,383,0.765,0.711,0.659,20080,677
"7929",195030,1997,1,0,"UNIVERSITY OF ROCHESTER",NA,NA,892,404,488,592,301,291,0.72,0.664,0.617,21020,639
"7930",195030,1998,1,0,"UNIVERSITY OF ROCHESTER",NA,NA,1062,481,581,730,372,358,0.744,0.687,0.64,21981,696
"7931",195030,1999,1,0,"UNIVERSITY OF ROCHESTER",NA,NA,1211,525,686,828,429,399,0.76,0.684,0.625,22300,739
"7932",195030,2000,1,0,"UNIVERSITY OF ROCHESTER",NA,NA,1044,460,584,741,395,346,0.752,0.71,0.676,23130,640
"7933",195030,2001,1,0,"UNIVERSITY OF ROCHESTER",NA,NA,1095,481,614,767,390,377,0.784,0.7,0.635,24150,699
"7934",195030,2002,1,0,"UNIVERSITY OF ROCHESTER",NA,NA,1055,492,563,776,392,384,0.78,0.736,0.696,25430,675
"7935",195030,2003,1,0,"UNIVERSITY OF ROCHESTER",NA,NA,1086,508,578,747,368,379,0.746,0.688,0.637,26900,650
"7936",195030,2004,1,0,"UNIVERSITY OF ROCHESTER",NA,NA,1083,496,587,808,409,399,0.804,0.746,0.697,28250,726
"7937",195030,2005,1,0,"University of Rochester",NA,NA,1106,563,543,808,376,432,0.767,0.731,0.692,30540,712
"7938",195030,2006,1,0,"University of Rochester",NA,NA,1219,561,658,906,467,439,0.782,0.743,0.71,32650,667
"7939",195030,2007,1,0,"University of Rochester",NA,NA,1181,603,578,905,415,490,0.813,0.766,0.718,34380,635
"7940",195030,2008,1,0,"University of Rochester",NA,NA,1282,642,640,936,442,494,0.77,0.73,0.691,36410,683
"7941",195030,2009,1,0,"University of Rochester",NA,NA,1195,594,601,890,431,459,0.773,0.745,0.717,37870,631
"7942",195030,2010,1,0,"University of Rochester",NA,NA,1305,641,664,120,69,51,0.08,0.092,0.104,39480,777
"7943",195164,1991,1,0,"SAINT BONAVENTURE UNIVERSITY",NA,NA,479,236,243,267,117,150,0.636,0.557,0.481,9067,440
"7944",195164,1992,1,0,"SAINT BONAVENTURE UNIVERSITY",NA,NA,441,216,225,226,93,133,0.616,0.512,0.413,9284,399
"7945",195164,1993,1,0,"SAINT BONAVENTURE UNIVERSITY",NA,NA,370,187,183,215,95,120,0.642,0.581,0.519,9656,350
"7946",195164,1995,1,0,"SAINT BONAVENTURE UNIVERSITY",NA,NA,547,278,269,285,127,158,0.568,0.521,0.472,11604,482
"7947",195164,1996,1,0,"SAINT BONAVENTURE UNIVERSITY",NA,NA,590,311,279,327,153,174,0.559,0.554,0.548,12439,534
"7948",195164,1997,1,0,"SAINT BONAVENTURE UNIVERSITY",NA,NA,542,274,268,309,144,165,0.602,0.57,0.537,13100,292
"7949",195164,1998,1,0,"SAINT BONAVENTURE UNIVERSITY",NA,NA,568,284,284,290,126,164,0.578,0.511,0.444,13800,463
"7950",195164,1999,1,0,"SAINT BONAVENTURE UNIVERSITY",NA,NA,520,294,226,273,100,173,0.588,0.525,0.442,13880,276
"7951",195164,2000,1,0,"SAINT BONAVENTURE UNIVERSITY",NA,NA,584,316,268,309,116,193,0.611,0.529,0.433,14510,306
"7952",195164,2001,1,0,"SAINT BONAVENTURE UNIVERSITY",NA,NA,518,263,255,280,121,159,0.605,0.541,0.475,15526,286
"7953",195164,2002,1,0,"SAINT BONAVENTURE UNIVERSITY",NA,NA,584,295,289,300,136,164,0.556,0.514,0.471,16210,340
"7954",195164,2003,1,0,"SAINT BONAVENTURE UNIVERSITY",NA,NA,595,292,303,296,135,161,0.551,0.497,0.446,17190,371
"7955",195164,2004,1,0,"SAINT BONAVENTURE UNIVERSITY",NA,NA,574,304,270,305,134,171,0.562,0.531,0.496,18650,387
"7956",195164,2005,1,0,"Saint Bonaventure University",NA,NA,477,225,252,239,112,127,0.564,0.501,0.444,20610,352
"7957",195164,2006,1,0,"Saint Bonaventure University",NA,NA,459,234,225,235,105,130,0.556,0.512,0.467,21650,361
"7958",195164,2007,1,0,"Saint Bonaventure University",NA,NA,527,264,263,283,133,150,0.568,0.537,0.506,22740,389
"7959",195164,2008,1,0,"Saint Bonaventure University",NA,NA,563,315,248,310,113,197,0.625,0.551,0.456,23920,416
"7960",195164,2009,1,0,"Saint Bonaventure University",NA,NA,465,249,216,252,106,146,0.586,0.542,0.491,24920,338
"7961",195164,2010,1,0,"Saint Bonaventure University",NA,NA,494,242,252,257,116,141,0.583,0.52,0.46,25930,366
"7962",195173,1991,1,0,"ST FRANCIS COLLEGE",NA,NA,353,207,146,68,26,42,0.203,0.193,0.178,5850,196
"7963",195173,1992,1,0,"ST FRANCIS COLLEGE",NA,NA,372,200,172,63,26,37,0.185,0.169,0.151,6550,206
"7964",195173,1993,1,0,"ST FRANCIS COLLEGE",NA,NA,358,214,144,107,40,67,0.313,0.299,0.278,6710,212
"7965",195173,1995,1,0,"ST FRANCIS COLLEGE",NA,NA,281,145,136,89,48,41,0.283,0.317,0.353,7360,170
"7966",195173,1996,1,0,"ST FRANCIS COLLEGE",NA,NA,305,181,124,93,35,58,0.32,0.305,0.282,7739,163
"7967",195173,1997,1,0,"ST FRANCIS COLLEGE",NA,NA,410,253,157,95,26,69,0.273,0.232,0.166,8160,217
"7968",195173,1998,1,0,"ST FRANCIS COLLEGE",NA,NA,440,259,181,146,40,106,0.409,0.332,0.221,8480,237
"7969",195173,1999,1,0,"ST FRANCIS COLLEGE",NA,NA,474,284,190,130,54,76,0.268,0.274,0.284,8250,277
"7970",195173,2000,1,0,"ST FRANCIS COLLEGE",NA,NA,434,242,192,191,72,119,0.492,0.44,0.375,8900,253
"7971",195173,2001,1,0,"ST FRANCIS COLLEGE",NA,NA,471,220,251,171,75,96,0.436,0.363,0.299,9450,235
"7972",195173,2002,1,0,"ST FRANCIS COLLEGE",NA,NA,454,238,216,153,61,92,0.387,0.337,0.282,9920,258
"7973",195173,2003,1,0,"ST FRANCIS COLLEGE",NA,NA,428,224,204,71,18,53,0.237,0.166,0.088,10620,225
"7974",195173,2004,1,0,"ST FRANCIS COLLEGE",NA,NA,473,228,245,148,67,81,0.355,0.313,0.273,11420,226
"7975",195173,2005,1,0,"St Francis College",NA,NA,497,224,273,140,68,72,0.321,0.282,0.249,12450,238
"7976",195173,2006,1,0,"St Francis College",NA,NA,474,253,221,137,61,76,0.3,0.289,0.276,13500,228
"7977",195173,2007,1,0,"St Francis College",NA,NA,478,261,217,130,48,82,0.314,0.272,0.221,14400,204
"7978",195173,2008,1,0,"St. Francis College",NA,NA,566,292,274,160,68,92,0.315,0.283,0.248,15200,275
"7979",195173,2009,1,0,"St. Francis College",NA,NA,580,301,279,168,63,105,0.349,0.29,0.226,16040,279
"7980",195173,2010,1,0,"St. Francis College",NA,NA,559,289,270,151,65,86,0.298,0.27,0.241,16720,223
"7981",195216,1991,1,0,"SAINT LAWRENCE UNIVERSITY",NA,NA,421,213,208,322,142,180,0.845,0.765,0.683,15735,381
"7982",195216,1992,1,0,"ST LAWRENCE UNIVERSITY",NA,NA,601,294,307,413,207,206,0.701,0.687,0.674,16820,552
"7983",195216,1993,1,0,"ST LAWRENCE UNIVERSITY",NA,NA,507,260,247,353,167,186,0.715,0.696,0.676,17890,442
"7984",195216,1995,1,0,"ST LAWRENCE UNIVERSITY",NA,NA,571,287,284,382,176,206,0.718,0.669,0.62,19790,517
"7985",195216,1996,1,0,"ST LAWRENCE UNIVERSITY",NA,NA,592,281,311,388,209,179,0.637,0.655,0.672,20560,529
"7986",195216,1997,1,0,"ST LAWRENCE UNIVERSITY",NA,NA,476,232,244,328,148,180,0.776,0.689,0.607,21325,434
"7987",195216,1998,1,0,"ST LAWRENCE UNIVERSITY",NA,NA,479,255,224,339,155,184,0.722,0.708,0.692,22120,364
"7988",195216,1999,1,0,"ST LAWRENCE UNIVERSITY",NA,NA,575,301,274,410,182,228,0.758,0.713,0.664,22905,459
"7989",195216,2000,1,0,"ST LAWRENCE UNIVERSITY",NA,NA,612,325,287,436,186,250,0.769,0.712,0.648,23765,440
"7990",195216,2001,1,0,"ST LAWRENCE UNIVERSITY",NA,NA,511,269,242,377,179,198,0.736,0.738,0.74,24655,341
"7991",195216,2002,1,0,"ST LAWRENCE UNIVERSITY",NA,NA,615,316,299,443,197,246,0.778,0.72,0.659,26280,427
"7992",195216,2003,1,0,"ST LAWRENCE UNIVERSITY",NA,NA,565,296,269,444,196,248,0.838,0.786,0.729,27985,394
"7993",195216,2004,1,0,"ST LAWRENCE UNIVERSITY",NA,NA,566,298,268,444,203,241,0.809,0.784,0.757,30270,419
"7994",195216,2005,1,0,"St Lawrence University",NA,NA,534,268,266,407,190,217,0.81,0.762,0.714,31935,415
"7995",195216,2006,1,0,"St Lawrence University",NA,NA,608,325,283,463,210,253,0.778,0.762,0.742,33690,495
"7996",195216,2007,1,0,"St Lawrence University",NA,NA,627,383,244,482,181,301,0.786,0.769,0.742,35375,508
"7997",195216,2008,1,0,"St Lawrence University",NA,NA,616,334,282,490,220,270,0.808,0.795,0.78,37675,512
"7998",195216,2009,1,0,"St Lawrence University",NA,NA,579,307,272,476,219,257,0.837,0.822,0.805,39520,492
"7999",195216,2010,1,0,"St Lawrence University",NA,NA,609,316,293,492,227,265,0.839,0.808,0.775,40905,495
"8000",195234,1991,1,0,"COLLEGE OF SAINT ROSE",NA,NA,207,152,55,106,24,82,0.54,0.512,0.436,8420,184
"8001",195234,1992,1,0,"COLLEGE OF SAINT ROSE",NA,NA,233,177,56,122,21,101,0.571,0.524,0.375,9036,204
"8002",195234,1993,1,0,"COLLEGE OF SAINT ROSE",NA,NA,236,160,76,116,24,92,0.575,0.492,0.316,9562,213
"8003",195234,1995,1,0,"THE COLLEGE OF SAINT ROSE",NA,NA,248,170,78,111,34,77,0.453,0.448,0.436,10610,225
"8004",195234,1996,1,0,"THE COLLEGE OF SAINT ROSE",NA,NA,319,226,93,146,30,116,0.513,0.458,0.323,11174,273
"8005",195234,1997,1,0,"THE COLLEGE OF SAINT ROSE",NA,NA,311,223,88,146,29,117,0.525,0.469,0.33,11684,290
"8006",195234,1998,1,0,"THE COLLEGE OF SAINT ROSE",NA,NA,345,262,83,175,29,146,0.557,0.507,0.349,11968,313
"8007",195234,1999,1,0,"THE COLLEGE OF SAINT ROSE",NA,NA,401,297,104,202,39,163,0.549,0.504,0.375,12434,368
"8008",195234,2000,1,0,"THE COLLEGE OF SAINT ROSE",NA,NA,485,349,136,216,47,169,0.484,0.445,0.346,12870,442
"8009",195234,2001,1,0,"THE COLLEGE OF SAINT ROSE",NA,NA,490,356,134,239,45,194,0.545,0.488,0.336,13578,435
"8010",195234,2002,1,0,"THE COLLEGE OF SAINT ROSE",NA,NA,526,391,135,303,65,238,0.609,0.576,0.481,14244,467
"8011",195234,2003,1,0,"THE COLLEGE OF SAINT ROSE",NA,NA,531,397,134,277,52,225,0.567,0.522,0.388,15242,455
"8012",195234,2004,1,0,"THE COLLEGE OF SAINT ROSE",NA,NA,563,408,155,387,91,296,0.726,0.687,0.587,16230,388
"8013",195234,2005,1,0,"The College of Saint Rose",NA,NA,595,411,184,330,75,255,0.62,0.555,0.408,17368,452
"8014",195234,2006,1,0,"The College of Saint Rose",NA,NA,630,423,207,328,88,240,0.567,0.521,0.425,18672,510
"8015",195234,2007,1,0,"The College of Saint Rose",NA,NA,611,456,155,326,63,263,0.577,0.534,0.406,19860,487
"8016",195234,2008,1,0,"The College of Saint Rose",NA,NA,574,415,159,312,72,240,0.578,0.544,0.453,21260,462
"8017",195234,2009,1,0,"The College of Saint Rose",NA,NA,583,381,202,271,76,195,0.512,0.465,0.376,22324,425
"8018",195234,2010,1,0,"The College of Saint Rose",NA,NA,639,432,207,313,83,230,0.532,0.49,0.401,23330,474
"8019",195243,1991,1,0,"SAINT THOMAS AQUINAS COLLEGE",NA,NA,198,113,85,95,28,67,0.593,0.48,0.329,6750,177
"8020",195243,1992,1,0,"SAINT THOMAS AQUINAS COLLEGE",NA,NA,214,125,89,53,9,44,0.352,0.248,0.101,7350,162
"8021",195243,1993,1,0,"SAINT THOMAS AQUINAS COLLEGE",NA,NA,211,132,79,86,24,62,0.47,0.408,0.304,8150,170
"8022",195243,1995,1,0,"SAINT THOMAS AQUINAS COLLEGE",NA,NA,276,162,114,74,22,52,0.321,0.268,0.193,9450,192
"8023",195243,1996,1,0,"SAINT THOMAS AQUINAS COLLEGE",NA,NA,238,142,96,65,16,49,0.345,0.273,0.167,10100,183
"8024",195243,1997,1,0,"SAINT THOMAS AQUINAS COLLEGE",NA,NA,300,179,121,106,34,72,0.402,0.353,0.281,10700,241
"8025",195243,1998,1,0,"SAINT THOMAS AQUINAS COLLEGE",NA,NA,306,179,127,97,34,63,0.352,0.317,0.268,11420,236
"8026",195243,1999,1,0,"SAINT THOMAS AQUINAS COLLEGE",NA,NA,304,168,136,103,33,70,0.417,0.339,0.243,11800,213
"8027",195243,2000,1,0,"SAINT THOMAS AQUINAS COLLEGE",NA,NA,298,173,125,117,38,79,0.457,0.393,0.304,12500,188
"8028",195243,2001,1,0,"SAINT THOMAS AQUINAS COLLEGE",NA,NA,301,164,137,101,35,66,0.402,0.336,0.255,13120,195
"8029",195243,2002,1,0,"SAINT THOMAS AQUINAS COLLEGE",NA,NA,329,191,138,130,38,92,0.482,0.395,0.275,13780,209
"8030",195243,2003,1,0,"SAINT THOMAS AQUINAS COLLEGE",NA,NA,343,188,155,97,39,58,0.308,0.283,0.252,14500,231
"8031",195243,2004,1,0,"SAINT THOMAS AQUINAS COLLEGE",NA,NA,349,168,181,112,56,56,0.333,0.321,0.309,15300,225
"8032",195243,2005,1,0,"Saint Thomas Aquinas College",NA,NA,327,188,139,119,43,76,0.404,0.364,0.309,16200,238
"8033",195243,2006,1,0,"Saint Thomas Aquinas College",NA,NA,323,185,138,113,39,74,0.4,0.35,0.283,17200,229
"8034",195243,2007,1,0,"Saint Thomas Aquinas College",NA,NA,324,163,161,117,49,68,0.417,0.361,0.304,18400,227
"8035",195243,2008,1,0,"Saint Thomas Aquinas College",NA,NA,352,213,139,140,44,96,0.451,0.398,0.317,19500,239
"8036",195243,2009,1,0,"Saint Thomas Aquinas College",NA,NA,293,156,137,105,56,49,0.314,0.358,0.409,20670,195
"8037",195243,2010,1,0,"Saint Thomas Aquinas College",NA,NA,290,173,117,123,40,83,0.48,0.424,0.342,21910,178
"8038",195304,1991,1,0,"SARAH LAWRENCE COLLEGE",NA,NA,228,168,60,125,34,91,0.542,0.548,0.567,16750,193
"8039",195304,1992,1,0,"SARAH LAWRENCE COLLEGE",NA,NA,220,168,52,127,30,97,0.577,0.577,0.577,17640,181
"8040",195304,1993,1,0,"SARAH LAWRENCE COLLEGE",NA,NA,255,195,60,131,31,100,0.513,0.514,0.517,18460,200
"8041",195304,1995,1,0,"SARAH LAWRENCE COLLEGE",NA,NA,233,183,50,118,29,89,0.486,0.506,0.58,20708,183
"8042",195304,1996,1,0,"SARAH LAWRENCE COLLEGE",NA,NA,294,219,75,193,47,146,0.667,0.656,0.627,21836,234
"8043",195304,1997,1,0,"SARAH LAWRENCE COLLEGE",NA,NA,283,222,61,174,33,141,0.635,0.615,0.541,22936,236
"8044",195304,1998,1,0,"SARAH LAWRENCE COLLEGE",NA,NA,306,227,79,202,57,145,0.639,0.66,0.722,24066,243
"8045",195304,1999,1,0,"SARAH LAWRENCE COLLEGE",NA,NA,278,215,63,180,44,136,0.633,0.647,0.698,24810,203
"8046",195304,2000,1,0,"SARAH LAWRENCE COLLEGE",NA,NA,292,212,80,204,56,148,0.698,0.699,0.7,26040,203
"8047",195304,2001,1,0,"SARAH LAWRENCE COLLEGE",NA,NA,323,240,83,213,50,163,0.679,0.659,0.602,27330,239
"8048",195304,2002,1,0,"SARAH LAWRENCE COLLEGE",NA,NA,323,249,74,205,56,149,0.598,0.635,0.757,28680,261
"8049",195304,2003,1,0,"SARAH LAWRENCE COLLEGE",NA,NA,322,234,88,218,63,155,0.662,0.677,0.716,30120,243
"8050",195304,2004,1,0,"SARAH LAWRENCE COLLEGE",NA,NA,329,253,76,233,50,183,0.723,0.708,0.658,31680,254
"8051",195304,2005,1,0,"Sarah Lawrence College",NA,NA,376,285,91,237,50,187,0.656,0.63,0.549,33270,308
"8052",195304,2006,1,0,"Sarah Lawrence College",NA,NA,381,286,95,261,62,199,0.696,0.685,0.653,35280,286
"8053",195304,2007,1,0,"Sarah Lawrence College",NA,NA,363,278,85,226,50,176,0.633,0.623,0.588,37230,209
"8054",195304,2008,1,0,"Sarah Lawrence College",NA,NA,348,273,75,246,57,189,0.692,0.707,0.76,39450,254
"8055",195304,2009,1,0,"Sarah Lawrence College",NA,NA,365,273,92,263,72,191,0.7,0.721,0.783,41040,270
"8056",195304,2010,1,0,"Sarah Lawrence College",NA,NA,338,238,100,249,68,181,0.76,0.737,0.68,42600,231
"8057",195474,1991,1,0,"SIENA COLLEGE",NA,NA,584,307,277,455,220,235,0.765,0.779,0.794,9060,537
"8058",195474,1992,1,0,"SIENA COLLEGE",NA,NA,544,315,229,399,153,246,0.781,0.733,0.668,9810,497
"8059",195474,1993,1,0,"SIENA COLLEGE",NA,NA,616,339,277,421,185,236,0.696,0.683,0.668,10505,554
"8060",195474,1995,1,0,"SIENA COLLEGE",NA,NA,590,317,273,393,182,211,0.666,0.666,0.667,11650,552
"8061",195474,1996,1,0,"SIENA COLLEGE",NA,NA,558,325,233,354,137,217,0.668,0.634,0.588,12150,522
"8062",195474,1997,1,0,"SIENA COLLEGE",NA,NA,583,301,282,400,181,219,0.728,0.686,0.642,12770,545
"8063",195474,1998,1,0,"SIENA COLLEGE",NA,NA,619,311,308,436,202,234,0.752,0.704,0.656,13545,570
"8064",195474,1999,1,0,"SIENA COLLEGE",NA,NA,677,381,296,491,197,294,0.772,0.725,0.666,13660,603
"8065",195474,2000,1,0,"SIENA COLLEGE",NA,NA,765,404,361,547,234,313,0.775,0.715,0.648,14330,704
"8066",195474,2001,1,0,"SIENA COLLEGE",NA,NA,713,394,319,530,230,300,0.761,0.743,0.721,15330,639
"8067",195474,2002,1,0,"SIENA COLLEGE",NA,NA,677,405,272,497,185,312,0.77,0.734,0.68,16405,591
"8068",195474,2003,1,0,"SIENA COLLEGE",NA,NA,759,438,321,519,204,315,0.719,0.684,0.636,17555,660
"8069",195474,2004,1,0,"SIENA COLLEGE",NA,NA,715,412,303,532,212,320,0.777,0.744,0.7,18590,616
"8070",195474,2005,1,0,"Siena College",NA,NA,763,443,320,531,225,306,0.691,0.696,0.703,20100,646
"8071",195474,2006,1,0,"Siena College",NA,NA,688,393,295,478,190,288,0.733,0.695,0.644,21285,579
"8072",195474,2007,1,0,"Siena College",NA,NA,781,463,318,578,219,359,0.775,0.74,0.689,22510,668
"8073",195474,2008,1,0,"Siena College",NA,NA,824,444,380,613,272,341,0.768,0.744,0.716,23750,704
"8074",195474,2009,1,0,"Siena College",NA,NA,783,417,366,563,239,324,0.777,0.719,0.653,25060,656
"8075",195474,2010,1,0,"Siena College",NA,NA,768,410,358,539,228,311,0.758,0.702,0.637,26185,634
"8076",195526,1991,1,0,"SKIDMORE COLLEGE",NA,NA,652,392,260,401,139,262,0.668,0.615,0.535,15991,538
"8077",195526,1992,1,0,"SKIDMORE COLLEGE",NA,NA,615,369,246,425,144,281,0.762,0.691,0.585,16650,505
"8078",195526,1993,1,0,"SKIDMORE COLLEGE",NA,NA,588,355,233,414,153,261,0.735,0.704,0.657,17560,476
"8079",195526,1995,1,0,"SKIDMORE COLLEGE",NA,NA,606,373,233,438,152,286,0.767,0.723,0.652,19725,487
"8080",195526,1996,1,0,"SKIDMORE COLLEGE",NA,NA,702,424,278,501,196,305,0.719,0.714,0.705,20670,559
"8081",195526,1997,1,0,"SKIDMORE COLLEGE",NA,NA,605,372,233,452,175,277,0.745,0.747,0.751,21750,485
"8082",195526,1998,1,0,"SKIDMORE COLLEGE",NA,NA,596,366,230,482,193,289,0.79,0.809,0.839,22853,471
"8083",195526,1999,1,0,"SKIDMORE COLLEGE",NA,NA,642,367,275,470,189,281,0.766,0.732,0.687,24000,485
"8084",195526,2000,1,0,"SKIDMORE COLLEGE",NA,NA,599,345,254,461,186,275,0.797,0.77,0.732,25190,433
"8085",195526,2001,1,0,"SKIDMORE COLLEGE",NA,NA,598,352,246,469,196,273,0.776,0.784,0.797,26400,430
"8086",195526,2002,1,0,"SKIDMORE COLLEGE",NA,NA,634,383,251,494,191,303,0.791,0.779,0.761,27700,443
"8087",195526,2003,1,0,"SKIDMORE COLLEGE",NA,NA,642,377,265,527,208,319,0.846,0.821,0.785,29350,452
"8088",195526,2004,1,0,"SKIDMORE COLLEGE",NA,NA,676,383,293,539,229,310,0.809,0.797,0.782,30800,490
"8089",195526,2005,1,0,"Skidmore College",NA,NA,694,433,261,567,202,365,0.843,0.817,0.774,32340,508
"8090",195526,2006,1,0,"Skidmore College",NA,NA,672,388,284,565,231,334,0.861,0.841,0.813,34224,495
"8091",195526,2007,1,0,"Skidmore College",NA,NA,682,406,276,564,213,351,0.865,0.827,0.772,36126,470
"8092",195526,2008,1,0,"Skidmore College",NA,NA,652,400,252,552,212,340,0.85,0.847,0.841,38114,484
"8093",195526,2009,1,0,"Skidmore College",NA,NA,663,414,249,549,194,355,0.858,0.828,0.779,39600,494
"8094",195526,2010,1,0,"Skidmore College",NA,NA,768,485,283,653,225,428,0.883,0.85,0.795,40350,526
"8095",195544,1991,1,0,"SAINT JOSEPHS COLLEGE MAIN CAMPUS",NA,NA,65,47,18,41,9,32,0.681,0.631,0.5,6280,46
"8096",195544,1992,1,0,"SAINT JOSEPHS COLLEGE MAIN CAMPUS",NA,NA,55,42,13,32,7,25,0.595,0.582,0.538,6700,36
"8097",195544,1993,1,0,"SAINT JOSEPHS COLLEGE-MAIN CAMPUS",NA,NA,78,61,17,42,10,32,0.525,0.538,0.588,7122,55
"8098",195544,1995,1,0,"SAINT JOSEPHS COLLEGE-MAIN CAMPUS",NA,NA,84,64,20,56,9,47,0.734,0.667,0.45,7818,62
"8099",195544,1996,1,0,"SAINT JOSEPHS COLLEGE-MAIN CAMPUS",NA,NA,97,76,21,59,8,51,0.671,0.608,0.381,8116,68
"8100",195544,1997,1,0,"SAINT JOSEPHS COLLEGE-MAIN CAMPUS",NA,NA,107,74,33,60,18,42,0.568,0.561,0.545,8428,73
"8101",195544,1998,1,0,"SAINT JOSEPHS COLLEGE-MAIN CAMPUS",NA,NA,100,82,18,69,9,60,0.732,0.69,0.5,8672,72
"8102",195544,1999,1,0,"SAINT JOSEPHS COLLEGE-MAIN CAMPUS",NA,NA,77,55,22,51,8,43,0.782,0.662,0.364,8600,57
"8103",195544,2000,1,0,"SAINT JOSEPHS COLLEGE-MAIN CAMPUS",NA,NA,98,80,18,67,6,61,0.763,0.684,0.333,9030,66
"8104",195544,2001,1,0,"SAINT JOSEPHS COLLEGE-MAIN CAMPUS",NA,NA,66,56,10,43,4,39,0.696,0.652,0.4,9480,45
"8105",195544,2002,1,0,"SAINT JOSEPHS COLLEGE-MAIN CAMPUS",NA,NA,109,92,17,78,11,67,0.728,0.716,0.647,10050,71
"8106",195544,2003,1,0,"SAINT JOSEPHS COLLEGE-MAIN CAMPUS",NA,NA,96,80,16,67,10,57,0.713,0.698,0.625,10550,67
"8107",195544,2004,1,0,"SAINT JOSEPHS COLLEGE-MAIN CAMPUS",NA,NA,593,420,173,311,68,243,0.579,0.524,0.393,11078,418
"8108",195544,2005,1,0,"Saint Josephs College-Main Campus",NA,NA,605,446,159,291,57,234,0.525,0.481,0.358,11854,466
"8109",195544,2006,1,0,"Saint Josephs College-Main Campus",NA,NA,597,424,173,309,68,241,0.568,0.518,0.393,12564,453
"8110",195544,2007,1,0,"Saint Josephs College-Main Campus",NA,NA,672,474,198,373,87,286,0.603,0.555,0.439,14000,502
"8111",195544,2008,1,0,"Saint Josephs College-Main Campus",NA,NA,613,420,193,326,84,242,0.576,0.532,0.435,15400,462
"8112",195544,2009,1,0,"Saint Josephs College-Main Campus",NA,NA,700,519,181,374,73,301,0.58,0.534,0.403,16200,489
"8113",195544,2010,1,0,"Saint Joseph's College-New York",NA,NA,697,498,199,403,102,301,0.604,0.578,0.513,17000,465
"8114",195809,1991,1,0,"SAINT JOHN'S UNIVERSITY NEW YORK",NA,NA,2483,1282,1201,612,253,359,0.28,0.246,0.211,7530,1423
"8115",195809,1992,1,0,"SAINT JOHN'S UNIVERSITY NEW YORK",NA,NA,2326,1211,1115,526,223,303,0.25,0.226,0.2,8230,1376
"8116",195809,1993,1,0,"SAINT JOHNS UNIVERSITY-NEW YORK",NA,NA,2324,1174,1150,565,223,342,0.291,0.243,0.194,8980,1371
"8117",195809,1995,1,0,"SAINT JOHNS UNIVERSITY-NEW YORK",NA,NA,2206,1181,1025,629,234,395,0.334,0.285,0.228,10450,1146
"8118",195809,1996,1,0,"SAINT JOHNS UNIVERSITY-NEW YORK",NA,NA,2157,1146,1011,629,229,400,0.349,0.292,0.227,11380,1105
"8119",195809,1997,1,0,"SAINT JOHNS UNIVERSITY-NEW YORK",NA,NA,2480,1358,1122,789,311,478,0.352,0.318,0.277,12230,1135
"8120",195809,1998,1,0,"SAINT JOHNS UNIVERSITY-NEW YORK",NA,NA,2504,1417,1087,886,318,568,0.401,0.354,0.293,13630,1157
"8121",195809,1999,1,0,"SAINT JOHNS UNIVERSITY-NEW YORK",NA,NA,2650,1500,1150,954,357,597,0.398,0.36,0.31,13990,1087
"8122",195809,2000,1,0,"ST JOHN'S UNIVERSITY-NEW YORK",NA,NA,2853,1619,1234,997,387,610,0.377,0.349,0.314,15500,1187
"8123",195809,2001,1,0,"ST JOHN'S UNIVERSITY-NEW YORK",NA,NA,2670,1523,1147,957,357,600,0.394,0.358,0.311,16900,1103
"8124",195809,2002,1,0,"ST JOHN'S UNIVERSITY-NEW YORK",NA,NA,2954,1736,1218,1001,347,654,0.377,0.339,0.285,17850,1167
"8125",195809,2003,1,0,"ST JOHN'S UNIVERSITY-NEW YORK",NA,NA,2966,1749,1217,1058,381,677,0.387,0.357,0.313,19600,1265
"8126",195809,2004,1,0,"ST JOHN'S UNIVERSITY-NEW YORK",NA,NA,2996,1696,1300,1035,384,651,0.384,0.345,0.295,21150,1112
"8127",195809,2005,1,0,"St. John's University-New York",NA,NA,3153,1742,1411,1098,435,663,0.381,0.348,0.308,22800,1133
"8128",195809,2006,1,0,"St. John's University-New York",NA,NA,3260,1713,1547,1198,494,704,0.411,0.367,0.319,24400,1158
"8129",195809,2007,1,0,"St. John's University-New York",NA,NA,3151,1689,1462,1121,455,666,0.394,0.356,0.311,26200,1120
"8130",195809,2008,1,0,"St. John's University-New York",NA,NA,3258,1737,1521,1294,521,773,0.445,0.397,0.343,28100,1116
"8131",195809,2009,1,0,"St. John's University-New York",NA,NA,3101,1651,1450,1245,534,711,0.431,0.401,0.368,29350,1119
"8132",195809,2010,1,0,"St John's University-New York",NA,NA,3105,1626,1479,1117,500,617,0.38,0.36,0.338,31250,1028
"8133",196413,1991,1,0,"SYRACUSE UNIVERSITY MAIN CAMPUS",NA,NA,2513,1294,1219,1388,596,792,0.612,0.552,0.489,12957,1697
"8134",196413,1992,1,0,"SYRACUSE UNIVERSITY MAIN CAMPUS",NA,NA,2581,1329,1252,1465,628,837,0.63,0.568,0.502,13811,1879
"8135",196413,1993,1,0,"SYRACUSE UNIVERSITY-MAIN CAMPUS",NA,NA,2418,1270,1148,1386,590,796,0.627,0.573,0.514,14707,1707
"8136",196413,1995,1,0,"SYRACUSE UNIVERSITY",NA,NA,2392,1259,1133,1467,631,836,0.664,0.613,0.557,16280,1699
"8137",196413,1996,1,0,"SYRACUSE UNIVERSITY",NA,NA,2652,1429,1223,1722,735,987,0.691,0.649,0.601,17092,1959
"8138",196413,1997,1,0,"SYRACUSE UNIVERSITY",NA,NA,2562,1417,1145,1773,713,1060,0.748,0.692,0.623,17950,1864
"8139",196413,1998,1,0,"SYRACUSE UNIVERSITY",NA,NA,2566,1383,1183,1689,702,987,0.714,0.658,0.593,18850,1799
"8140",196413,1999,1,0,"SYRACUSE UNIVERSITY",NA,NA,2724,1534,1190,1841,748,1093,0.713,0.676,0.629,19360,1991
"8141",196413,2000,1,0,"SYRACUSE UNIVERSITY",NA,NA,2791,1569,1222,1981,805,1176,0.75,0.71,0.659,20380,2126
"8142",196413,2001,1,0,"SYRACUSE UNIVERSITY",NA,NA,2601,1493,1108,1837,716,1121,0.751,0.706,0.646,21500,1850
"8143",196413,2002,1,0,"SYRACUSE UNIVERSITY",NA,NA,2894,1676,1218,2021,793,1228,0.733,0.698,0.651,22800,1987
"8144",196413,2003,1,0,"SYRACUSE UNIVERSITY",NA,NA,2628,1501,1127,1914,755,1159,0.772,0.728,0.67,24170,1926
"8145",196413,2004,1,0,"SYRACUSE UNIVERSITY",NA,NA,2662,1505,1157,1907,766,1141,0.758,0.716,0.662,25720,1920
"8146",196413,2005,1,0,"Syracuse University",NA,NA,3243,1849,1394,2261,903,1358,0.735,0.697,0.648,27210,2000
"8147",196413,2006,1,0,"Syracuse University",NA,NA,3045,1686,1359,2099,839,1260,0.747,0.689,0.617,28820,1919
"8148",196413,2007,1,0,"Syracuse University",NA,NA,3092,1756,1336,2119,846,1273,0.725,0.685,0.633,30470,1863
"8149",196413,2008,1,0,"Syracuse University",NA,NA,3161,1853,1308,2173,846,1327,0.716,0.687,0.647,32180,1634
"8150",196413,2009,1,0,"Syracuse University",NA,NA,3240,1868,1372,2215,854,1361,0.729,0.684,0.622,33630,1843
"8151",196413,2010,1,0,"Syracuse University",NA,NA,3452,1929,1523,2379,962,1417,0.735,0.689,0.632,34970,2085
"8152",196592,1991,1,0,"TOURO COLLEGE",NA,NA,503,330,173,37,15,22,0.067,0.074,0.087,6650,0
"8153",196592,1992,1,0,"TOURO COLLEGE",NA,NA,1037,676,361,63,14,49,0.072,0.061,0.039,7030,801
"8154",196592,1993,1,0,"TOURO COLLEGE",NA,NA,1236,815,421,70,6,64,0.078,0.057,0.014,7130,982
"8155",196592,1995,1,0,"TOURO COLLEGE",NA,NA,1899,1266,633,136,70,66,0.052,0.072,0.111,8700,1445
"8156",196592,1996,1,0,"TOURO COLLEGE",NA,NA,2337,1646,691,73,40,33,0.02,0.031,0.058,8700,1633
"8157",196592,1997,1,0,"TOURO COLLEGE",NA,NA,2028,1457,571,85,27,58,0.04,0.042,0.047,8750,1348
"8158",196592,1998,1,0,"TOURO COLLEGE",NA,NA,1651,1155,496,221,65,156,0.135,0.134,0.131,8850,1005
"8159",196592,1999,1,0,"TOURO COLLEGE",NA,NA,1756,1210,546,152,50,102,0.084,0.087,0.092,9250,1230
"8160",196592,2000,1,0,"TOURO COLLEGE",NA,NA,1272,919,353,121,46,75,0.082,0.095,0.13,9750,790
"8161",196592,2001,1,0,"TOURO COLLEGE",NA,NA,1520,1064,456,146,42,104,0.098,0.096,0.092,9950,968
"8162",196592,2002,1,0,"TOURO COLLEGE",NA,NA,1877,1306,571,159,40,119,0.091,0.085,0.07,9900,922
"8163",196592,2003,1,0,"TOURO COLLEGE",NA,NA,1967,1343,624,247,74,173,0.129,0.126,0.119,9900,936
"8164",196592,2004,1,0,"TOURO COLLEGE",NA,NA,1863,1278,585,246,86,160,0.125,0.132,0.147,10200,977
"8165",196592,2005,1,0,"Touro College",NA,NA,1839,1261,578,40,13,27,0.021,0.022,0.022,10900,956
"8166",196592,2006,1,0,"Touro College",NA,NA,1479,988,491,60,25,35,0.035,0.041,0.051,11800,474
"8167",196592,2007,1,0,"Touro College",NA,NA,848,545,303,80,22,58,0.106,0.094,0.073,12300,352
"8168",196592,2008,1,0,"Touro College",NA,NA,790,486,304,69,27,42,0.086,0.087,0.089,12800,375
"8169",196592,2009,1,0,"Touro College",NA,NA,867,555,312,58,7,51,0.092,0.067,0.022,13300,356
"8170",196592,2010,1,0,"Touro College",NA,NA,1030,668,362,152,21,131,0.196,0.148,0.058,13700,592
"8171",197045,1991,1,0,"UTICA COLLEGE OF SYRACUSE UNIVERSITY",NA,NA,328,169,159,96,42,54,0.32,0.293,0.264,10536,258
"8172",197045,1992,1,0,"UTICA COLLEGE OF SYRACUSE UNIVERSITY",NA,NA,323,183,140,90,37,53,0.29,0.279,0.264,11230,250
"8173",197045,1993,1,0,"UTICA COLLEGE OF SYRACUSE UNIVERSITY",NA,NA,256,140,116,84,35,49,0.35,0.328,0.302,11980,214
"8174",197045,1995,1,0,"UTICA COLLEGE OF SYRACUSE UNIVERSITY",NA,NA,255,162,93,100,27,73,0.451,0.392,0.29,13406,184
"8175",197045,1996,1,0,"UTICA COLLEGE OF SYRACUSE UNIVERSITY",NA,NA,338,223,115,126,34,92,0.413,0.373,0.296,14206,222
"8176",197045,1997,1,0,"UTICA COLLEGE OF SYRACUSE UNIVERSITY",NA,NA,320,216,104,130,44,86,0.398,0.406,0.423,14912,232
"8177",197045,1998,1,0,"UTICA COLLEGE OF SYRACUSE UNIVERSITY",NA,NA,306,203,103,107,31,76,0.374,0.35,0.301,15654,189
"8178",197045,1999,1,0,"UTICA COLLEGE OF SYRACUSE UNIVERSITY",NA,NA,365,221,144,158,49,109,0.493,0.433,0.34,16150,240
"8179",197045,2000,1,0,"UTICA COLLEGE OF SYRACUSE UNIVERSITY",NA,NA,445,260,185,139,41,98,0.377,0.312,0.222,16844,287
"8180",197045,2001,1,0,"UTICA COLLEGE OF SYRACUSE UNIVERSITY",NA,NA,475,218,257,154,76,78,0.358,0.324,0.296,17790,333
"8181",197045,2002,1,0,"UTICA COLLEGE",NA,NA,451,226,225,180,73,107,0.474,0.399,0.324,18848,327
"8182",197045,2003,1,0,"UTICA COLLEGE",NA,NA,447,254,193,169,70,99,0.39,0.378,0.363,19980,256
"8183",197045,2004,1,0,"UTICA COLLEGE",NA,NA,484,248,236,143,68,75,0.302,0.295,0.288,20980,310
"8184",197045,2005,1,0,"Utica College",NA,NA,468,264,204,139,52,87,0.33,0.297,0.255,22030,276
"8185",197045,2006,1,0,"Utica College",NA,NA,495,277,218,164,62,102,0.368,0.331,0.284,23130,270
"8186",197045,2007,1,0,"Utica College",NA,NA,492,265,227,146,60,86,0.324,0.297,0.264,24264,316
"8187",197045,2008,1,0,"Utica College",NA,NA,568,254,314,171,82,89,0.35,0.301,0.261,25538,354
"8188",197045,2009,1,0,"Utica College",NA,NA,559,271,288,161,76,85,0.314,0.288,0.264,27764,351
"8189",197045,2010,1,0,"Utica College",NA,NA,564,281,283,190,83,107,0.381,0.337,0.293,28100,376
"8190",197133,1991,1,0,"VASSAR COLLEGE",NA,NA,592,364,228,460,167,293,0.805,0.777,0.732,16510,454
"8191",197133,1992,1,0,"VASSAR COLLEGE",NA,NA,597,370,227,478,175,303,0.819,0.801,0.771,17620,458
"8192",197133,1993,1,0,"VASSAR COLLEGE",NA,NA,649,414,235,497,169,328,0.792,0.766,0.719,18456,490
"8193",197133,1995,1,0,"VASSAR COLLEGE",NA,NA,632,381,251,509,193,316,0.829,0.805,0.769,20420,511
"8194",197133,1996,1,0,"VASSAR COLLEGE",NA,NA,614,375,239,499,191,308,0.821,0.813,0.799,21330,466
"8195",197133,1997,1,0,"VASSAR COLLEGE",NA,NA,646,409,237,529,186,343,0.839,0.819,0.785,22090,482
"8196",197133,1998,1,0,"VASSAR COLLEGE",NA,NA,626,379,247,504,191,313,0.826,0.805,0.773,23000,470
"8197",197133,1999,1,0,"VASSAR COLLEGE",NA,NA,633,381,252,543,209,334,0.877,0.858,0.829,23700,478
"8198",197133,2000,1,0,"VASSAR COLLEGE",NA,NA,639,389,250,544,211,333,0.856,0.851,0.844,24610,484
"8199",197133,2001,1,0,"VASSAR COLLEGE",NA,NA,695,447,248,612,211,401,0.897,0.881,0.851,25890,508
"8200",197133,2002,1,0,"VASSAR COLLEGE",NA,NA,632,377,255,552,217,335,0.889,0.873,0.851,27550,473
"8201",197133,2003,1,0,"VASSAR COLLEGE",NA,NA,631,367,264,554,226,328,0.894,0.878,0.856,29095,478
"8202",197133,2004,1,0,"VASSAR COLLEGE",NA,NA,654,419,235,586,198,388,0.926,0.896,0.843,30895,466
"8203",197133,2005,1,0,"Vassar College",NA,NA,647,374,273,572,238,334,0.893,0.884,0.872,33310,482
"8204",197133,2006,1,0,"Vassar College",NA,NA,668,412,256,534,173,361,0.876,0.799,0.676,35520,488
"8205",197133,2007,1,0,"Vassar College",NA,NA,677,409,268,607,233,374,0.914,0.897,0.869,37570,467
"8206",197133,2008,1,0,"Vassar College",NA,NA,638,365,273,560,235,325,0.89,0.878,0.861,39635,444
"8207",197133,2009,1,0,"Vassar College",NA,NA,658,392,266,568,217,351,0.895,0.863,0.816,41335,430
"8208",197133,2010,1,0,"Vassar College",NA,NA,665,382,283,576,242,334,0.874,0.866,0.855,42560,419
"8209",197869,1991,1,0,"APPALACHIAN STATE UNIVERSITY",NA,NA,1916,1025,891,562,185,377,0.368,0.293,0.208,1166,1780
"8210",197869,1992,1,0,"APPALACHIAN STATE UNIVERSITY",NA,NA,2060,1146,914,621,215,406,0.354,0.301,0.235,1264,1944
"8211",197869,1993,1,0,"APPALACHIAN STATE UNIVERSITY",NA,NA,1931,1098,833,603,192,411,0.374,0.312,0.23,1459,1809
"8212",197869,1995,1,0,"APPALACHIAN STATE UNIVERSITY",NA,NA,2205,1198,1007,749,273,476,0.397,0.34,0.271,1627,2082
"8213",197869,1996,1,0,"APPALACHIAN STATE UNIVERSITY",NA,NA,2026,1111,915,689,226,463,0.417,0.34,0.247,1663,1920
"8214",197869,1997,1,0,"APPALACHIAN STATE UNIVERSITY",NA,NA,2161,1177,984,711,235,476,0.404,0.329,0.239,1703,2029
"8215",197869,1998,1,0,"APPALACHIAN STATE UNIVERSITY",NA,NA,2312,1192,1120,687,239,448,0.376,0.297,0.213,1753,2184
"8216",197869,1999,1,0,"APPALACHIAN STATE UNIVERSITY",NA,NA,2199,1186,1013,778,266,512,0.432,0.354,0.263,962,2059
"8217",197869,2000,1,0,"APPALACHIAN STATE UNIVERSITY",NA,NA,2544,1370,1174,872,285,587,0.429,0.343,0.243,982,2380
"8218",197869,2001,1,0,"APPALACHIAN STATE UNIVERSITY",NA,NA,2303,1196,1107,857,309,548,0.458,0.372,0.279,1222,2181
"8219",197869,2002,1,0,"APPALACHIAN STATE UNIVERSITY",NA,NA,2412,1261,1151,964,385,579,0.459,0.4,0.334,1520,2165
"8220",197869,2003,1,0,"APPALACHIAN STATE UNIVERSITY",NA,NA,2462,1216,1246,920,360,560,0.46,0.374,0.289,1596,2219
"8221",197869,2004,1,0,"APPALACHIAN STATE UNIVERSITY",NA,NA,2507,1247,1260,941,357,584,0.468,0.375,0.283,1821,2229
"8222",197869,2005,1,0,"Appalachian State University",NA,NA,2536,1265,1271,974,391,583,0.461,0.384,0.308,1821,2308
"8223",197869,2006,1,0,"Appalachian State University",NA,NA,2707,1403,1304,1080,402,678,0.483,0.399,0.308,2221,2369
"8224",197869,2007,1,0,"Appalachian State University",NA,NA,2730,1401,1329,1133,431,702,0.501,0.415,0.324,2221,2347
"8225",197869,2008,1,0,"Appalachian State University",NA,NA,2768,1415,1353,1221,462,759,0.536,0.441,0.341,2263,2403
"8226",197869,2009,1,0,"Appalachian State University",NA,NA,2732,1471,1261,1267,464,803,0.546,0.464,0.368,2341,2437
"8227",197869,2010,1,0,"Appalachian State University",NA,NA,2816,1538,1278,1387,500,887,0.577,0.493,0.391,2961,2434
"8228",197984,1991,1,0,"BELMONT ABBEY COLLEGE",NA,NA,174,92,82,56,21,35,0.38,0.322,0.256,7470,141
"8229",197984,1992,1,0,"BELMONT ABBEY COLLEGE",NA,NA,145,67,78,42,22,20,0.299,0.29,0.282,7974,122
"8230",197984,1993,1,0,"BELMONT ABBEY COLLEGE",NA,NA,136,69,67,44,20,24,0.348,0.324,0.299,8684,120
"8231",197984,1995,1,0,"BELMONT ABBEY COLLEGE",NA,NA,114,45,69,47,26,21,0.467,0.412,0.377,9818,98
"8232",197984,1996,1,0,"BELMONT ABBEY COLLEGE",NA,NA,181,93,88,62,30,32,0.344,0.343,0.341,10408,156
"8233",197984,1997,1,0,"BELMONT ABBEY COLLEGE",NA,NA,159,68,91,61,27,34,0.5,0.384,0.297,11034,133
"8234",197984,1998,1,0,"BELMONT ABBEY COLLEGE",NA,NA,198,94,104,87,41,46,0.489,0.439,0.394,11640,179
"8235",197984,1999,1,0,"BELMONT ABBEY COLLEGE",NA,NA,195,90,105,57,27,30,0.333,0.292,0.257,11650,163
"8236",197984,2000,1,0,"BELMONT ABBEY COLLEGE",NA,NA,188,113,75,63,22,41,0.363,0.335,0.293,12116,162
"8237",197984,2001,1,0,"BELMONT ABBEY COLLEGE",NA,NA,143,68,75,61,22,39,0.574,0.427,0.293,12722,113
"8238",197984,2002,1,0,"BELMONT ABBEY COLLEGE",NA,NA,223,136,87,64,20,44,0.324,0.287,0.23,13358,137
"8239",197984,2003,1,0,"BELMONT ABBEY COLLEGE",NA,NA,147,70,77,48,25,23,0.329,0.327,0.325,14160,110
"8240",197984,2004,1,0,"BELMONT ABBEY COLLEGE",NA,NA,174,96,78,47,20,27,0.281,0.27,0.256,15010,123
"8241",197984,2005,1,0,"Belmont Abbey College",NA,NA,224,109,115,75,23,52,0.477,0.335,0.2,15910,154
"8242",197984,2006,1,0,"Belmont Abbey College",NA,NA,279,142,137,94,34,60,0.422,0.337,0.248,16870,198
"8243",197984,2007,1,0,"Belmont Abbey College",NA,NA,210,90,120,69,28,41,0.456,0.329,0.233,17880,144
"8244",197984,2008,1,0,"Belmont Abbey College",NA,NA,286,134,152,93,39,54,0.403,0.325,0.257,19114,184
"8245",197984,2009,1,0,"Belmont Abbey College",NA,NA,396,224,172,138,50,88,0.393,0.348,0.291,20356,211
"8246",197984,2010,1,0,"Belmont Abbey College",NA,NA,307,139,168,103,53,50,0.36,0.336,0.315,23183,21
"8247",198385,1991,1,0,"DAVIDSON COLLEGE",NA,NA,397,179,218,339,178,161,0.899,0.854,0.817,14058,352
"8248",198385,1992,1,0,"DAVIDSON COLLEGE",NA,NA,414,221,193,367,170,197,0.891,0.886,0.881,14950,375
"8249",198385,1993,1,0,"DAVIDSON COLLEGE",NA,NA,452,195,257,381,212,169,0.867,0.843,0.825,16263,383
"8250",198385,1995,1,0,"DAVIDSON COLLEGE",NA,NA,429,209,220,373,186,187,0.895,0.869,0.845,18626,373
"8251",198385,1996,1,0,"DAVIDSON COLLEGE",NA,NA,439,230,209,385,181,204,0.887,0.877,0.866,19631,399
"8252",198385,1997,1,0,"DAVIDSON COLLEGE",NA,NA,470,230,240,417,206,211,0.917,0.887,0.858,20595,407
"8253",198385,1998,1,0,"DAVIDSON COLLEGE",NA,NA,472,253,219,423,198,225,0.889,0.896,0.904,21395,405
"8254",198385,1999,1,0,"DAVIDSON COLLEGE",NA,NA,456,226,230,380,187,193,0.854,0.833,0.813,22014,394
"8255",198385,2000,1,0,"DAVIDSON COLLEGE",NA,NA,465,229,236,413,193,220,0.961,0.888,0.818,22872,407
"8256",198385,2001,1,0,"DAVIDSON COLLEGE",NA,NA,465,246,219,420,193,227,0.923,0.903,0.881,23739,369
"8257",198385,2002,1,0,"DAVIDSON COLLEGE",NA,NA,468,243,225,430,201,229,0.942,0.919,0.893,24930,382
"8258",198385,2003,1,0,"DAVIDSON COLLEGE",NA,NA,489,237,252,435,218,217,0.916,0.89,0.865,24987,385
"8259",198385,2004,1,0,"DAVIDSON COLLEGE",NA,NA,462,238,224,410,192,218,0.916,0.887,0.857,26211,345
"8260",198385,2005,1,0,"Davidson College",NA,NA,459,234,225,400,182,218,0.932,0.871,0.809,27653,358
"8261",198385,2006,1,0,"Davidson College",NA,NA,461,233,228,410,197,213,0.914,0.889,0.864,29119,340
"8262",198385,2007,1,0,"Davidson College",NA,NA,464,234,230,417,198,219,0.936,0.899,0.861,30662,346
"8263",198385,2008,1,0,"Davidson College",NA,NA,480,250,230,436,209,227,0.908,0.908,0.909,33148,345
"8264",198385,2009,1,0,"Davidson College",NA,NA,487,252,235,438,207,231,0.917,0.899,0.881,34776,365
"8265",198385,2010,1,0,"Davidson College",NA,NA,499,246,253,452,223,229,0.931,0.906,0.881,36320,344
"8266",198464,1991,1,0,"EAST CAROLINA UNIVERSITY",NA,NA,2338,1288,1050,386,124,262,0.203,0.165,0.118,1204,2025
"8267",198464,1992,1,0,"EAST CAROLINA UNIVERSITY",NA,NA,2880,1673,1207,561,166,395,0.236,0.195,0.138,1246,2552
"8268",198464,1993,1,0,"EAST CAROLINA UNIVERSITY",NA,NA,2428,1417,1011,558,151,407,0.287,0.23,0.149,1366,2106
"8269",198464,1995,1,0,"EAST CAROLINA UNIVERSITY",NA,NA,2635,1550,1085,630,189,441,0.284,0.239,0.174,1673,2263
"8270",198464,1996,1,0,"EAST CAROLINA UNIVERSITY",NA,NA,2626,1581,1045,673,216,457,0.289,0.256,0.207,1752,2208
"8271",198464,1997,1,0,"EAST CAROLINA UNIVERSITY",NA,NA,2871,1718,1153,705,222,483,0.281,0.246,0.193,1832,2411
"8272",198464,1998,1,0,"EAST CAROLINA UNIVERSITY",NA,NA,2803,1714,1089,720,196,524,0.306,0.257,0.18,1886,2288
"8273",198464,1999,1,0,"EAST CAROLINA UNIVERSITY",NA,NA,3255,1931,1324,822,266,556,0.288,0.253,0.201,992,2600
"8274",198464,2000,1,0,"EAST CAROLINA UNIVERSITY",NA,NA,3105,1837,1268,856,248,608,0.331,0.276,0.196,1195,2533
"8275",198464,2001,1,0,"EAST CAROLINA UNIVERSITY",NA,NA,3182,1877,1305,813,242,571,0.304,0.255,0.185,1453,2576
"8276",198464,2002,1,0,"EAST CAROLINA UNIVERSITY",NA,NA,3561,2117,1444,968,294,674,0.318,0.272,0.204,1819,2973
"8277",198464,2003,1,0,"EAST CAROLINA UNIVERSITY",NA,NA,3458,2117,1341,1035,293,742,0.35,0.299,0.218,1910,2811
"8278",198464,2004,1,0,"EAST CAROLINA UNIVERSITY",NA,NA,3451,2143,1308,1009,294,715,0.334,0.292,0.225,2135,2746
"8279",198464,2005,1,0,"East Carolina University",NA,NA,3220,1973,1247,1048,345,703,0.356,0.325,0.277,2135,2505
"8280",198464,2006,1,0,"East Carolina University",NA,NA,3784,2331,1453,1240,347,893,0.383,0.328,0.239,2335,2820
"8281",198464,2007,1,0,"East Carolina University",NA,NA,4195,2535,1660,1294,391,903,0.356,0.308,0.236,2431,3123
"8282",198464,2008,1,0,"East Carolina University",NA,NA,4515,2608,1907,1468,483,985,0.378,0.325,0.253,2445,3483
"8283",198464,2009,1,0,"East Carolina University",NA,NA,3942,2273,1669,1397,445,952,0.419,0.354,0.267,2491,3021
"8284",198464,2010,1,0,"East Carolina University",NA,NA,4196,2446,1750,1417,448,969,0.396,0.338,0.256,2881,2984
"8285",198507,1991,1,0,"ELIZABETH CITY STATE UNIVERSITY",NA,NA,402,217,185,135,48,87,0.401,0.336,0.259,1150,49
"8286",198507,1992,1,0,"ELIZABETH CITY STATE UNIVERSITY",NA,NA,541,317,224,181,47,134,0.423,0.335,0.21,1184,72
"8287",198507,1993,1,0,"ELIZABETH CITY STATE UNIVERSITY",NA,NA,460,273,187,164,47,117,0.429,0.357,0.251,1242,93
"8288",198507,1995,1,0,"ELIZABETH CITY STATE UNIVERSITY",NA,NA,381,222,159,162,47,115,0.518,0.425,0.296,1410,49
"8289",198507,1996,1,0,"ELIZABETH CITY STATE UNIVERSITY",NA,NA,380,205,175,130,44,86,0.42,0.342,0.251,1468,66
"8290",198507,1997,1,0,"ELIZABETH CITY STATE UNIVERSITY",NA,NA,424,251,173,133,33,100,0.398,0.314,0.191,1522,70
"8291",198507,1998,1,0,"ELIZABETH CITY STATE UNIVERSITY",NA,NA,378,229,149,109,22,87,0.38,0.288,0.148,1572,51
"8292",198507,1999,1,0,"ELIZABETH CITY STATE UNIVERSITY",NA,NA,402,247,155,109,22,87,0.352,0.271,0.142,806,71
"8293",198507,2000,1,0,"ELIZABETH CITY STATE UNIVERSITY",NA,NA,441,248,193,133,32,101,0.407,0.302,0.166,822,51
"8294",198507,2001,1,0,"ELIZABETH CITY STATE UNIVERSITY",NA,NA,363,200,163,102,32,70,0.35,0.281,0.196,896,49
"8295",198507,2002,1,0,"ELIZABETH CITY STATE UNIVERSITY",NA,NA,458,270,188,108,16,92,0.341,0.236,0.085,1118,60
"8296",198507,2003,1,0,"ELIZABETH CITY STATE UNIVERSITY",NA,NA,459,258,201,104,36,68,0.264,0.227,0.179,1174,73
"8297",198507,2004,1,0,"ELIZABETH CITY STATE UNIVERSITY",NA,NA,554,295,259,107,30,77,0.261,0.193,0.116,1399,78
"8298",198507,2005,1,0,"Elizabeth City State University",NA,NA,556,328,228,99,28,71,0.216,0.178,0.123,1399,66
"8299",198507,2006,1,0,"Elizabeth City State University",NA,NA,534,313,221,90,20,70,0.224,0.169,0.09,1490,49
"8300",198507,2007,1,0,"Elizabeth City State University",NA,NA,642,391,251,138,39,99,0.253,0.215,0.155,1587,49
"8301",198507,2008,1,0,"Elizabeth City State University",NA,NA,636,368,268,95,25,70,0.19,0.149,0.093,1611,41
"8302",198507,2009,1,0,"Elizabeth City State University",NA,NA,659,375,284,106,35,71,0.189,0.161,0.123,1681,70
"8303",198507,2010,1,0,"Elizabeth City State University",NA,NA,573,319,254,94,31,63,0.198,0.164,0.122,2204,45
"8304",198516,1991,1,0,"ELON COLLEGE",NA,NA,780,461,319,381,121,260,0.564,0.488,0.379,7520,729
"8305",198516,1992,1,0,"ELON COLLEGE",NA,NA,817,470,347,455,175,280,0.596,0.557,0.504,8110,742
"8306",198516,1993,1,0,"ELON COLLEGE",NA,NA,857,492,365,478,197,281,0.571,0.558,0.54,8630,787
"8307",198516,1995,1,0,"ELON COLLEGE",NA,NA,907,545,362,548,198,350,0.642,0.604,0.547,9910,827
"8308",198516,1996,1,0,"ELON COLLEGE",NA,NA,941,569,372,551,204,347,0.61,0.586,0.548,10667,851
"8309",198516,1997,1,0,"ELON COLLEGE",NA,NA,964,584,380,599,207,392,0.671,0.621,0.545,11542,860
"8310",198516,1998,1,0,"ELON COLLEGE",NA,NA,1013,632,381,660,234,426,0.674,0.652,0.614,12147,894
"8311",198516,1999,1,0,"ELON COLLEGE",NA,NA,999,637,362,701,232,469,0.736,0.702,0.641,12671,885
"8312",198516,2000,1,0,"ELON COLLEGE",NA,NA,1144,718,426,744,244,500,0.696,0.65,0.573,13556,1034
"8313",198516,2001,1,0,"ELON UNIVERSITY",NA,NA,1212,757,455,797,263,534,0.705,0.658,0.578,14335,1058
"8314",198516,2002,1,0,"ELON UNIVERSITY",NA,NA,1192,736,456,856,308,548,0.745,0.718,0.675,15280,1054
"8315",198516,2003,1,0,"ELON UNIVERSITY",NA,NA,1227,775,452,875,294,581,0.75,0.713,0.65,16325,1083
"8316",198516,2004,1,0,"ELON UNIVERSITY",NA,NA,1230,775,455,918,319,599,0.773,0.746,0.701,17310,1038
"8317",198516,2005,1,0,"Elon University",NA,NA,1237,748,489,959,370,589,0.787,0.775,0.757,18699,1060
"8318",198516,2006,1,0,"Elon University",NA,NA,1283,740,543,991,378,613,0.828,0.772,0.696,20171,1064
"8319",198516,2007,1,0,"Elon University",NA,NA,1286,746,540,987,380,607,0.814,0.767,0.704,21886,1055
"8320",198516,2008,1,0,"Elon University",NA,NA,1290,777,513,977,358,619,0.797,0.757,0.698,23746,983
"8321",198516,2009,1,0,"Elon University",NA,NA,1290,774,516,1025,374,651,0.841,0.795,0.725,25159,1065
"8322",198516,2010,1,0,"Elon University",NA,NA,1359,794,565,1041,386,655,0.825,0.766,0.683,26480,1052
"8323",198835,1991,1,0,"LENOIR-RHYNE COLLEGE",NA,NA,279,153,126,113,33,80,0.523,0.405,0.262,8520,251
"8324",198835,1992,1,0,"LENOIR-RHYNE COLLEGE",NA,NA,255,162,93,104,30,74,0.457,0.408,0.323,9500,227
"8325",198835,1993,1,0,"LENOIR-RHYNE COLLEGE",NA,NA,254,135,119,115,39,76,0.563,0.453,0.328,10220,229
"8326",198835,1995,1,0,"LENOIR-RHYNE COLLEGE",NA,NA,287,157,130,132,47,85,0.541,0.46,0.362,10960,258
"8327",198835,1996,1,0,"LENOIR-RHYNE COLLEGE",NA,NA,232,135,97,96,32,64,0.474,0.414,0.33,11416,205
"8328",198835,1997,1,0,"LENOIR-RHYNE COLLEGE",NA,NA,306,167,139,119,41,78,0.467,0.389,0.295,12036,270
"8329",198835,1998,1,0,"LENOIR-RHYNE COLLEGE",NA,NA,267,138,129,112,38,74,0.536,0.419,0.295,12386,219
"8330",198835,1999,1,0,"LENOIR-RHYNE COLLEGE",NA,NA,288,168,120,117,37,80,0.476,0.406,0.308,12310,228
"8331",198835,2000,1,0,"LENOIR-RHYNE COLLEGE",NA,NA,268,142,126,122,42,80,0.563,0.455,0.333,12870,229
"8332",198835,2001,1,0,"LENOIR-RHYNE COLLEGE",NA,NA,268,159,109,107,27,80,0.503,0.399,0.248,13600,234
"8333",198835,2002,1,0,"LENOIR-RHYNE COLLEGE",NA,NA,319,161,158,145,69,76,0.472,0.455,0.437,14350,271
"8334",198835,2003,1,0,"LENOIR-RHYNE COLLEGE",NA,NA,308,178,130,124,45,79,0.444,0.403,0.346,15750,264
"8335",198835,2004,1,0,"LENOIR-RHYNE COLLEGE",NA,NA,322,196,126,123,35,88,0.449,0.382,0.278,17120,262
"8336",198835,2005,1,0,"Lenoir-Rhyne College",NA,NA,326,203,123,122,37,85,0.419,0.374,0.301,18130,264
"8337",198835,2006,1,0,"Lenoir-Rhyne College",NA,NA,347,195,152,117,40,77,0.395,0.337,0.263,19350,275
"8338",198835,2007,1,0,"Lenoir-Rhyne College",NA,NA,367,214,153,146,48,98,0.458,0.398,0.314,20690,288
"8339",198835,2008,1,0,"Lenoir-Rhyne University",NA,NA,345,217,128,140,32,108,0.498,0.406,0.25,23070,259
"8340",198835,2009,1,0,"Lenoir-Rhyne University",NA,NA,355,215,140,119,36,83,0.386,0.335,0.257,24200,170
"8341",198835,2010,1,0,"Lenoir-Rhyne University",NA,NA,423,229,194,149,53,96,0.419,0.352,0.273,25290,325
"8342",198969,1991,1,0,"METHODIST COLLEGE",NA,NA,254,86,168,59,35,24,0.279,0.232,0.208,7700,217
"8343",198969,1992,1,0,"METHODIST COLLEGE",NA,NA,290,98,192,54,36,18,0.184,0.186,0.188,8250,217
"8344",198969,1993,1,0,"METHODIST COLLEGE",NA,NA,310,81,229,49,28,21,0.259,0.158,0.122,8850,227
"8345",198969,1995,1,0,"METHODIST COLLEGE",NA,NA,370,121,249,67,37,30,0.248,0.181,0.149,9950,267
"8346",198969,1996,1,0,"METHODIST COLLEGE",NA,NA,320,100,220,55,30,25,0.25,0.172,0.136,10600,241
"8347",198969,1997,1,0,"METHODIST COLLEGE",NA,NA,350,107,243,69,41,28,0.262,0.197,0.169,11250,270
"8348",198969,1998,1,0,"METHODIST COLLEGE",NA,NA,437,117,320,88,55,33,0.282,0.201,0.172,11900,312
"8349",198969,1999,1,0,"METHODIST COLLEGE",NA,NA,378,123,255,53,23,30,0.244,0.14,0.09,12600,285
"8350",198969,2000,1,0,"METHODIST COLLEGE",NA,NA,308,115,193,46,18,28,0.244,0.149,0.093,13300,226
"8351",198969,2001,1,0,"METHODIST COLLEGE",NA,NA,379,117,262,59,28,31,0.265,0.156,0.107,14070,265
"8352",198969,2002,1,0,"METHODIST COLLEGE",NA,NA,395,118,277,58,20,38,0.322,0.147,0.072,14840,274
"8353",198969,2003,1,0,"METHODIST COLLEGE",NA,NA,384,120,264,58,26,32,0.267,0.151,0.098,15650,275
"8354",198969,2004,1,0,"METHODIST COLLEGE",NA,NA,435,143,292,71,25,46,0.322,0.163,0.086,16500,290
"8355",198969,2005,1,0,"Methodist College",NA,NA,387,143,244,59,22,37,0.259,0.152,0.09,17580,266
"8356",198969,2006,1,0,"Methodist University",NA,NA,449,135,314,75,31,44,0.326,0.167,0.099,18780,306
"8357",198969,2007,1,0,"Methodist University",NA,NA,433,138,295,76,31,45,0.326,0.176,0.105,20050,262
"8358",198969,2008,1,0,"Methodist University",NA,NA,439,148,291,64,26,38,0.257,0.146,0.089,21470,239
"8359",198969,2009,1,0,"Methodist University",NA,NA,472,144,328,80,35,45,0.312,0.169,0.107,22620,161
"8360",198969,2010,1,0,"Methodist University",NA,NA,531,190,341,104,46,58,0.305,0.196,0.135,23780,282
"8361",199102,1991,1,0,"NORTH CAROLINA AGRICULTURAL AND TECHNICAL ST UNIV",NA,NA,1469,803,666,275,63,212,0.264,0.187,0.095,1228,35
"8362",199102,1992,1,0,"NORTH CAROLINA AGRICULTURAL AND TECHNICAL ST UNIV",NA,NA,1484,780,704,290,86,204,0.262,0.195,0.122,1270,40
"8363",199102,1993,1,0,"NORTH CAROLINA AGRICULTURAL AND TECHNICAL ST UNIV",NA,NA,1429,775,654,300,85,215,0.277,0.21,0.13,1367,40
"8364",199102,1995,1,0,"NORTH CAROLINA AGRICULTURAL AND TECHNICAL ST UNIV",NA,NA,1396,706,690,339,117,222,0.314,0.243,0.17,1532,40
"8365",199102,1996,1,0,"NORTH CAROLINA AGRICULTURAL AND TECHNICAL ST UNIV",NA,NA,1313,692,621,300,90,210,0.304,0.228,0.145,1561,30
"8366",199102,1997,1,0,"NORTH CAROLINA AGRICULTURAL AND TECHNICAL ST UNIV",NA,NA,1383,727,656,363,118,245,0.337,0.262,0.18,1622,43
"8367",199102,1998,1,0,"NORTH CAROLINA AGRICULTURAL AND TECHNICAL ST UNIV",NA,NA,1366,695,671,323,104,219,0.315,0.236,0.155,1680,34
"8368",199102,1999,1,0,"NORTH CAROLINA AGRICULTURAL AND TECHNICAL ST UNIV",NA,NA,1530,850,680,348,112,236,0.278,0.227,0.165,962,37
"8369",199102,2000,1,0,"NORTH CAROLINA AGRICULTURAL AND TECHNICAL ST UNIV",NA,NA,1661,884,777,321,97,224,0.253,0.193,0.125,982,46
"8370",199102,2001,1,0,"NORTH CAROLINA AGRICULTURAL AND TECHNICAL ST UNIV",NA,NA,1760,874,886,354,117,237,0.271,0.201,0.132,1222,56
"8371",199102,2002,1,0,"NORTH CAROLINA AGRICULTURAL AND TECHNICAL ST UNIV",NA,NA,2025,1043,982,299,90,209,0.2,0.148,0.092,1470,60
"8372",199102,2003,1,0,"NORTH CAROLINA A & T STATE UNIVERSITY",NA,NA,2221,1176,1045,389,104,285,0.242,0.175,0.1,1544,69
"8373",199102,2004,1,0,"NORTH CAROLINA  A &T STATE UNIVERSITY",NA,NA,2212,1147,1065,335,86,249,0.217,0.151,0.081,1769,39
"8374",199102,2005,1,0,"North Carolina A & T State University",NA,NA,2237,1178,1059,369,116,253,0.215,0.165,0.11,1769,34
"8375",199102,2006,1,0,"North Carolina A & T State University",NA,NA,2068,1102,966,340,81,259,0.235,0.164,0.084,1994,53
"8376",199102,2007,1,0,"North Carolina A & T State University",NA,NA,1569,819,750,251,64,187,0.228,0.16,0.085,1994,34
"8377",199102,2008,1,0,"North Carolina A & T State University",NA,NA,1592,848,744,342,105,237,0.28,0.215,0.141,1994,44
"8378",199102,2009,1,0,"North Carolina A & T State University",NA,NA,1875,1028,847,383,116,267,0.26,0.204,0.137,1994,45
"8379",199102,2010,1,0,"North Carolina A & T State University",NA,NA,2040,1065,975,374,108,266,0.25,0.183,0.111,2621,38
"8380",199111,1991,1,0,"UNIVERSITY OF NORTH CAROLINA AT ASHEVILLE",NA,NA,336,199,137,77,18,59,0.296,0.229,0.131,1116,316
"8381",199111,1992,1,0,"UNIVERSITY OF NORTH CAROLINA AT ASHEVILLE",NA,NA,364,195,169,101,33,68,0.349,0.277,0.195,1150,339
"8382",199111,1993,1,0,"UNIVERSITY OF NORTH CAROLINA AT ASHEVILLE",NA,NA,394,222,172,129,42,87,0.392,0.327,0.244,1436,368
"8383",199111,1995,1,0,"UNIVERSITY OF NORTH CAROLINA AT ASHEVILLE",NA,NA,393,235,158,123,35,88,0.375,0.313,0.222,1658,346
"8384",199111,1996,1,0,"UNIVERSITY OF NORTH CAROLINA AT ASHEVILLE",NA,NA,450,275,175,139,42,97,0.353,0.309,0.24,1723,408
"8385",199111,1997,1,0,"UNIVERSITY OF NORTH CAROLINA AT ASHEVILLE",NA,NA,470,264,206,138,49,89,0.337,0.294,0.238,1784,427
"8386",199111,1998,1,0,"UNIVERSITY OF NORTH CAROLINA AT ASHEVILLE",NA,NA,474,278,196,120,35,85,0.306,0.253,0.179,1832,434
"8387",199111,1999,1,0,"UNIVERSITY OF NORTH CAROLINA AT ASHEVILLE",NA,NA,456,267,189,128,48,80,0.3,0.281,0.254,806,414
"8388",199111,2000,1,0,"UNIVERSITY OF NORTH CAROLINA AT ASHEVILLE",NA,NA,496,284,212,154,54,100,0.352,0.31,0.255,822,451
"8389",199111,2001,1,0,"UNIVERSITY OF NORTH CAROLINA AT ASHEVILLE",NA,NA,446,281,165,149,43,106,0.377,0.334,0.261,1196,396
"8390",199111,2002,1,0,"UNIVERSITY OF NORTH CAROLINA AT ASHEVILLE",NA,NA,421,250,171,140,41,99,0.396,0.333,0.24,1592,383
"8391",199111,2003,1,0,"UNIVERSITY OF NORTH CAROLINA AT ASHEVILLE",NA,NA,590,332,258,170,45,125,0.376,0.288,0.174,1672,535
"8392",199111,2004,1,0,"UNIVERSITY OF NORTH CAROLINA AT ASHEVILLE",NA,NA,694,418,276,208,59,149,0.356,0.3,0.214,1897,626
"8393",199111,2005,1,0,"University of North Carolina at Asheville",NA,NA,471,291,180,154,51,103,0.354,0.327,0.283,1897,418
"8394",199111,2006,1,0,"University of North Carolina at Asheville",NA,NA,567,328,239,180,57,123,0.375,0.317,0.238,2172,503
"8395",199111,2007,1,0,"University of North Carolina at Asheville",NA,NA,571,341,230,211,67,144,0.422,0.37,0.291,2307,487
"8396",199111,2008,1,0,"University of North Carolina at Asheville",NA,NA,586,361,225,225,77,148,0.41,0.384,0.342,2339,498
"8397",199111,2009,1,0,"University of North Carolina at Asheville",NA,NA,637,363,274,230,75,155,0.427,0.361,0.274,2389,556
"8398",199111,2010,1,0,"University of North Carolina at Asheville",NA,NA,590,335,255,231,87,144,0.43,0.392,0.341,2626,497
"8399",199120,1991,1,0,"UNIVERSITY OF NORTH CAROLINA AT CHAPEL HILL",NA,NA,3133,1941,1192,1966,672,1294,0.667,0.628,0.564,1248,2589
"8400",199120,1992,1,0,"UNIVERSITY OF NORTH CAROLINA AT CHAPEL HILL",NA,NA,3200,1957,1243,2009,733,1276,0.652,0.628,0.59,1249,2626
"8401",199120,1993,1,0,"UNIVERSITY OF NORTH CAROLINA AT CHAPEL HILL",NA,NA,3310,2048,1262,2089,744,1345,0.657,0.631,0.59,1419,2702
"8402",199120,1995,1,0,"UNIVERSITY OF NORTH CAROLINA AT CHAPEL HILL",NA,NA,3229,1982,1247,2101,732,1369,0.691,0.651,0.587,1640,2610
"8403",199120,1996,1,0,"UNIVERSITY OF NORTH CAROLINA AT CHAPEL HILL",NA,NA,3270,2065,1205,2185,718,1467,0.71,0.668,0.596,2110,2629
"8404",199120,1997,1,0,"UNIVERSITY OF NORTH CAROLINA AT CHAPEL HILL",NA,NA,3412,2118,1294,2371,816,1555,0.734,0.695,0.631,2173,2728
"8405",199120,1998,1,0,"UNIVERSITY OF NORTH CAROLINA AT CHAPEL HILL",NA,NA,3425,2116,1309,2289,794,1495,0.707,0.668,0.607,2211,2778
"8406",199120,1999,1,0,"UNIVERSITY OF NORTH CAROLINA AT CHAPEL HILL",NA,NA,3388,2099,1289,2389,797,1592,0.758,0.705,0.618,1528,2706
"8407",199120,2000,1,0,"UNIVERSITY OF NORTH CAROLINA AT CHAPEL HILL",NA,NA,3406,2121,1285,2426,829,1597,0.753,0.712,0.645,1860,2680
"8408",199120,2001,1,0,"UNIVERSITY OF NORTH CAROLINA AT CHAPEL HILL",NA,NA,3681,2195,1486,2611,986,1625,0.74,0.709,0.664,2328,2827
"8409",199120,2002,1,0,"UNIVERSITY OF NORTH CAROLINA AT CHAPEL HILL",NA,NA,3455,2053,1402,2513,935,1578,0.769,0.727,0.667,2814,2581
"8410",199120,2003,1,0,"UNIVERSITY OF NORTH CAROLINA AT CHAPEL HILL",NA,NA,3511,2068,1443,2535,945,1590,0.769,0.722,0.655,2955,2558
"8411",199120,2004,1,0,"UNIVERSITY OF NORTH CAROLINA AT CHAPEL HILL",NA,NA,3584,2099,1485,2685,1027,1658,0.79,0.749,0.692,3205,2610
"8412",199120,2005,1,0,"University of North Carolina at Chapel Hill",NA,NA,3747,2270,1477,2819,1050,1769,0.779,0.752,0.711,3205,2740
"8413",199120,2006,1,0,"University of North Carolina at Chapel Hill",NA,NA,3796,2276,1520,2893,1107,1786,0.785,0.762,0.728,3455,2649
"8414",199120,2007,1,0,"University of North Carolina at Chapel Hill",NA,NA,3877,2338,1539,3124,1151,1973,0.844,0.806,0.748,3705,2684
"8415",199120,2008,1,0,"University of North Carolina at Chapel Hill",NA,NA,3852,2270,1582,3096,1188,1908,0.841,0.804,0.751,3705,2641
"8416",199120,2009,1,0,"University of North Carolina at Chapel Hill",NA,NA,3955,2354,1601,3216,1225,1991,0.846,0.813,0.765,3865,2655
"8417",199120,2010,1,0,"University of North Carolina at Chapel Hill",NA,NA,3944,2371,1573,3299,1235,2064,0.87,0.836,0.785,4815,2763
"8418",199139,1991,1,0,"UNIVERSITY OF NORTH CAROLINA AT CHARLOTTE",NA,NA,1552,876,676,347,86,261,0.298,0.224,0.127,1147,1216
"8419",199139,1992,1,0,"UNIVERSITY OF NORTH CAROLINA AT CHARLOTTE",NA,NA,1575,813,762,291,111,180,0.221,0.185,0.146,1189,1202
"8420",199139,1993,1,0,"UNIVERSITY OF NORTH CAROLINA AT CHARLOTTE",NA,NA,1685,845,840,312,111,201,0.238,0.185,0.132,1383,1245
"8421",199139,1995,1,0,"UNIVERSITY OF NORTH CAROLINA AT CHARLOTTE",NA,NA,1663,974,689,396,115,281,0.289,0.238,0.167,1618,1231
"8422",199139,1996,1,0,"UNIVERSITY OF NORTH CAROLINA AT CHARLOTTE",NA,NA,1682,952,730,359,113,246,0.258,0.213,0.155,1716,1243
"8423",199139,1997,1,0,"UNIVERSITY OF NORTH CAROLINA AT CHARLOTTE",NA,NA,1904,1077,827,418,155,263,0.244,0.22,0.187,1777,1417
"8424",199139,1998,1,0,"UNIVERSITY OF NORTH CAROLINA AT CHARLOTTE",NA,NA,2122,1178,944,456,169,287,0.244,0.215,0.179,1834,1508
"8425",199139,1999,1,0,"UNIVERSITY OF NORTH CAROLINA AT CHARLOTTE",NA,NA,2078,1111,967,489,181,308,0.277,0.235,0.187,962,1575
"8426",199139,2000,1,0,"UNIVERSITY OF NORTH CAROLINA AT CHARLOTTE",NA,NA,2142,1208,934,553,194,359,0.297,0.258,0.208,1132,1648
"8427",199139,2001,1,0,"UNIVERSITY OF NORTH CAROLINA AT CHARLOTTE",NA,NA,2309,1273,1036,610,209,401,0.315,0.264,0.202,1417,1795
"8428",199139,2002,1,0,"UNIVERSITY OF NORTH CAROLINA AT CHARLOTTE",NA,NA,2383,1234,1149,577,204,373,0.302,0.242,0.178,1813,1890
"8429",199139,2003,1,0,"UNIVERSITY OF NORTH CAROLINA AT CHARLOTTE",NA,NA,2472,1291,1181,630,244,386,0.299,0.255,0.207,1904,1975
"8430",199139,2004,1,0,"UNIVERSITY OF NORTH CAROLINA AT CHARLOTTE",NA,NA,2599,1416,1183,707,249,458,0.323,0.272,0.21,2129,2092
"8431",199139,2005,1,0,"University of North Carolina at Charlotte",NA,NA,2859,1498,1361,741,273,468,0.312,0.259,0.201,2129,2288
"8432",199139,2006,1,0,"University of North Carolina at Charlotte",NA,NA,2764,1475,1289,728,280,448,0.304,0.263,0.217,2344,2161
"8433",199139,2007,1,0,"University of North Carolina at Charlotte",NA,NA,2926,1520,1406,749,304,445,0.293,0.256,0.216,2461,2238
"8434",199139,2008,1,0,"University of North Carolina at Charlotte",NA,NA,3059,1610,1449,766,289,477,0.296,0.25,0.199,2516,2238
"8435",199139,2009,1,0,"University of North Carolina at Charlotte",NA,NA,3152,1571,1581,820,319,501,0.319,0.26,0.202,2516,2078
"8436",199139,2010,1,0,"University of North Carolina at Charlotte",NA,NA,2947,1513,1434,840,312,528,0.349,0.285,0.218,3044,1927
"8437",199148,1991,1,0,"UNIVERSITY OF NORTH CAROLINA AT GREENSBORO",NA,NA,1345,890,455,358,82,276,0.31,0.266,0.18,1492,1090
"8438",199148,1992,1,0,"UNIVERSITY OF NORTH CAROLINA AT GREENSBORO",NA,NA,1509,1000,509,363,80,283,0.283,0.241,0.157,1540,1182
"8439",199148,1993,1,0,"UNIVERSITY OF NORTH CAROLINA AT GREENSBORO",NA,NA,1500,959,541,297,61,236,0.246,0.198,0.113,1717,1187
"8440",199148,1995,1,0,"UNIVERSITY OF NORTH CAROLINA AT GREENSBORO",NA,NA,1804,1234,570,376,77,299,0.242,0.208,0.135,1868,1333
"8441",199148,1996,1,0,"UNIVERSITY OF NORTH CAROLINA AT GREENSBORO",NA,NA,1552,1075,477,390,77,313,0.291,0.251,0.161,1943,1182
"8442",199148,1997,1,0,"UNIVERSITY OF NORTH CAROLINA AT GREENSBORO",NA,NA,1577,1091,486,431,90,341,0.313,0.273,0.185,2019,1150
"8443",199148,1998,1,0,"UNIVERSITY OF NORTH CAROLINA AT GREENSBORO",NA,NA,1791,1257,534,472,94,378,0.301,0.264,0.176,2039,1283
"8444",199148,1999,1,0,"UNIVERSITY OF NORTH CAROLINA AT GREENSBORO",NA,NA,1908,1346,562,540,107,433,0.322,0.283,0.19,1086,1373
"8445",199148,2000,1,0,"UNIVERSITY OF NORTH CAROLINA AT GREENSBORO",NA,NA,1867,1355,512,556,112,444,0.328,0.298,0.219,1108,1363
"8446",199148,2001,1,0,"UNIVERSITY OF NORTH CAROLINA AT GREENSBORO",NA,NA,1898,1350,548,511,102,409,0.303,0.269,0.186,1358,1336
"8447",199148,2002,1,0,"UNIVERSITY OF NORTH CAROLINA AT GREENSBORO",NA,NA,2071,1420,651,570,118,452,0.318,0.275,0.181,1717,1487
"8448",199148,2003,1,0,"UNIVERSITY OF NORTH CAROLINA AT GREENSBORO",NA,NA,2039,1422,617,577,123,454,0.319,0.283,0.199,1803,1436
"8449",199148,2004,1,0,"UNIVERSITY OF NORTH CAROLINA AT GREENSBORO",NA,NA,2159,1525,634,625,124,501,0.328,0.289,0.196,2028,1517
"8450",199148,2005,1,0,"University of North Carolina at Greensboro",NA,NA,2399,1690,709,670,125,545,0.322,0.279,0.176,2028,1664
"8451",199148,2006,1,0,"University of North Carolina at Greensboro",NA,NA,2400,1698,702,706,128,578,0.34,0.294,0.182,2308,1546
"8452",199148,2007,1,0,"University of North Carolina at Greensboro",NA,NA,2431,1689,742,721,166,555,0.329,0.297,0.224,2458,1532
"8453",199148,2008,1,0,"University of North Carolina at Greensboro",NA,NA,2471,1703,768,759,183,576,0.338,0.307,0.238,2507,1581
"8454",199148,2009,1,0,"University of North Carolina at Greensboro",NA,NA,2495,1733,762,804,180,624,0.36,0.322,0.236,2590,1553
"8455",199148,2010,1,0,"University of North Carolina at Greensboro",NA,NA,2505,1722,783,762,162,600,0.348,0.304,0.207,3243,1485
"8456",199157,1991,1,0,"NORTH CAROLINA CENTRAL UNIVERSITY",NA,NA,531,336,195,93,21,72,0.214,0.175,0.108,1169,7
"8457",199157,1992,1,0,"NORTH CAROLINA CENTRAL UNIVERSITY",NA,NA,759,452,307,134,30,104,0.23,0.177,0.098,1211,12
"8458",199157,1993,1,0,"NORTH CAROLINA CENTRAL UNIVERSITY",NA,NA,810,525,285,201,40,161,0.307,0.248,0.14,1338,5
"8459",199157,1995,1,0,"NORTH CAROLINA CENTRAL UNIVERSITY",NA,NA,510,309,201,139,34,105,0.34,0.273,0.169,1512,21
"8460",199157,1996,1,0,"NORTH CAROLINA CENTRAL UNIVERSITY",NA,NA,681,441,240,179,38,141,0.32,0.263,0.158,1595,11
"8461",199157,1997,1,0,"NORTH CAROLINA CENTRAL UNIVERSITY",NA,NA,712,467,245,202,45,157,0.336,0.284,0.184,1736,17
"8462",199157,1998,1,0,"NORTH CAROLINA CENTRAL UNIVERSITY",NA,NA,673,409,264,184,41,143,0.35,0.273,0.155,1793,17
"8463",199157,1999,1,0,"NORTH CAROLINA CENTRAL UNIVERSITY",NA,NA,625,345,280,143,31,112,0.325,0.229,0.111,962,9
"8464",199157,2000,1,0,"NORTH CAROLINA CENTRAL UNIVERSITY",NA,NA,720,443,277,162,26,136,0.307,0.225,0.094,982,12
"8465",199157,2001,1,0,"NORTH CAROLINA CENTRAL UNIVERSITY",NA,NA,763,492,271,174,29,145,0.295,0.228,0.107,1272,9
"8466",199157,2002,1,0,"NORTH CAROLINA CENTRAL UNIVERSITY",NA,NA,821,542,279,191,42,149,0.275,0.233,0.151,1574,15
"8467",199157,2003,1,0,"NORTH CAROLINA CENTRAL UNIVERSITY",NA,NA,1025,679,346,190,32,158,0.233,0.185,0.092,1653,13
"8468",199157,2004,1,0,"NORTH CAROLINA CENTRAL UNIVERSITY",NA,NA,1138,732,406,205,51,154,0.21,0.18,0.126,1878,18
"8469",199157,2005,1,0,"North Carolina Central University",NA,NA,1195,800,395,181,45,136,0.17,0.151,0.114,1878,20
"8470",199157,2006,1,0,"North Carolina Central University",NA,NA,975,631,344,145,30,115,0.182,0.149,0.087,2078,18
"8471",199157,2007,1,0,"North Carolina Central University",NA,NA,1236,764,472,185,47,138,0.181,0.15,0.1,2218,26
"8472",199157,2008,1,0,"North Carolina Central University",NA,NA,1026,683,343,224,56,168,0.246,0.218,0.163,2218,23
"8473",199157,2009,1,0,"North Carolina Central University",NA,NA,1345,858,487,215,49,166,0.194,0.16,0.101,2264,27
"8474",199157,2010,1,0,"North Carolina Central University",NA,NA,1218,809,409,238,56,182,0.225,0.195,0.137,2812,22
"8475",199193,1991,1,0,"NORTH CAROLINA STATE UNIVERSITY AT RALEIGH",NA,NA,3296,1290,2006,773,370,403,0.312,0.235,0.184,1238,2724
"8476",199193,1992,1,0,"NORTH CAROLINA STATE UNIVERSITY AT RALEIGH",NA,NA,3176,1219,1957,759,338,421,0.345,0.239,0.173,1286,2589
"8477",199193,1993,1,0,"NORTH CAROLINA STATE UNIVERSITY AT RALEIGH",NA,NA,3277,1248,2029,841,397,444,0.356,0.257,0.196,1389,2724
"8478",199193,1995,1,0,"NORTH CAROLINA STATE UNIVERSITY AT RALEIGH",NA,NA,3607,1523,2084,900,395,505,0.332,0.25,0.19,1732,2898
"8479",199193,1996,1,0,"NORTH CAROLINA STATE UNIVERSITY AT RALEIGH",NA,NA,3630,1457,2173,968,442,526,0.361,0.267,0.203,2200,2996
"8480",199193,1997,1,0,"NORTH CAROLINA STATE UNIVERSITY AT RALEIGH",NA,NA,3756,1496,2260,961,427,534,0.357,0.256,0.189,2270,3049
"8481",199193,1998,1,0,"NORTH CAROLINA STATE UNIVERSITY AT RALEIGH",NA,NA,3751,1513,2238,1075,492,583,0.385,0.287,0.22,2634,3044
"8482",199193,1999,1,0,"NORTH CAROLINA STATE UNIVERSITY AT RALEIGH",NA,NA,3636,1499,2137,1253,559,694,0.463,0.345,0.262,1528,3029
"8483",199193,2000,1,0,"NORTH CAROLINA STATE UNIVERSITY AT RALEIGH",NA,NA,3816,1622,2194,1379,634,745,0.459,0.361,0.289,1860,3082
"8484",199193,2001,1,0,"NORTH CAROLINA STATE UNIVERSITY AT RALEIGH",NA,NA,3862,1630,2232,1404,619,785,0.482,0.364,0.277,2328,3128
"8485",199193,2002,1,0,"NORTH CAROLINA STATE UNIVERSITY AT RALEIGH",NA,NA,3713,1561,2152,1391,580,811,0.52,0.375,0.27,2814,3032
"8486",199193,2003,1,0,"NORTH CAROLINA STATE UNIVERSITY AT RALEIGH",NA,NA,3915,1665,2250,1595,734,861,0.517,0.407,0.326,2955,3235
"8487",199193,2004,1,0,"NORTH CAROLINA STATE UNIVERSITY AT RALEIGH",NA,NA,3935,1702,2233,1585,682,903,0.531,0.403,0.305,3205,3154
"8488",199193,2005,1,0,"North Carolina State University at Raleigh",NA,NA,4364,1918,2446,1732,716,1016,0.53,0.397,0.293,3205,3513
"8489",199193,2006,1,0,"North Carolina State University at Raleigh",NA,NA,4667,2067,2600,1781,761,1020,0.494,0.382,0.293,3530,3719
"8490",199193,2007,1,0,"North Carolina State University at Raleigh",NA,NA,4895,2179,2716,1975,836,1139,0.523,0.403,0.308,3760,3908
"8491",199193,2008,1,0,"North Carolina State University at Raleigh",NA,NA,4792,2184,2608,2029,863,1166,0.534,0.423,0.331,3860,3770
"8492",199193,2009,1,0,"North Carolina State University at Raleigh",NA,NA,4716,2067,2649,2031,920,1111,0.537,0.431,0.347,3953,3589
"8493",199193,2010,1,0,"North Carolina State University at Raleigh",NA,NA,4685,2098,2587,2187,962,1225,0.584,0.467,0.372,4853,3592
"8494",199218,1991,1,0,"UNIVERSITY OF NORTH CAROLINA AT WILMINGTON",NA,NA,1545,923,622,385,111,274,0.297,0.249,0.178,1302,1444
"8495",199218,1992,1,0,"UNIVERSITY OF NORTH CAROLINA AT WILMINGTON",NA,NA,1225,771,454,320,95,225,0.292,0.261,0.209,1344,1104
"8496",199218,1993,1,0,"UNIVERSITY OF NORTH CAROLINA AT WILMINGTON",NA,NA,1439,860,579,417,131,286,0.333,0.29,0.226,1492,1296
"8497",199218,1995,1,0,"UNIVERSITY OF NORTH CAROLINA AT WILMINGTON",NA,NA,1370,863,507,463,133,330,0.382,0.338,0.262,1664,1253
"8498",199218,1996,1,0,"UNIVERSITY OF NORTH CAROLINA AT WILMINGTON",NA,NA,1619,990,629,602,196,406,0.41,0.372,0.312,1734,1472
"8499",199218,1997,1,0,"UNIVERSITY OF NORTH CAROLINA-WILMINGTON",NA,NA,1350,837,513,478,149,329,0.393,0.354,0.29,1782,1216
"8500",199218,1998,1,0,"UNIVERSITY OF NORTH CAROLINA-WILMINGTON",NA,NA,1681,1030,651,628,180,448,0.435,0.374,0.276,1934,1551
"8501",199218,1999,1,0,"UNIVERSITY OF NORTH CAROLINA-WILMINGTON",NA,NA,1649,1011,638,672,213,459,0.454,0.408,0.334,962,1522
"8502",199218,2000,1,0,"UNIVERSITY OF NORTH CAROLINA-WILMINGTON",NA,NA,1661,1081,580,711,185,526,0.487,0.428,0.319,1102,1524
"8503",199218,2001,1,0,"UNIVERSITY OF NORTH CAROLINA-WILMINGTON",NA,NA,1983,1246,737,824,205,619,0.497,0.416,0.278,1317,1823
"8504",199218,2002,1,0,"UNIVERSITY OF NORTH CAROLINA-WILMINGTON",NA,NA,1629,1014,615,733,209,524,0.517,0.45,0.34,1622,1489
"8505",199218,2003,1,0,"UNIVERSITY OF NORTH CAROLINA-WILMINGTON",NA,NA,1764,1133,631,783,227,556,0.491,0.444,0.36,1703,1557
"8506",199218,2004,1,0,"UNIVERSITY OF NORTH CAROLINA-WILMINGTON",NA,NA,1891,1154,737,841,272,569,0.493,0.445,0.369,1928,1668
"8507",199218,2005,1,0,"University of North Carolina-Wilmington",NA,NA,1933,1133,800,842,302,540,0.477,0.436,0.378,1928,1693
"8508",199218,2006,1,0,"University of North Carolina-Wilmington",NA,NA,1980,1140,840,973,335,638,0.56,0.491,0.399,2221,1652
"8509",199218,2007,1,0,"University of North Carolina-Wilmington",NA,NA,1913,1138,775,991,340,651,0.572,0.518,0.439,2413,1607
"8510",199218,2008,1,0,"University of North Carolina-Wilmington",NA,NA,2069,1229,840,1017,326,691,0.562,0.492,0.388,2459,1761
"8511",199218,2009,1,0,"University of North Carolina-Wilmington",NA,NA,1943,1178,765,975,314,661,0.561,0.502,0.41,2565,1607
"8512",199218,2010,1,0,"University of North Carolina at Wilmington",NA,NA,1985,1236,749,1044,320,724,0.586,0.526,0.427,3029,1655
"8513",199281,1991,1,0,"PEMBROKE STATE UNIVERSITY",NA,NA,379,195,184,58,21,37,0.19,0.153,0.114,914,229
"8514",199281,1992,1,0,"PEMBROKE STATE UNIVERSITY",NA,NA,417,199,218,68,26,42,0.211,0.163,0.119,948,251
"8515",199281,1993,1,0,"PEMBROKE STATE UNIVERSITY",NA,NA,422,216,206,71,19,52,0.241,0.168,0.092,1078,245
"8516",199281,1995,1,0,"UNIVERSITY OF NORTH CAROLINA-PEMBROKE",NA,NA,410,199,211,81,34,47,0.236,0.198,0.161,1325,230
"8517",199281,1996,1,0,"UNIVERSITY OF NORTH CAROLINA-PEMBROKE",NA,NA,450,211,239,80,30,50,0.237,0.178,0.126,1467,228
"8518",199281,1997,1,0,"UNIVERSITY OF NORTH CAROLINA-PEMBROKE",NA,NA,480,258,222,98,34,64,0.248,0.204,0.153,1536,272
"8519",199281,1998,1,0,"UNIVERSITY OF NORTH CAROLINA AT PEMBROKE",NA,NA,464,244,220,99,36,63,0.258,0.213,0.164,1600,241
"8520",199281,1999,1,0,"UNIVERSITY OF NORTH CAROLINA AT PEMBROKE",NA,NA,475,241,234,89,33,56,0.232,0.187,0.141,962,268
"8521",199281,2000,1,0,"UNIVERSITY OF NORTH CAROLINA AT PEMBROKE",NA,NA,567,303,264,114,34,80,0.264,0.201,0.129,982,307
"8522",199281,2001,1,0,"UNIVERSITY OF NORTH CAROLINA AT PEMBROKE",NA,NA,688,363,325,100,31,69,0.19,0.145,0.095,1152,378
"8523",199281,2002,1,0,"UNIVERSITY OF NORTH CAROLINA AT PEMBROKE",NA,NA,709,376,333,101,38,63,0.168,0.142,0.114,1394,413
"8524",199281,2003,1,0,"UNIVERSITY OF NORTH CAROLINA AT PEMBROKE",NA,NA,792,415,377,130,45,85,0.205,0.164,0.119,1464,459
"8525",199281,2004,1,0,"UNIVERSITY OF NORTH CAROLINA AT PEMBROKE",NA,NA,741,393,348,113,44,69,0.176,0.152,0.126,1689,358
"8526",199281,2005,1,0,"University of North Carolina at Pembroke",NA,NA,961,528,433,142,50,92,0.174,0.148,0.115,1689,437
"8527",199281,2006,1,0,"University of North Carolina at Pembroke",NA,NA,929,475,454,148,54,94,0.198,0.159,0.119,1869,414
"8528",199281,2007,1,0,"University of North Carolina at Pembroke",NA,NA,1101,585,516,170,57,113,0.193,0.154,0.11,1949,487
"8529",199281,2008,1,0,"University of North Carolina at Pembroke",NA,NA,1054,563,491,157,50,107,0.19,0.149,0.102,2007,448
"8530",199281,2009,1,0,"University of North Carolina at Pembroke",NA,NA,1202,642,560,218,77,141,0.22,0.181,0.138,2060,454
"8531",199281,2010,1,0,"University of North Carolina at Pembroke",NA,NA,1036,582,454,209,74,135,0.232,0.202,0.163,2423,410
"8532",199306,1991,1,0,"PFEIFFER COLLEGE",NA,NA,166,82,84,45,17,28,0.341,0.271,0.202,7295,149
"8533",199306,1992,1,0,"PFEIFFER COLLEGE",NA,NA,147,66,81,45,18,27,0.409,0.306,0.222,7730,130
"8534",199306,1993,1,0,"PFEIFFER COLLEGE",NA,NA,156,70,86,40,14,26,0.371,0.256,0.163,8190,126
"8535",199306,1995,1,0,"PFEIFFER UNIVERSITY",NA,NA,146,66,80,31,10,21,0.318,0.212,0.125,8990,121
"8536",199306,1996,1,0,"PFEIFFER UNIVERSITY",NA,NA,120,54,66,26,12,14,0.259,0.217,0.182,9260,99
"8537",199306,1997,1,0,"PFEIFFER UNIVERSITY",NA,NA,162,59,103,40,21,19,0.322,0.247,0.204,9816,129
"8538",199306,1998,1,0,"PFEIFFER UNIVERSITY",NA,NA,148,67,81,45,17,28,0.418,0.304,0.21,10230,122
"8539",199306,1999,1,0,"PFEIFFER UNIVERSITY",NA,NA,159,80,79,52,15,37,0.462,0.327,0.19,10844,126
"8540",199306,2000,1,0,"PFEIFFER UNIVERSITY",NA,NA,185,90,95,58,17,41,0.456,0.314,0.179,11380,154
"8541",199306,2001,1,0,"PFEIFFER UNIVERSITY",NA,NA,146,69,77,63,26,37,0.536,0.432,0.338,12066,120
"8542",199306,2002,1,0,"PFEIFFER UNIVERSITY",NA,NA,166,97,69,71,29,42,0.433,0.428,0.42,12780,138
"8543",199306,2003,1,0,"PFEIFFER UNIVERSITY",NA,NA,158,86,72,56,20,36,0.419,0.354,0.278,13550,130
"8544",199306,2004,1,0,"PFEIFFER UNIVERSITY",NA,NA,191,88,103,54,17,37,0.42,0.283,0.165,14570,153
"8545",199306,2005,1,0,"Pfeiffer University",NA,NA,198,90,108,74,28,46,0.511,0.374,0.259,15590,147
"8546",199306,2006,1,0,"Pfeiffer University",NA,NA,196,85,111,72,38,34,0.4,0.367,0.342,16450,145
"8547",199306,2007,1,0,"Pfeiffer University",NA,NA,189,90,99,63,28,35,0.389,0.333,0.283,17520,154
"8548",199306,2008,1,0,"Pfeiffer University",NA,NA,192,91,101,48,15,33,0.363,0.25,0.149,18570,133
"8549",199306,2009,1,0,"Pfeiffer University",NA,NA,225,100,125,71,34,37,0.37,0.316,0.272,19040,172
"8550",199306,2010,1,0,"Pfeiffer University",NA,NA,199,88,111,67,31,36,0.409,0.337,0.279,20182,127
"8551",199412,1991,1,0,"QUEENS COLLEGE",NA,NA,144,102,42,47,9,38,0.372,0.326,0.214,9300,117
"8552",199412,1992,1,0,"QUEENS COLLEGE",NA,NA,127,95,32,45,8,37,0.39,0.354,0.25,9850,102
"8553",199412,1993,1,0,"QUEENS COLLEGE",NA,NA,169,134,35,60,13,47,0.351,0.355,0.371,10400,139
"8554",199412,1995,1,0,"QUEENS COLLEGE",NA,NA,146,110,36,72,19,53,0.482,0.493,0.528,11520,113
"8555",199412,1996,1,0,"QUEENS COLLEGE",NA,NA,155,116,39,80,14,66,0.569,0.516,0.359,12310,117
"8556",199412,1997,1,0,"QUEENS COLLEGE",NA,NA,198,142,56,80,20,60,0.422,0.404,0.357,12980,148
"8557",199412,1998,1,0,"QUEENS COLLEGE",NA,NA,147,111,36,67,15,52,0.469,0.456,0.417,9410,114
"8558",199412,1999,1,0,"QUEENS COLLEGE",NA,NA,123,85,38,67,15,52,0.612,0.545,0.395,10020,89
"8559",199412,2000,1,0,"QUEENS COLLEGE",NA,NA,188,136,52,93,23,70,0.515,0.495,0.442,10680,150
"8560",199412,2001,1,0,"QUEENS COLLEGE",NA,NA,209,166,43,105,23,82,0.494,0.502,0.535,11360,165
"8561",199412,2002,1,0,"QUEENS UNIVERSITY OF CHARLOTTE",NA,NA,193,150,43,111,24,87,0.58,0.575,0.558,12290,168
"8562",199412,2003,1,0,"QUEENS UNIVERSITY OF CHARLOTTE",NA,NA,252,186,66,127,34,93,0.5,0.504,0.515,15650,216
"8563",199412,2004,1,0,"QUEENS UNIVERSITY OF CHARLOTTE",NA,NA,223,154,69,98,28,70,0.454,0.439,0.406,17008,183
"8564",199412,2005,1,0,"Queens University of Charlotte",NA,NA,238,171,67,116,30,86,0.503,0.487,0.448,18028,189
"8565",199412,2006,1,0,"Queens University of Charlotte",NA,NA,235,173,62,104,22,82,0.474,0.443,0.355,19450,148
"8566",199412,2007,1,0,"Queens University of Charlotte",NA,NA,290,198,92,126,32,94,0.475,0.434,0.348,20720,202
"8567",199412,2008,1,0,"Queens University of Charlotte",NA,NA,307,214,93,164,49,115,0.537,0.534,0.527,22068,190
"8568",199412,2009,1,0,"Queens University of Charlotte",NA,NA,311,232,79,144,31,113,0.487,0.463,0.392,22730,177
"8569",199412,2010,1,0,"Queens University of Charlotte",NA,NA,349,252,97,162,38,124,0.492,0.464,0.392,23752,205
"8570",199582,1991,1,0,"SAINT AUGUSTINE'S COLLEGE",NA,NA,418,237,181,44,10,34,0.144,0.105,0.055,4950,1
"8571",199582,1992,1,0,"SAINT AUGUSTINE'S COLLEGE",NA,NA,401,232,169,61,14,47,0.203,0.152,0.083,5300,0
"8572",199582,1993,1,0,"SAINT AUGUSTINES COLLEGE",NA,NA,361,196,165,49,12,37,0.189,0.136,0.073,5700,1
"8573",199582,1995,1,0,"SAINT AUGUSTINES COLLEGE",NA,NA,385,203,182,61,17,44,0.217,0.158,0.093,5872,0
"8574",199582,1996,1,0,"SAINT AUGUSTINES COLLEGE",NA,NA,408,228,180,46,21,25,0.11,0.113,0.117,6284,0
"8575",199582,1997,1,0,"SAINT AUGUSTINES COLLEGE",NA,NA,400,228,172,60,14,46,0.202,0.15,0.081,6472,1
"8576",199582,1998,1,0,"SAINT AUGUSTINES COLLEGE",NA,NA,299,164,135,57,13,44,0.268,0.191,0.096,6796,1
"8577",199582,1999,1,0,"SAINT AUGUSTINES COLLEGE",NA,NA,331,173,158,57,16,41,0.237,0.172,0.101,5132,0
"8578",199582,2000,1,0,"SAINT AUGUSTINES COLLEGE",NA,NA,398,232,166,67,17,50,0.216,0.168,0.102,5650,1
"8579",199582,2001,1,0,"SAINT AUGUSTINES COLLEGE",NA,NA,324,172,152,52,16,36,0.209,0.16,0.105,5780,0
"8580",199582,2002,1,0,"SAINT AUGUSTINES COLLEGE",NA,NA,449,183,266,25,13,12,0.066,0.056,0.049,6030,0
"8581",199582,2003,1,0,"SAINT AUGUSTINES COLLEGE",NA,NA,542,238,304,46,15,31,0.13,0.085,0.049,7398,3
"8582",199582,2004,1,0,"SAINT AUGUSTINES COLLEGE",NA,NA,324,140,184,45,15,30,0.214,0.139,0.082,8138,3
"8583",199582,2005,1,0,"Saint Augustines College",NA,NA,261,129,132,34,16,18,0.139,0.13,0.121,8952,0
"8584",199582,2006,1,0,"Saint Augustines College",NA,NA,363,146,217,58,23,35,0.24,0.16,0.106,9980,2
"8585",199582,2007,1,0,"Saint Augustines College",NA,NA,417,188,229,91,31,60,0.319,0.218,0.135,10580,4
"8586",199582,2008,1,0,"Saint Augustines College",NA,NA,484,233,251,87,33,54,0.232,0.18,0.131,10580,3
"8587",199582,2009,1,0,"Saint Augustines College",NA,NA,424,206,218,91,35,56,0.272,0.215,0.161,12004,13
"8588",199582,2010,1,0,"Saint Augustines College",NA,NA,440,196,244,78,25,53,0.27,0.177,0.102,12364,3
"8589",199643,1991,1,0,"SHAW UNIVERSITY",NA,NA,579,330,249,190,82,108,0.327,0.328,0.329,4894,22
"8590",199643,1992,1,0,"SHAW UNIVERSITY",NA,NA,740,428,312,124,33,91,0.213,0.168,0.106,5272,17
"8591",199643,1993,1,0,"SHAW UNIVERSITY",NA,NA,601,336,265,140,43,97,0.289,0.233,0.162,5562,7
"8592",199643,1995,1,0,"SHAW UNIVERSITY",NA,NA,518,305,213,127,29,98,0.321,0.245,0.136,5946,14
"8593",199643,1996,1,0,"SHAW UNIVERSITY",NA,NA,374,232,142,67,17,50,0.216,0.179,0.12,5946,5
"8594",199643,1997,1,0,"SHAW UNIVERSITY",NA,NA,304,173,131,43,12,31,0.179,0.141,0.092,6304,5
"8595",199643,1998,1,0,"SHAW UNIVERSITY",NA,NA,382,220,162,73,20,53,0.241,0.191,0.123,6494,8
"8596",199643,1999,1,0,"SHAW UNIVERSITY",NA,NA,440,258,182,61,21,40,0.155,0.139,0.115,6272,3
"8597",199643,2000,1,0,"SHAW UNIVERSITY",NA,NA,401,247,154,43,13,30,0.122,0.107,0.084,6712,7
"8598",199643,2001,1,0,"SHAW UNIVERSITY",NA,NA,445,283,162,83,18,65,0.23,0.187,0.111,7056,13
"8599",199643,2002,1,0,"SHAW UNIVERSITY",NA,NA,526,240,286,67,26,41,0.171,0.127,0.091,7560,11
"8600",199643,2003,1,0,"SHAW UNIVERSITY",NA,NA,469,249,220,79,31,48,0.193,0.168,0.141,7800,6
"8601",199643,2004,1,0,"SHAW UNIVERSITY",NA,NA,417,227,190,61,16,45,0.198,0.146,0.084,7800,9
"8602",199643,2005,1,0,"Shaw University",NA,NA,573,307,266,75,29,46,0.15,0.131,0.109,7800,5
"8603",199643,2006,1,0,"Shaw University",NA,NA,674,423,251,82,23,59,0.139,0.122,0.092,8280,10
"8604",199643,2007,1,0,"Shaw University",NA,NA,565,321,244,89,35,54,0.168,0.158,0.143,8800,11
"8605",199643,2008,1,0,"Shaw University",NA,NA,532,308,224,64,21,43,0.14,0.12,0.094,9336,9
"8606",199643,2009,1,0,"Shaw University",NA,NA,581,334,247,74,24,50,0.15,0.127,0.097,9336,11
"8607",199643,2010,1,0,"Shaw University",NA,NA,679,360,319,54,23,31,0.086,0.08,0.072,9840,9
"8608",199847,1991,1,0,"WAKE FOREST UNIVERSITY",NA,NA,857,425,432,659,299,360,0.847,0.769,0.692,10800,753
"8609",199847,1992,1,0,"WAKE FOREST UNIVERSITY",NA,NA,909,445,464,639,300,339,0.762,0.703,0.647,12000,805
"8610",199847,1993,1,0,"WAKE FOREST UNIVERSITY",NA,NA,904,443,461,676,314,362,0.817,0.748,0.681,13000,793
"8611",199847,1995,1,0,"WAKE FOREST UNIVERSITY",NA,NA,962,458,504,720,357,363,0.793,0.748,0.708,14750,841
"8612",199847,1996,1,0,"WAKE FOREST UNIVERSITY",NA,NA,934,500,434,707,297,410,0.82,0.757,0.684,18500,802
"8613",199847,1997,1,0,"WAKE FOREST UNIVERSITY",NA,NA,962,483,479,739,338,401,0.83,0.768,0.706,19450,849
"8614",199847,1998,1,0,"WAKE FOREST UNIVERSITY",NA,NA,993,505,488,746,334,412,0.816,0.751,0.684,20450,875
"8615",199847,1999,1,0,"WAKE FOREST UNIVERSITY",NA,NA,969,498,471,760,327,433,0.87,0.784,0.694,21420,865
"8616",199847,2000,1,0,"WAKE FOREST UNIVERSITY",NA,NA,1020,530,490,804,355,449,0.847,0.788,0.724,22410,886
"8617",199847,2001,1,0,"WAKE FOREST UNIVERSITY",NA,NA,960,481,479,756,343,413,0.859,0.787,0.716,23530,846
"8618",199847,2002,1,0,"WAKE FOREST UNIVERSITY",NA,NA,999,509,490,832,393,439,0.863,0.833,0.802,24750,847
"8619",199847,2003,1,0,"WAKE FOREST UNIVERSITY",NA,NA,984,507,477,834,386,448,0.884,0.848,0.809,26490,850
"8620",199847,2004,1,0,"WAKE FOREST UNIVERSITY",NA,NA,1109,552,557,921,438,483,0.875,0.83,0.786,28210,946
"8621",199847,2005,1,0,"Wake Forest University",NA,NA,1114,565,549,918,431,487,0.862,0.824,0.785,30110,916
"8622",199847,2006,1,0,"Wake Forest University",NA,NA,1119,576,543,927,432,495,0.859,0.828,0.796,32040,927
"8623",199847,2007,1,0,"Wake Forest University",NA,NA,1123,573,550,919,433,486,0.848,0.818,0.787,34230,936
"8624",199847,2008,1,0,"Wake Forest University",NA,NA,1197,621,576,991,455,536,0.863,0.828,0.79,36560,969
"8625",199847,2009,1,0,"Wake Forest University",NA,NA,1193,628,565,983,445,538,0.857,0.824,0.788,38206,914
"8626",199847,2010,1,0,"Wake Forest University",NA,NA,1217,639,578,1019,462,557,0.872,0.837,0.799,39544,941
"8627",199962,1991,1,0,"WINGATE COLLEGE",NA,NA,371,181,190,93,28,65,0.359,0.251,0.147,6120,321
"8628",199962,1992,1,0,"WINGATE COLLEGE",NA,NA,365,179,186,84,36,48,0.268,0.23,0.194,6740,307
"8629",199962,1993,1,0,"WINGATE COLLEGE",NA,NA,376,171,205,78,31,47,0.275,0.207,0.151,7410,314
"8630",199962,1995,1,0,"WINGATE UNIVERSITY",NA,NA,334,157,177,113,45,68,0.433,0.338,0.254,8760,289
"8631",199962,1996,1,0,"WINGATE UNIVERSITY",NA,NA,331,137,194,101,43,58,0.423,0.305,0.222,11090,289
"8632",199962,1997,1,0,"WINGATE UNIVERSITY",NA,NA,296,123,173,103,43,60,0.488,0.348,0.249,11730,255
"8633",199962,1998,1,0,"WINGATE UNIVERSITY",NA,NA,273,127,146,89,34,55,0.433,0.326,0.233,12150,245
"8634",199962,1999,1,0,"WINGATE UNIVERSITY",NA,NA,301,144,157,102,32,70,0.486,0.339,0.204,11950,242
"8635",199962,2000,1,0,"WINGATE UNIVERSITY",NA,NA,380,181,199,142,54,88,0.486,0.374,0.271,12300,303
"8636",199962,2001,1,0,"WINGATE UNIVERSITY",NA,NA,393,209,184,147,44,103,0.493,0.374,0.239,12900,334
"8637",199962,2002,1,0,"WINGATE UNIVERSITY",NA,NA,374,197,177,167,62,105,0.533,0.447,0.35,13550,314
"8638",199962,2003,1,0,"WINGATE UNIVERSITY",NA,NA,372,198,174,160,55,105,0.53,0.43,0.316,14200,314
"8639",199962,2004,1,0,"WINGATE UNIVERSITY",NA,NA,358,174,184,155,66,89,0.511,0.433,0.359,15000,296
"8640",199962,2005,1,0,"Wingate University",NA,NA,371,183,188,154,54,100,0.546,0.415,0.287,15800,319
"8641",199962,2006,1,0,"Wingate University",NA,NA,385,198,187,152,57,95,0.48,0.395,0.305,16600,294
"8642",199962,2007,1,0,"Wingate University",NA,NA,426,209,217,200,87,113,0.541,0.469,0.401,17430,318
"8643",199962,2008,1,0,"Wingate University",NA,NA,431,223,208,183,79,104,0.466,0.425,0.38,18300,291
"8644",199962,2009,1,0,"Wingate University",NA,NA,375,195,180,150,59,91,0.467,0.4,0.328,18990,243
"8645",199962,2010,1,0,"Wingate University",NA,NA,605,336,269,267,95,172,0.512,0.441,0.353,19990,366
"8646",199999,1991,1,0,"WINSTON-SALEM STATE UNIVERSITY",NA,NA,431,287,144,59,7,52,0.181,0.137,0.049,1060,16
"8647",199999,1992,1,0,"WINSTON-SALEM STATE UNIVERSITY",NA,NA,391,267,124,83,20,63,0.236,0.212,0.161,1094,14
"8648",199999,1993,1,0,"WINSTON-SALEM STATE UNIVERSITY",NA,NA,369,225,144,79,26,53,0.236,0.214,0.181,1172,19
"8649",199999,1995,1,0,"WINSTON-SALEM STATE UNIVERSITY",NA,NA,446,298,148,121,32,89,0.299,0.271,0.216,1351,27
"8650",199999,1996,1,0,"WINSTON-SALEM STATE UNIVERSITY",NA,NA,480,351,129,95,19,76,0.216,0.198,0.147,1414,35
"8651",199999,1997,1,0,"WINSTON-SALEM STATE UNIVERSITY",NA,NA,485,329,156,117,27,90,0.274,0.241,0.173,1504,23
"8652",199999,1998,1,0,"WINSTON SALEM STATE UNIVERSITY",NA,NA,524,364,160,114,23,91,0.25,0.218,0.144,1561,19
"8653",199999,1999,1,0,"WINSTON-SALEM STATE UNIVERSITY",NA,NA,476,316,160,103,19,84,0.266,0.216,0.119,806,12
"8654",199999,2000,1,0,"WINSTON-SALEM STATE UNIVERSITY",NA,NA,499,359,140,97,19,78,0.217,0.194,0.136,822,21
"8655",199999,2001,1,0,"WINSTON-SALEM STATE UNIVERSITY",NA,NA,614,424,190,124,17,107,0.252,0.202,0.089,896,15
"8656",199999,2002,1,0,"WINSTON-SALEM STATE UNIVERSITY",NA,NA,670,471,199,121,28,93,0.198,0.181,0.141,1168,25
"8657",199999,2003,1,0,"WINSTON-SALEM STATE UNIVERSITY",NA,NA,883,580,303,124,25,99,0.171,0.14,0.083,1226,17
"8658",199999,2004,1,0,"WINSTON-SALEM STATE UNIVERSITY",NA,NA,891,619,272,117,35,82,0.132,0.131,0.129,1451,29
"8659",199999,2005,1,0,"Winston-Salem State University",NA,NA,1050,701,349,167,42,125,0.178,0.159,0.12,1451,37
"8660",199999,2006,1,0,"Winston-Salem State University",NA,NA,976,692,284,144,36,108,0.156,0.148,0.127,1651,24
"8661",199999,2007,1,0,"Winston-Salem State University",NA,NA,962,661,301,171,40,131,0.198,0.178,0.133,1701,34
"8662",199999,2008,1,0,"Winston-Salem State University",NA,NA,1353,886,467,234,62,172,0.194,0.173,0.133,1701,27
"8663",199999,2009,1,0,"Winston-Salem State University",NA,NA,794,540,254,135,39,96,0.178,0.17,0.154,1769,21
"8664",199999,2010,1,0,"Winston-Salem State University",NA,NA,690,465,225,139,25,114,0.245,0.201,0.111,2274,32
"8665",200004,1991,1,0,"WESTERN CAROLINA UNIVERSITY",NA,NA,1011,522,489,210,84,126,0.241,0.208,0.172,1229,933
"8666",200004,1992,1,0,"WESTERN CAROLINA UNIVERSITY",NA,NA,1065,543,522,208,76,132,0.243,0.195,0.146,1271,998
"8667",200004,1993,1,0,"WESTERN CAROLINA UNIVERSITY",NA,NA,1051,509,542,226,91,135,0.265,0.215,0.168,1391,968
"8668",200004,1995,1,0,"WESTERN CAROLINA UNIVERSITY",NA,NA,1156,608,548,259,78,181,0.298,0.224,0.142,1589,1062
"8669",200004,1996,1,0,"WESTERN CAROLINA UNIVERSITY",NA,NA,1177,560,617,260,87,173,0.309,0.221,0.141,1663,1090
"8670",200004,1997,1,0,"WESTERN CAROLINA UNIVERSITY",NA,NA,1224,629,595,310,100,210,0.334,0.253,0.168,1723,1119
"8671",200004,1998,1,0,"WESTERN CAROLINA UNIVERSITY",NA,NA,1098,544,554,249,80,169,0.311,0.227,0.144,1793,1004
"8672",200004,1999,1,0,"WESTERN CAROLINA UNIVERSITY",NA,NA,1151,569,582,261,103,158,0.278,0.227,0.177,962,1043
"8673",200004,2000,1,0,"WESTERN CAROLINA UNIVERSITY",NA,NA,1211,594,617,298,120,178,0.3,0.246,0.194,982,1075
"8674",200004,2001,1,0,"WESTERN CAROLINA UNIVERSITY",NA,NA,1176,530,646,266,108,158,0.298,0.226,0.167,1072,1057
"8675",200004,2002,1,0,"WESTERN CAROLINA UNIVERSITY",NA,NA,1216,627,589,344,127,217,0.346,0.283,0.216,1358,1074
"8676",200004,2003,1,0,"WESTERN CAROLINA UNIVERSITY",NA,NA,1485,739,746,394,138,256,0.346,0.265,0.185,1426,1346
"8677",200004,2004,1,0,"WESTERN CAROLINA UNIVERSITY",NA,NA,1571,805,766,447,154,293,0.364,0.285,0.201,1651,1400
"8678",200004,2005,1,0,"Western Carolina University",NA,NA,1549,775,774,453,181,272,0.351,0.292,0.234,1651,1354
"8679",200004,2006,1,0,"Western Carolina University",NA,NA,1558,784,774,434,163,271,0.346,0.279,0.211,1904,1341
"8680",200004,2007,1,0,"Western Carolina University",NA,NA,1249,651,598,400,142,258,0.396,0.32,0.237,2028,1038
"8681",200004,2008,1,0,"Western Carolina University",NA,NA,1218,617,601,485,198,287,0.465,0.398,0.329,2078,1036
"8682",200004,2009,1,0,"Western Carolina University",NA,NA,1547,848,699,568,211,357,0.421,0.367,0.302,2106,1253
"8683",200004,2010,1,0,"Western Carolina University",NA,NA,1415,746,669,520,196,324,0.434,0.367,0.293,2816,1176
"8684",200059,1991,1,0,"DICKINSON STATE UNIVERSITY",NA,NA,315,165,150,30,12,18,0.109,0.095,0.08,1706,306
"8685",200059,1992,1,0,"DICKINSON STATE UNIVERSITY",NA,NA,336,191,145,32,9,23,0.12,0.095,0.062,1706,328
"8686",200059,1993,1,0,"DICKINSON STATE UNIVERSITY",NA,NA,300,148,152,22,5,17,0.115,0.073,0.033,1782,289
"8687",200059,1995,1,0,"DICKINSON STATE UNIVERSITY",NA,NA,296,140,156,27,10,17,0.121,0.091,0.064,1856,279
"8688",200059,1996,1,0,"DICKINSON STATE UNIVERSITY",NA,NA,397,193,204,24,9,15,0.078,0.06,0.044,1970,375
"8689",200059,1997,1,0,"DICKINSON STATE UNIVERSITY",NA,NA,408,233,175,39,15,24,0.103,0.096,0.086,2096,391
"8690",200059,1998,1,0,"DICKINSON STATE UNIVERSITY",NA,NA,363,204,159,26,4,22,0.108,0.072,0.025,2196,349
"8691",200059,1999,1,0,"DICKINSON STATE UNIVERSITY",NA,NA,359,179,180,39,15,24,0.134,0.109,0.083,1906,346
"8692",200059,2000,1,0,"DICKINSON STATE UNIVERSITY",NA,NA,350,208,142,34,14,20,0.096,0.097,0.099,1982,329
"8693",200059,2001,1,0,"DICKINSON STATE UNIVERSITY",NA,NA,375,188,187,39,8,31,0.165,0.104,0.043,2067,341
"8694",200059,2002,1,0,"DICKINSON STATE UNIVERSITY",NA,NA,368,193,175,32,8,24,0.124,0.087,0.046,2202,327
"8695",200059,2003,1,0,"DICKINSON STATE UNIVERSITY",NA,NA,383,201,182,42,14,28,0.139,0.11,0.077,2554,335
"8696",200059,2004,1,0,"DICKINSON STATE UNIVERSITY",NA,NA,332,170,162,37,15,22,0.129,0.111,0.093,3040,286
"8697",200059,2005,1,0,"Dickinson State University",NA,NA,317,162,155,29,11,18,0.111,0.091,0.071,3329,263
"8698",200059,2006,1,0,"Dickinson State University",NA,NA,333,160,173,50,22,28,0.175,0.15,0.127,3645,240
"8699",200059,2007,1,0,"Dickinson State University",NA,NA,355,191,164,48,19,29,0.152,0.135,0.116,3828,270
"8700",200059,2008,1,0,"Dickinson State University",NA,NA,320,142,178,34,16,18,0.127,0.106,0.09,4019,228
"8701",200059,2009,1,0,"Dickinson State University",NA,NA,307,177,130,43,13,30,0.169,0.14,0.1,4160,211
"8702",200059,2010,1,0,"Dickinson State University",NA,NA,307,146,161,33,14,19,0.13,0.107,0.087,4304,226
"8703",200156,1991,1,0,"JAMESTOWN COLLEGE",NA,NA,288,134,154,68,21,47,0.351,0.236,0.136,6670,256
"8704",200156,1992,1,0,"JAMESTOWN COLLEGE",NA,NA,292,140,152,86,27,59,0.421,0.295,0.178,6920,263
"8705",200156,1993,1,0,"JAMESTOWN COLLEGE",NA,NA,262,121,141,62,27,35,0.289,0.237,0.191,7270,244
"8706",200156,1995,1,0,"JAMESTOWN COLLEGE",NA,NA,289,144,145,89,32,57,0.396,0.308,0.221,7970,282
"8707",200156,1996,1,0,"JAMESTOWN COLLEGE",NA,NA,288,159,129,90,25,65,0.409,0.312,0.194,8420,269
"8708",200156,1997,1,0,"JAMESTOWN COLLEGE",NA,NA,232,134,98,100,36,64,0.478,0.431,0.367,8770,220
"8709",200156,1998,1,0,"JAMESTOWN COLLEGE",NA,NA,278,150,128,99,39,60,0.4,0.356,0.305,6770,261
"8710",200156,1999,1,0,"JAMESTOWN COLLEGE",NA,NA,284,165,119,84,31,53,0.321,0.296,0.261,7150,269
"8711",200156,2000,1,0,"JAMESTOWN COLLEGE",NA,NA,331,192,139,107,35,72,0.375,0.323,0.252,7550,304
"8712",200156,2001,1,0,"JAMESTOWN COLLEGE",NA,NA,293,173,120,96,35,61,0.353,0.328,0.292,7925,274
"8713",200156,2002,1,0,"JAMESTOWN COLLEGE",NA,NA,332,176,156,98,29,69,0.392,0.295,0.186,8350,302
"8714",200156,2003,1,0,"JAMESTOWN COLLEGE",NA,NA,261,142,119,82,27,55,0.387,0.314,0.227,8750,232
"8715",200156,2004,1,0,"JAMESTOWN COLLEGE",NA,NA,229,135,94,63,33,30,0.222,0.275,0.351,9400,210
"8716",200156,2005,1,0,"Jamestown College",NA,NA,270,139,131,67,24,43,0.309,0.248,0.183,10000,249
"8717",200156,2006,1,0,"Jamestown College",NA,NA,238,129,109,75,21,54,0.419,0.315,0.193,10550,223
"8718",200156,2007,1,0,"Jamestown College",NA,NA,264,140,124,88,26,62,0.443,0.333,0.21,11235,239
"8719",200156,2008,1,0,"Jamestown College",NA,NA,267,123,144,74,27,47,0.382,0.277,0.188,12748,234
"8720",200156,2009,1,0,"Jamestown College",NA,NA,233,116,117,49,17,32,0.276,0.21,0.145,14432,208
"8721",200156,2010,1,0,"Jamestown College",NA,NA,202,98,104,72,27,45,0.459,0.356,0.26,15680,161
"8722",200217,1991,1,0,"UNIVERSITY OF MARY",NA,NA,317,179,138,96,33,63,0.352,0.303,0.239,5550,294
"8723",200217,1992,1,0,"UNIVERSITY OF MARY",NA,NA,343,205,138,104,30,74,0.361,0.303,0.217,5900,312
"8724",200217,1993,1,0,"UNIVERSITY OF MARY",NA,NA,350,224,126,91,20,71,0.317,0.26,0.159,6260,326
"8725",200217,1995,1,0,"UNIVERSITY OF MARY",NA,NA,412,234,178,115,32,83,0.355,0.279,0.18,6950,388
"8726",200217,1996,1,0,"UNIVERSITY OF MARY",NA,NA,440,266,174,117,36,81,0.304,0.266,0.207,7330,408
"8727",200217,1997,1,0,"UNIVERSITY OF MARY",NA,NA,381,242,139,131,32,99,0.409,0.344,0.23,7590,366
"8728",200217,1998,1,0,"UNIVERSITY OF MARY",NA,NA,404,244,160,149,39,110,0.451,0.369,0.244,8080,385
"8729",200217,1999,1,0,"UNIVERSITY OF MARY",NA,NA,373,242,131,155,42,113,0.467,0.416,0.321,8200,359
"8730",200217,2000,1,0,"UNIVERSITY OF MARY",NA,NA,351,201,150,142,37,105,0.522,0.405,0.247,8500,335
"8731",200217,2001,1,0,"UNIVERSITY OF MARY",NA,NA,372,213,159,143,43,100,0.47,0.384,0.27,8800,348
"8732",200217,2002,1,0,"UNIVERSITY OF MARY",NA,NA,402,240,162,168,44,124,0.517,0.418,0.272,9200,381
"8733",200217,2003,1,0,"UNIVERSITY OF MARY",NA,NA,390,226,164,147,36,111,0.491,0.377,0.22,9600,353
"8734",200217,2004,1,0,"UNIVERSITY OF MARY",NA,NA,430,251,179,156,46,110,0.438,0.363,0.257,9990,400
"8735",200217,2005,1,0,"University of Mary",NA,NA,392,220,172,103,28,75,0.341,0.263,0.163,10600,358
"8736",200217,2006,1,0,"University of Mary",NA,NA,343,187,156,19,10,9,0.048,0.055,0.064,11100,316
"8737",200217,2007,1,0,"University of Mary",NA,NA,352,206,146,99,20,79,0.384,0.281,0.137,11530,302
"8738",200217,2008,1,0,"University of Mary",NA,NA,373,227,146,108,25,83,0.366,0.29,0.171,11940,339
"8739",200217,2009,1,0,"University of Mary",NA,NA,311,192,119,122,32,90,0.469,0.392,0.269,12360,280
"8740",200217,2010,1,0,"University of Mary",NA,NA,362,203,159,138,38,100,0.493,0.381,0.239,12800,307
"8741",200226,1991,0,1,"MAYVILLE STATE UNIVERSITY",1992,0,162,83,79,21,3,18,0.217,0.13,0.038,2133,150
"8742",200226,1992,1,0,"MAYVILLE STATE UNIVERSITY",1992,1,165,86,79,15,5,10,0.116,0.091,0.063,2755,143
"8743",200226,1993,1,0,"MAYVILLE STATE UNIVERSITY",1992,1,146,61,85,17,4,13,0.213,0.116,0.047,1831,122
"8744",200226,1995,1,0,"MAYVILLE STATE UNIVERSITY",1992,1,193,80,113,25,10,15,0.188,0.13,0.088,2340,172
"8745",200226,1996,1,0,"MAYVILLE STATE UNIVERSITY",1992,1,148,79,69,22,7,15,0.19,0.149,0.101,2016,141
"8746",200226,1997,1,0,"MAYVILLE STATE UNIVERSITY",1992,1,129,73,56,20,6,14,0.192,0.155,0.107,2946,112
"8747",200226,1998,1,0,"MAYVILLE STATE UNIVERSITY",1992,1,153,56,97,32,16,16,0.286,0.209,0.165,3032,132
"8748",200226,1999,1,0,"MAYVILLE STATE UNIVERSITY",1992,1,140,71,69,41,15,26,0.366,0.293,0.217,1906,130
"8749",200226,2000,1,0,"MAYVILLE STATE UNIVERSITY",1992,1,153,73,80,22,6,16,0.219,0.144,0.075,1982,145
"8750",200226,2001,1,0,"MAYVILLE STATE UNIVERSITY",1992,1,133,62,71,18,6,12,0.194,0.135,0.085,2067,127
"8751",200226,2002,1,0,"MAYVILLE STATE UNIVERSITY",1992,1,135,79,56,32,4,28,0.354,0.237,0.071,2202,125
"8752",200226,2003,1,0,"MAYVILLE STATE UNIVERSITY",1992,1,135,70,65,26,9,17,0.243,0.193,0.138,2576,113
"8753",200226,2004,1,0,"MAYVILLE STATE UNIVERSITY",1992,1,162,72,90,25,5,20,0.278,0.154,0.056,3014,128
"8754",200226,2005,1,0,"Mayville State University",1992,1,144,63,81,28,10,18,0.286,0.194,0.123,3300,121
"8755",200226,2006,1,0,"Mayville State University",1992,1,137,59,78,29,7,22,0.373,0.212,0.09,3614,116
"8756",200226,2007,1,0,"Mayville State University",1992,1,89,42,47,18,5,13,0.31,0.202,0.106,3795,76
"8757",200226,2008,1,0,"Mayville State University",1992,1,89,52,37,17,5,12,0.231,0.191,0.135,3985,71
"8758",200226,2009,1,0,"Mayville State University",1992,1,147,57,90,17,7,10,0.175,0.116,0.078,4124,98
"8759",200226,2010,1,0,"Mayville State University",1992,1,130,54,76,17,10,7,0.13,0.131,0.132,4268,99
"8760",200253,1991,0,1,"MINOT STATE UNIVERSITY",1992,0,546,363,183,52,14,38,0.105,0.095,0.077,1701,457
"8761",200253,1992,1,0,"MINOT STATE UNIVERSITY",1992,1,624,398,226,30,6,24,0.06,0.048,0.027,1710,483
"8762",200253,1993,1,0,"MINOT STATE UNIVERSITY",1992,1,579,346,233,48,13,35,0.101,0.083,0.056,1836,455
"8763",200253,1995,1,0,"MINOT STATE UNIVERSITY",1992,1,525,322,203,36,11,25,0.078,0.069,0.054,1960,447
"8764",200253,1996,1,0,"MINOT STATE UNIVERSITY",1992,1,457,304,153,35,10,25,0.082,0.077,0.065,2044,396
"8765",200253,1997,1,0,"MINOT STATE UNIVERSITY",1992,1,442,270,172,38,9,29,0.107,0.086,0.052,2139,389
"8766",200253,1998,1,0,"MINOT STATE UNIVERSITY",1992,1,371,217,154,28,7,21,0.097,0.075,0.045,2240,325
"8767",200253,1999,1,0,"MINOT STATE UNIVERSITY",1992,1,433,251,182,40,11,29,0.116,0.092,0.06,2050,395
"8768",200253,2000,1,0,"MINOT STATE UNIVERSITY",1992,1,452,260,192,61,25,36,0.138,0.135,0.13,2144,396
"8769",200253,2001,1,0,"MINOT STATE UNIVERSITY",1992,1,419,241,178,43,11,32,0.133,0.103,0.062,2244,370
"8770",200253,2002,1,0,"MINOT STATE UNIVERSITY",1992,1,476,268,208,62,11,51,0.19,0.13,0.053,2344,414
"8771",200253,2003,1,0,"MINOT STATE UNIVERSITY",1992,1,435,252,183,70,16,54,0.214,0.161,0.087,2730,375
"8772",200253,2004,1,0,"MINOT STATE UNIVERSITY",1992,1,431,254,177,72,20,52,0.205,0.167,0.113,3160,369
"8773",200253,2005,1,0,"Minot State University",1992,1,431,240,191,64,19,45,0.188,0.148,0.099,3460,378
"8774",200253,2006,1,0,"Minot State University",1992,1,461,263,198,58,13,45,0.171,0.126,0.066,3790,355
"8775",200253,2007,1,0,"Minot State University",1992,1,418,231,187,60,21,39,0.169,0.144,0.112,3980,347
"8776",200253,2008,1,0,"Minot State University",1992,1,406,259,147,55,11,44,0.17,0.135,0.075,4179,318
"8777",200253,2009,1,0,"Minot State University",1992,1,418,238,180,68,21,47,0.198,0.163,0.117,4325,321
"8778",200253,2010,1,0,"Minot State University",1992,1,461,298,163,83,10,73,0.245,0.18,0.061,4476,344
"8779",200280,1991,1,0,"UNIVERSITY OF NORTH DAKOTA-MAIN CAMPUS",NA,NA,1288,588,700,161,78,83,0.141,0.125,0.111,2145,1188
"8780",200280,1992,1,0,"UNIVERSITY OF NORTH DAKOTA-MAIN CAMPUS",NA,NA,1579,724,855,189,87,102,0.141,0.12,0.102,2165,1466
"8781",200280,1993,1,0,"UNIVERSITY OF NORTH DAKOTA-MAIN CAMPUS",NA,NA,1465,747,718,205,80,125,0.167,0.14,0.111,2298,1371
"8782",200280,1995,1,0,"UNIVERSITY OF NORTH DAKOTA-MAIN CAMPUS",NA,NA,1407,665,742,190,81,109,0.164,0.135,0.109,2428,1314
"8783",200280,1996,1,0,"UNIVERSITY OF NORTH DAKOTA-MAIN CAMPUS",NA,NA,1365,630,735,194,92,102,0.162,0.142,0.125,2528,1269
"8784",200280,1997,1,0,"UNIVERSITY OF NORTH DAKOTA-MAIN CAMPUS",NA,NA,1516,742,774,222,94,128,0.173,0.146,0.121,2677,1394
"8785",200280,1998,1,0,"UNIVERSITY OF NORTH DAKOTA-MAIN CAMPUS",NA,NA,1465,722,743,326,141,185,0.256,0.223,0.19,2830,1377
"8786",200280,1999,1,0,"UNIVERSITY OF NORTH DAKOTA-MAIN CAMPUS",NA,NA,1742,846,896,394,179,215,0.254,0.226,0.2,2956,1636
"8787",200280,2000,1,0,"UNIVERSITY OF NORTH DAKOTA-MAIN CAMPUS",NA,NA,1832,858,974,394,192,202,0.235,0.215,0.197,2604,1731
"8788",200280,2001,1,0,"UNIVERSITY OF NORTH DAKOTA-MAIN CAMPUS",NA,NA,1969,870,1099,436,191,245,0.282,0.221,0.174,2754,1816
"8789",200280,2002,1,0,"UNIVERSITY OF NORTH DAKOTA-MAIN CAMPUS",NA,NA,1987,935,1052,438,205,233,0.249,0.22,0.195,2954,1856
"8790",200280,2003,1,0,"UNIVERSITY OF NORTH DAKOTA-MAIN CAMPUS",NA,NA,2213,1039,1174,511,244,267,0.257,0.231,0.208,3441,2063
"8791",200280,2004,1,0,"UNIVERSITY OF NORTH DAKOTA-MAIN CAMPUS",NA,NA,2178,1016,1162,459,216,243,0.239,0.211,0.186,4009,2015
"8792",200280,2005,1,0,"University of North Dakota",NA,NA,1851,858,993,425,198,227,0.265,0.23,0.199,4390,1769
"8793",200280,2006,1,0,"University of North Dakota",NA,NA,1868,869,999,438,199,239,0.275,0.234,0.199,4786,1754
"8794",200280,2007,1,0,"University of North Dakota",NA,NA,1832,883,949,441,200,241,0.273,0.241,0.211,5025,1673
"8795",200280,2008,1,0,"University of North Dakota",NA,NA,1923,896,1027,450,214,236,0.263,0.234,0.208,5276,1781
"8796",200280,2009,1,0,"University of North Dakota",NA,NA,1970,940,1030,468,218,250,0.266,0.238,0.212,5461,1744
"8797",200280,2010,1,0,"University of North Dakota",NA,NA,2073,978,1095,527,237,290,0.296,0.254,0.216,5652,1773
"8798",200332,1991,0,1,"NORTH DAKOTA STATE UNIVERSITY MAIN CAMPUS",1992,0,1192,491,701,134,58,76,0.155,0.112,0.083,2248,1157
"8799",200332,1992,1,0,"NORTH DAKOTA STATE UNIVERSITY MAIN CAMPUS",1992,1,1550,674,876,155,68,87,0.129,0.1,0.078,2032,1504
"8800",200332,1993,1,0,"NORTH DAKOTA STATE UNIVERSITY MAIN CAMPUS",1992,1,1433,571,862,182,76,106,0.186,0.127,0.088,2184,1395
"8801",200332,1995,1,0,"NORTH DAKOTA STATE UNIVERSITY MAIN CAMPUS",1992,1,1482,661,821,189,87,102,0.154,0.128,0.106,2310,1445
"8802",200332,1996,1,0,"NORTH DAKOTA STATE UNIVERSITY MAIN CAMPUS",1992,1,1295,543,752,169,83,86,0.158,0.131,0.11,2410,1250
"8803",200332,1997,1,0,"NORTH DAKOTA STATE UNIVERSITY MAIN CAMPUS",1992,1,1199,497,702,194,83,111,0.223,0.162,0.118,2566,1154
"8804",200332,1998,1,0,"NORTH DAKOTA STATE UNIVERSITY-MAIN CAMPUS",1992,1,1259,524,735,181,83,98,0.187,0.144,0.113,2730,1191
"8805",200332,1999,1,0,"NORTH DAKOTA STATE UNIVERSITY-MAIN CAMPUS",1992,1,1268,514,754,240,111,129,0.251,0.189,0.147,2596,1204
"8806",200332,2000,1,0,"NORTH DAKOTA STATE UNIVERSITY-MAIN CAMPUS",1992,1,1280,512,768,217,102,115,0.225,0.17,0.133,2604,1234
"8807",200332,2001,1,0,"NORTH DAKOTA STATE UNIVERSITY-MAIN CAMPUS",1992,1,1187,491,696,162,80,82,0.167,0.136,0.115,2754,1130
"8808",200332,2002,1,0,"NORTH DAKOTA STATE UNIVERSITY-MAIN CAMPUS",1992,1,1803,785,1018,387,186,201,0.256,0.215,0.183,2904,1721
"8809",200332,2003,1,0,"NORTH DAKOTA STATE UNIVERSITY-MAIN CAMPUS",1992,1,1944,902,1042,423,178,245,0.272,0.218,0.171,3374,1840
"8810",200332,2004,1,0,"NORTH DAKOTA STATE UNIVERSITY-MAIN CAMPUS",1992,1,2089,949,1140,481,220,261,0.275,0.23,0.193,3981,1940
"8811",200332,2005,1,0,"North Dakota State University-Main Campus",1992,1,1970,940,1030,457,191,266,0.283,0.232,0.185,4360,1879
"8812",200332,2006,1,0,"North Dakota State University-Main Campus",1992,1,2040,920,1120,486,221,265,0.288,0.238,0.197,4774,1902
"8813",200332,2007,1,0,"North Dakota State University-Main Campus",1992,1,2125,965,1160,544,244,300,0.311,0.256,0.21,5013,1999
"8814",200332,2008,1,0,"North Dakota State University-Main Campus",1992,1,2650,1182,1468,667,326,341,0.289,0.252,0.222,5264,2439
"8815",200332,2009,1,0,"North Dakota State University-Main Campus",1992,1,2435,1111,1324,655,299,356,0.32,0.269,0.226,5448,2250
"8816",200332,2010,1,0,"North Dakota State University-Main Campus",1992,1,2373,1074,1299,635,297,338,0.315,0.268,0.229,5639,2131
"8817",200572,1991,0,1,"VALLEY CITY STATE UNIVERSITY",1992,0,186,100,86,21,2,19,0.19,0.113,0.023,1707,171
"8818",200572,1992,1,0,"VALLEY CITY STATE UNIVERSITY",1992,1,193,90,103,28,12,16,0.178,0.145,0.117,1707,172
"8819",200572,1993,1,0,"VALLEY CITY STATE UNIVERSITY",1992,1,196,80,116,34,12,22,0.275,0.173,0.103,1815,171
"8820",200572,1995,1,0,"VALLEY CITY STATE UNIVERSITY",1992,1,166,80,86,32,11,21,0.262,0.193,0.128,1893,149
"8821",200572,1996,1,0,"VALLEY CITY STATE UNIVERSITY",1992,1,178,99,79,38,15,23,0.232,0.213,0.19,2843,167
"8822",200572,1997,1,0,"VALLEY CITY STATE UNIVERSITY",1992,1,177,100,77,37,8,29,0.29,0.209,0.104,2919,158
"8823",200572,1998,1,0,"VALLEY CITY STATE UNIVERSITY",1992,1,193,100,93,47,12,35,0.35,0.244,0.129,3023,172
"8824",200572,1999,1,0,"VALLEY CITY STATE UNIVERSITY",1992,1,158,76,82,35,8,27,0.355,0.222,0.098,1906,142
"8825",200572,2000,1,0,"VALLEY CITY STATE UNIVERSITY",1992,1,179,92,87,35,11,24,0.261,0.196,0.126,1982,160
"8826",200572,2001,1,0,"VALLEY CITY STATE UNIVERSITY",1992,1,155,75,80,40,15,25,0.333,0.258,0.188,2067,140
"8827",200572,2002,1,0,"VALLEY CITY STATE UNIVERSITY",1992,1,153,72,81,41,21,20,0.278,0.268,0.259,2202,133
"8828",200572,2003,1,0,"VALLEY CITY STATE UNIVERSITY",1992,1,159,71,88,36,15,21,0.296,0.226,0.17,2652,143
"8829",200572,2004,1,0,"VALLEY CITY STATE UNIVERSITY",1992,1,167,71,96,39,16,23,0.324,0.234,0.167,3130,143
"8830",200572,2005,1,0,"Valley City State University",1992,1,171,73,98,40,16,24,0.329,0.234,0.163,3656,135
"8831",200572,2006,1,0,"Valley City State University",1992,1,177,70,107,44,20,24,0.343,0.249,0.187,4003,150
"8832",200572,2007,1,0,"Valley City State University",1992,1,184,86,98,42,14,28,0.326,0.228,0.143,4204,154
"8833",200572,2008,1,0,"Valley City State University",1992,1,154,70,84,35,14,21,0.3,0.227,0.167,4412,121
"8834",200572,2009,1,0,"Valley City State University",1992,1,152,53,99,32,13,19,0.359,0.211,0.131,4568,119
"8835",200572,2010,1,0,"Valley City State University",1992,1,217,95,122,45,22,23,0.242,0.207,0.18,4433,173
"8836",201104,1991,1,0,"ASHLAND UNIVERSITY",NA,NA,542,238,304,145,52,93,0.391,0.268,0.171,9985,454
"8837",201104,1992,1,0,"ASHLAND UNIVERSITY",NA,NA,650,307,343,172,69,103,0.335,0.265,0.201,10583,559
"8838",201104,1993,1,0,"ASHLAND UNIVERSITY",NA,NA,510,268,242,134,29,105,0.392,0.263,0.12,10733,452
"8839",201104,1995,1,0,"ASHLAND UNIVERSITY",NA,NA,549,269,280,214,67,147,0.546,0.39,0.239,12174,493
"8840",201104,1996,1,0,"ASHLAND UNIVERSITY",NA,NA,432,240,192,150,47,103,0.429,0.347,0.245,12600,398
"8841",201104,1997,1,0,"ASHLAND UNIVERSITY",NA,NA,531,302,229,220,76,144,0.477,0.414,0.332,13293,493
"8842",201104,1998,1,0,"ASHLAND UNIVERSITY",NA,NA,570,351,219,235,66,169,0.482,0.412,0.301,13726,541
"8843",201104,1999,1,0,"ASHLAND UNIVERSITY",NA,NA,541,313,228,246,80,166,0.53,0.455,0.351,14276,512
"8844",201104,2000,1,0,"ASHLAND UNIVERSITY",NA,NA,448,265,183,187,51,136,0.513,0.417,0.279,15134,413
"8845",201104,2001,1,0,"ASHLAND UNIVERSITY",NA,NA,492,273,219,200,69,131,0.48,0.407,0.315,15814,458
"8846",201104,2002,1,0,"ASHLAND UNIVERSITY",NA,NA,559,373,186,258,60,198,0.531,0.462,0.323,16764,512
"8847",201104,2003,1,0,"ASHLAND UNIVERSITY",NA,NA,605,379,226,275,76,199,0.525,0.455,0.336,17518,547
"8848",201104,2004,1,0,"ASHLAND UNIVERSITY",NA,NA,571,340,231,245,70,175,0.515,0.429,0.303,18394,522
"8849",201104,2005,1,0,"Ashland University",NA,NA,573,357,216,271,86,185,0.518,0.473,0.398,19314,530
"8850",201104,2006,1,0,"Ashland University",NA,NA,554,313,241,238,78,160,0.511,0.43,0.324,20666,477
"8851",201104,2007,1,0,"Ashland University",NA,NA,639,371,268,264,77,187,0.504,0.413,0.287,22216,558
"8852",201104,2008,1,0,"Ashland University",NA,NA,570,306,264,236,83,153,0.5,0.414,0.314,23550,455
"8853",201104,2009,1,0,"Ashland University",NA,NA,614,338,276,281,94,187,0.553,0.458,0.341,24828,507
"8854",201104,2010,1,0,"Ashland University",NA,NA,688,407,281,345,115,230,0.565,0.501,0.409,26566,607
"8855",201371,1991,0,1,"BLUFFTON COLLEGE",1999,0,193,93,100,85,30,55,0.591,0.44,0.3,8100,178
"8856",201371,1992,0,1,"BLUFFTON COLLEGE",1999,0,181,104,77,92,39,53,0.51,0.508,0.506,8685,173
"8857",201371,1993,0,1,"BLUFFTON COLLEGE",1999,0,214,105,109,110,43,67,0.638,0.514,0.394,9225,193
"8858",201371,1995,0,1,"BLUFFTON COLLEGE",1999,0,248,163,85,125,39,86,0.528,0.504,0.459,10620,235
"8859",201371,1996,0,1,"BLUFFTON COLLEGE",1999,0,183,115,68,97,38,59,0.513,0.53,0.559,11250,174
"8860",201371,1997,0,1,"BLUFFTON COLLEGE",1999,0,254,149,105,124,37,87,0.584,0.488,0.352,11835,233
"8861",201371,1998,0,1,"BLUFFTON COLLEGE",1999,0,190,112,78,102,32,70,0.625,0.537,0.41,12375,177
"8862",201371,1999,1,0,"BLUFFTON COLLEGE",1999,1,248,156,92,114,32,82,0.526,0.46,0.348,13156,231
"8863",201371,2000,1,0,"BLUFFTON COLLEGE",1999,1,227,124,103,114,48,66,0.532,0.502,0.466,14076,210
"8864",201371,2001,1,0,"BLUFFTON COLLEGE",1999,1,239,133,106,117,44,73,0.549,0.49,0.415,15076,225
"8865",201371,2002,1,0,"BLUFFTON COLLEGE",1999,1,262,141,121,135,55,80,0.567,0.515,0.455,16130,226
"8866",201371,2003,1,0,"BLUFFTON COLLEGE",1999,1,236,143,93,133,51,82,0.573,0.564,0.548,17260,208
"8867",201371,2004,1,0,"BLUFFTON UNIVERSITY",1999,1,266,130,136,136,61,75,0.577,0.511,0.449,17950,236
"8868",201371,2005,1,0,"Bluffton University",1999,1,228,141,87,123,45,78,0.553,0.539,0.517,19028,198
"8869",201371,2006,1,0,"Bluffton University",1999,1,241,122,119,119,50,69,0.566,0.494,0.42,20170,203
"8870",201371,2007,1,0,"Bluffton University",1999,1,206,117,89,108,41,67,0.573,0.524,0.461,21380,181
"8871",201371,2008,1,0,"Bluffton University",1999,1,272,140,132,144,62,82,0.586,0.529,0.47,22470,250
"8872",201371,2009,1,0,"Bluffton University",1999,1,257,116,141,107,48,59,0.509,0.416,0.34,23594,213
"8873",201371,2010,1,0,"Bluffton University",1999,1,219,91,128,96,45,51,0.56,0.438,0.352,24480,169
"8874",201548,1991,1,0,"CAPITAL UNIVERSITY",NA,NA,370,218,152,232,87,145,0.665,0.627,0.572,11085,342
"8875",201548,1992,1,0,"CAPITAL UNIVERSITY",NA,NA,330,213,117,163,56,107,0.502,0.494,0.479,11810,296
"8876",201548,1993,1,0,"CAPITAL UNIVERSITY",NA,NA,448,266,182,238,81,157,0.59,0.531,0.445,12500,396
"8877",201548,1995,1,0,"CAPITAL UNIVERSITY",NA,NA,474,296,178,306,108,198,0.669,0.646,0.607,13700,415
"8878",201548,1996,1,0,"CAPITAL UNIVERSITY",NA,NA,468,285,183,275,90,185,0.649,0.588,0.492,14200,399
"8879",201548,1997,1,0,"CAPITAL UNIVERSITY",NA,NA,478,290,188,239,82,157,0.541,0.5,0.436,14760,413
"8880",201548,1998,1,0,"CAPITAL UNIVERSITY",NA,NA,518,313,205,250,79,171,0.546,0.483,0.385,15260,444
"8881",201548,1999,1,0,"CAPITAL UNIVERSITY",NA,NA,532,301,231,255,101,154,0.512,0.479,0.437,16000,474
"8882",201548,2000,1,0,"CAPITAL UNIVERSITY",NA,NA,558,333,225,305,111,194,0.583,0.547,0.493,16880,476
"8883",201548,2001,1,0,"CAPITAL UNIVERSITY",NA,NA,519,324,195,243,68,175,0.54,0.468,0.349,17990,449
"8884",201548,2002,1,0,"CAPITAL UNIVERSITY",NA,NA,563,330,233,296,104,192,0.582,0.526,0.446,18980,482
"8885",201548,2003,1,0,"CAPITAL UNIVERSITY",NA,NA,565,352,213,284,100,184,0.523,0.503,0.469,20500,473
"8886",201548,2004,1,0,"CAPITAL UNIVERSITY",NA,NA,517,298,219,253,96,157,0.527,0.489,0.438,22035,438
"8887",201548,2005,1,0,"Capital University",NA,NA,599,363,236,310,109,201,0.554,0.518,0.462,23433,504
"8888",201548,2006,1,0,"Capital University",NA,NA,690,410,280,342,130,212,0.517,0.496,0.464,25100,591
"8889",201548,2007,1,0,"Capital University",NA,NA,627,377,250,323,117,206,0.546,0.515,0.468,26360,525
"8890",201548,2008,1,0,"Capital University",NA,NA,632,354,278,321,122,199,0.562,0.508,0.439,27680,517
"8891",201548,2009,1,0,"Capital University",NA,NA,608,323,285,336,150,186,0.576,0.553,0.526,28480,520
"8892",201548,2010,1,0,"Capital University",NA,NA,715,409,306,381,167,214,0.523,0.533,0.546,29310,616
"8893",201645,1991,1,0,"CASE WESTERN RESERVE UNIVERSITY",NA,NA,647,245,402,327,173,154,0.629,0.505,0.43,13708,438
"8894",201645,1992,1,0,"CASE WESTERN RESERVE UNIVERSITY",NA,NA,762,321,441,350,152,198,0.617,0.459,0.345,14616,542
"8895",201645,1993,1,0,"CASE WESTERN RESERVE UNIVERSITY",NA,NA,712,249,463,354,201,153,0.615,0.497,0.434,15322,487
"8896",201645,1995,1,0,"CASE WESTERN RESERVE UNIVERSITY",NA,NA,729,275,454,388,205,183,0.665,0.532,0.452,16430,544
"8897",201645,1996,1,0,"CASE WESTERN RESERVE UNIVERSITY",NA,NA,738,284,454,387,202,185,0.651,0.524,0.445,17235,507
"8898",201645,1997,1,0,"CASE WESTERN RESERVE UNIVERSITY",NA,NA,736,269,467,408,235,173,0.643,0.554,0.503,17942,494
"8899",201645,1998,1,0,"CASE WESTERN RESERVE UNIVERSITY",NA,NA,830,301,529,476,265,211,0.701,0.573,0.501,18546,554
"8900",201645,1999,1,0,"CASE WESTERN RESERVE UNIVERSITY",NA,NA,762,292,470,432,245,187,0.64,0.567,0.521,19200,579
"8901",201645,2000,1,0,"CASE WESTERN RESERVE UNIVERSITY",NA,NA,833,305,528,489,279,210,0.689,0.587,0.528,20100,615
"8902",201645,2001,1,0,"CASE WESTERN RESERVE UNIVERSITY",NA,NA,737,288,449,433,228,205,0.712,0.588,0.508,21000,523
"8903",201645,2002,1,0,"CASE WESTERN RESERVE UNIVERSITY",NA,NA,835,322,513,482,264,218,0.677,0.577,0.515,22500,603
"8904",201645,2003,1,0,"CASE WESTERN RESERVE UNIVERSITY",NA,NA,874,350,524,552,292,260,0.743,0.632,0.557,24100,624
"8905",201645,2004,1,0,"CASE WESTERN RESERVE UNIVERSITY",NA,NA,782,306,476,508,282,226,0.739,0.65,0.592,26500,511
"8906",201645,2005,1,0,"Case Western Reserve University",NA,NA,1162,456,706,702,386,316,0.693,0.604,0.547,28400,682
"8907",201645,2006,1,0,"Case Western Reserve University",NA,NA,1015,441,574,636,325,311,0.705,0.627,0.566,31090,632
"8908",201645,2007,1,0,"Case Western Reserve University",NA,NA,1132,492,640,734,368,366,0.744,0.648,0.575,32800,652
"8909",201645,2008,1,0,"Case Western Reserve University",NA,NA,1023,442,581,651,337,314,0.71,0.636,0.58,34450,566
"8910",201645,2009,1,0,"Case Western Reserve University",NA,NA,965,401,564,609,309,300,0.748,0.631,0.548,35900,546
"8911",201645,2010,1,0,"Case Western Reserve University",NA,NA,1019,415,604,655,356,299,0.721,0.643,0.589,37300,537
"8912",201690,1991,0,1,"CENTRAL STATE UNIVERSITY",2005,0,661,327,334,92,34,58,0.177,0.139,0.102,2388,13
"8913",201690,1992,0,1,"CENTRAL STATE UNIVERSITY",2005,0,665,319,346,42,12,30,0.094,0.063,0.035,2679,6
"8914",201690,1993,0,1,"CENTRAL STATE UNIVERSITY",2005,0,613,301,312,66,18,48,0.16,0.108,0.058,2811,2
"8915",201690,1995,0,1,"CENTRAL STATE UNIVERSITY",2005,0,597,262,335,25,5,20,0.076,0.042,0.015,2664,4
"8916",201690,1996,0,1,"CENTRAL STATE UNIVERSITY",2005,0,330,161,169,28,12,16,0.099,0.085,0.071,3318,1
"8917",201690,1997,0,1,"CENTRAL STATE UNIVERSITY",2005,0,88,47,41,4,0,4,0.085,0.045,0,3318,0
"8918",201690,1998,0,1,"CENTRAL STATE UNIVERSITY",2005,0,230,130,100,27,5,22,0.169,0.117,0.05,3336,13
"8919",201690,1999,0,1,"CENTRAL STATE UNIVERSITY",2005,0,294,164,130,46,12,34,0.207,0.156,0.092,1926,5
"8920",201690,2000,0,1,"CENTRAL STATE UNIVERSITY",2005,0,307,173,134,39,5,34,0.196,0.127,0.037,2046,5
"8921",201690,2001,0,1,"CENTRAL STATE UNIVERSITY",2005,0,397,204,193,33,7,26,0.128,0.083,0.036,2064,0
"8922",201690,2002,0,1,"CENTRAL STATE UNIVERSITY",2005,0,378,207,171,51,14,37,0.179,0.135,0.082,2208,2
"8923",201690,2003,0,1,"CENTRAL STATE UNIVERSITY",2005,0,542,277,265,43,10,33,0.119,0.079,0.038,2340,4
"8924",201690,2004,0,1,"CENTRAL STATE UNIVERSITY",2005,0,583,270,313,46,11,35,0.13,0.079,0.035,2571,2
"8925",201690,2005,1,0,"Central State University",2005,1,343,156,187,31,15,16,0.103,0.09,0.08,2726,3
"8926",201690,2006,1,0,"Central State University",2005,1,535,266,269,65,21,44,0.165,0.121,0.078,2890,5
"8927",201690,2007,1,0,"Central State University",2005,1,564,278,286,59,15,44,0.158,0.105,0.052,2890,1
"8928",201690,2008,1,0,"Central State University",2005,1,646,330,316,72,10,62,0.188,0.111,0.032,2890,2
"8929",201690,2009,1,0,"Central State University",2005,1,702,363,339,42,14,28,0.077,0.06,0.041,2890,4
"8930",201690,2010,1,0,"Central State University",2005,1,503,231,272,49,18,31,0.134,0.097,0.066,2992,4
"8931",202134,1991,0,1,"CLEVELAND STATE UNIVERSITY",1999,0,959,435,524,70,34,36,0.083,0.073,0.065,2682,699
"8932",202134,1992,0,1,"CLEVELAND STATE UNIVERSITY",1999,0,868,409,459,55,21,34,0.083,0.063,0.046,2976,625
"8933",202134,1993,0,1,"CLEVELAND STATE UNIVERSITY",1999,0,942,479,463,77,26,51,0.107,0.082,0.056,3126,641
"8934",202134,1995,0,1,"CLEVELAND STATE UNIVERSITY",1999,0,856,463,393,71,26,45,0.097,0.083,0.066,3332,511
"8935",202134,1996,0,1,"CLEVELAND STATE UNIVERSITY",1999,0,845,443,402,80,25,55,0.124,0.095,0.062,3442,505
"8936",202134,1997,0,1,"CLEVELAND STATE UNIVERSITY",1999,0,924,464,460,89,36,53,0.114,0.096,0.078,3456,588
"8937",202134,1998,0,1,"CLEVELAND STATE UNIVERSITY",1999,0,962,455,507,86,37,49,0.108,0.089,0.073,3670,509
"8938",202134,1999,1,0,"CLEVELAND STATE UNIVERSITY",1999,1,1048,494,554,114,50,64,0.13,0.109,0.09,3864,661
"8939",202134,2000,1,0,"CLEVELAND STATE UNIVERSITY",1999,1,934,471,463,103,42,61,0.13,0.11,0.091,4110,561
"8940",202134,2001,1,0,"CLEVELAND STATE UNIVERSITY",1999,1,1008,493,515,95,47,48,0.097,0.094,0.091,4464,614
"8941",202134,2002,1,0,"CLEVELAND STATE UNIVERSITY",1999,1,946,463,483,80,39,41,0.089,0.085,0.081,5196,571
"8942",202134,2003,1,0,"CLEVELAND STATE UNIVERSITY",1999,1,925,463,462,65,34,31,0.067,0.07,0.074,5760,530
"8943",202134,2004,1,0,"CLEVELAND STATE UNIVERSITY",1999,1,922,463,459,79,31,48,0.104,0.086,0.068,6792,527
"8944",202134,2005,1,0,"Cleveland State University",1999,1,955,507,448,87,31,56,0.111,0.091,0.069,6972,553
"8945",202134,2006,1,0,"Cleveland State University",1999,1,947,520,427,95,31,64,0.123,0.1,0.073,7920,560
"8946",202134,2007,1,0,"Cleveland State University",1999,1,1132,622,510,94,37,57,0.092,0.083,0.073,7920,612
"8947",202134,2008,1,0,"Cleveland State University",1999,1,1005,548,457,150,50,100,0.182,0.149,0.109,7920,616
"8948",202134,2009,1,0,"Cleveland State University",1999,1,1127,601,526,181,70,111,0.185,0.161,0.133,7920,662
"8949",202134,2010,1,0,"Cleveland State University",1999,1,1148,615,533,237,105,132,0.215,0.206,0.197,8466,704
"8950",202480,1991,0,1,"UNIVERSITY OF DAYTON",2005,0,1499,744,755,758,322,436,0.586,0.506,0.426,9410,1361
"8951",202480,1992,0,1,"UNIVERSITY OF DAYTON",2005,0,1622,778,844,832,343,489,0.629,0.513,0.406,10210,1467
"8952",202480,1993,0,1,"UNIVERSITY OF DAYTON",2005,0,1507,730,777,769,324,445,0.61,0.51,0.417,11090,1360
"8953",202480,1995,0,1,"UNIVERSITY OF DAYTON",2005,0,1610,836,774,890,342,548,0.655,0.553,0.442,12350,1466
"8954",202480,1996,0,1,"UNIVERSITY OF DAYTON",2005,0,1553,845,708,890,310,580,0.686,0.573,0.438,13640,1437
"8955",202480,1997,0,1,"UNIVERSITY OF DAYTON",2005,0,1622,872,750,896,351,545,0.625,0.552,0.468,14180,1473
"8956",202480,1998,0,1,"UNIVERSITY OF DAYTON",2005,0,1792,919,873,991,385,606,0.659,0.553,0.441,14670,1620
"8957",202480,1999,0,1,"UNIVERSITY OF DAYTON",2005,0,1744,921,823,1041,412,629,0.683,0.597,0.501,15020,1516
"8958",202480,2000,0,1,"UNIVERSITY OF DAYTON",2005,0,1764,932,832,1055,431,624,0.67,0.598,0.518,15550,1619
"8959",202480,2001,0,1,"UNIVERSITY OF DAYTON",2005,0,1715,879,836,971,389,582,0.662,0.566,0.465,16320,1574
"8960",202480,2002,0,1,"UNIVERSITY OF DAYTON",2005,0,1644,797,847,944,390,554,0.695,0.574,0.46,17450,1404
"8961",202480,2003,0,1,"UNIVERSITY OF DAYTON",2005,0,1858,956,902,1084,431,653,0.683,0.583,0.478,18390,1568
"8962",202480,2004,0,1,"UNIVERSITY OF DAYTON",2005,0,1805,905,900,1048,437,611,0.675,0.581,0.486,19570,1574
"8963",202480,2005,1,0,"University of Dayton",2005,1,1970,1004,966,1149,475,674,0.671,0.583,0.492,21246,1783
"8964",202480,2006,1,0,"University of Dayton",2005,1,1738,864,874,1041,450,591,0.684,0.599,0.515,23000,1595
"8965",202480,2007,1,0,"University of Dayton",2005,1,1763,893,870,1064,460,604,0.676,0.604,0.529,24880,1563
"8966",202480,2008,1,0,"University of Dayton",2005,1,1985,1045,940,1177,452,725,0.694,0.593,0.481,26200,1732
"8967",202480,2009,1,0,"University of Dayton",2005,1,1692,834,858,1050,463,587,0.704,0.621,0.54,27510,1493
"8968",202480,2010,1,0,"University of Dayton",2005,1,2029,995,1034,1187,506,681,0.684,0.585,0.489,28700,1752
"8969",202523,1991,1,0,"DENISON UNIVERSITY",NA,NA,501,271,230,351,150,201,0.742,0.701,0.652,14700,438
"8970",202523,1992,1,0,"DENISON UNIVERSITY",NA,NA,570,301,269,392,174,218,0.724,0.688,0.647,15640,506
"8971",202523,1993,1,0,"DENISON UNIVERSITY",NA,NA,535,290,245,342,142,200,0.69,0.639,0.58,15950,496
"8972",202523,1995,1,0,"DENISON UNIVERSITY",NA,NA,701,357,344,488,221,267,0.748,0.696,0.642,18630,606
"8973",202523,1996,1,0,"DENISON UNIVERSITY",NA,NA,642,305,337,464,229,235,0.77,0.723,0.68,19470,562
"8974",202523,1997,1,0,"DENISON UNIVERSITY",NA,NA,593,325,268,438,185,253,0.778,0.739,0.69,20250,510
"8975",202523,1998,1,0,"DENISON UNIVERSITY",NA,NA,631,364,267,456,173,283,0.777,0.723,0.648,21060,527
"8976",202523,1999,1,0,"DENISON UNIVERSITY",NA,NA,587,335,252,444,171,273,0.815,0.756,0.679,20680,499
"8977",202523,2000,1,0,"DENISON UNIVERSITY",NA,NA,648,370,278,484,198,286,0.773,0.747,0.712,21710,553
"8978",202523,2001,1,0,"DENISON UNIVERSITY",NA,NA,553,309,244,414,170,244,0.79,0.749,0.697,22550,450
"8979",202523,2002,1,0,"DENISON UNIVERSITY",NA,NA,633,338,295,469,192,277,0.82,0.741,0.651,23680,519
"8980",202523,2003,1,0,"DENISON UNIVERSITY",NA,NA,629,358,271,502,199,303,0.846,0.798,0.734,25090,535
"8981",202523,2004,1,0,"DENISON UNIVERSITY",NA,NA,616,362,254,501,200,301,0.832,0.813,0.787,26700,512
"8982",202523,2005,1,0,"Denison University",NA,NA,620,337,283,473,211,262,0.777,0.763,0.746,28170,506
"8983",202523,2006,1,0,"Denison University",NA,NA,573,335,238,481,190,291,0.869,0.839,0.798,29860,479
"8984",202523,2007,1,0,"Denison University",NA,NA,585,325,260,455,199,256,0.788,0.778,0.765,32160,480
"8985",202523,2008,1,0,"Denison University",NA,NA,604,325,279,476,202,274,0.843,0.788,0.724,34410,472
"8986",202523,2009,1,0,"Denison University",NA,NA,649,362,287,500,205,295,0.815,0.77,0.714,35650,486
"8987",202523,2010,1,0,"Denison University",NA,NA,623,349,274,482,199,283,0.811,0.774,0.726,37270,452
"8988",202763,1991,1,0,"THE UNIVERSITY OF FINDLAY",NA,NA,342,152,190,95,46,49,0.322,0.278,0.242,8880,262
"8989",202763,1992,1,0,"THE UNIVERSITY OF FINDLAY",NA,NA,412,197,215,153,62,91,0.462,0.371,0.288,10054,337
"8990",202763,1993,1,0,"THE UNIVERSITY OF FINDLAY",NA,NA,394,190,204,162,76,86,0.453,0.411,0.373,10920,286
"8991",202763,1995,1,0,"THE UNIVERSITY OF FINDLAY",NA,NA,591,306,285,205,78,127,0.415,0.347,0.274,12500,386
"8992",202763,1996,1,0,"THE UNIVERSITY OF FINDLAY",NA,NA,553,302,251,210,83,127,0.42,0.38,0.331,13112,428
"8993",202763,1997,1,0,"THE UNIVERSITY OF FINDLAY",NA,NA,651,390,261,264,75,189,0.485,0.406,0.287,13766,545
"8994",202763,1998,1,0,"THE UNIVERSITY OF FINDLAY",NA,NA,585,384,201,228,64,164,0.427,0.39,0.318,14320,533
"8995",202763,1999,1,0,"THE UNIVERSITY OF FINDLAY",NA,NA,522,337,185,212,52,160,0.475,0.406,0.281,15080,452
"8996",202763,2000,1,0,"THE UNIVERSITY OF FINDLAY",NA,NA,684,399,285,257,87,170,0.426,0.376,0.305,15830,603
"8997",202763,2001,1,0,"THE UNIVERSITY OF FINDLAY",NA,NA,613,377,236,255,69,186,0.493,0.416,0.292,17088,537
"8998",202763,2002,1,0,"THE UNIVERSITY OF FINDLAY",NA,NA,651,386,265,276,98,178,0.461,0.424,0.37,18114,571
"8999",202763,2003,1,0,"THE UNIVERSITY OF FINDLAY",NA,NA,671,441,230,260,72,188,0.426,0.387,0.313,19052,569
"9000",202763,2004,1,0,"THE UNIVERSITY OF FINDLAY",NA,NA,580,387,193,248,60,188,0.486,0.428,0.311,19996,517
"9001",202763,2005,1,0,"The University of Findlay",NA,NA,584,399,185,240,64,176,0.441,0.411,0.346,20796,537
"9002",202763,2006,1,0,"The University of Findlay",NA,NA,616,441,175,243,58,185,0.42,0.394,0.331,21836,541
"9003",202763,2007,1,0,"The University of Findlay",NA,NA,594,416,178,258,53,205,0.493,0.434,0.298,22906,535
"9004",202763,2008,1,0,"The University of Findlay",NA,NA,562,391,171,242,56,186,0.476,0.431,0.327,23938,504
"9005",202763,2009,1,0,"The University of Findlay",NA,NA,565,398,167,251,51,200,0.503,0.444,0.305,25016,461
"9006",202763,2010,1,0,"The University of Findlay",NA,NA,659,461,198,338,95,243,0.527,0.513,0.48,26016,585
"9007",203085,1991,1,0,"HEIDELBERG COLLEGE",NA,NA,252,100,152,100,56,44,0.44,0.397,0.368,11680,236
"9008",203085,1992,1,0,"HEIDELBERG COLLEGE",NA,NA,229,88,141,86,46,40,0.454,0.376,0.326,12380,203
"9009",203085,1993,1,0,"HEIDELBERG COLLEGE",NA,NA,217,105,112,86,38,48,0.457,0.396,0.339,13000,204
"9010",203085,1995,1,0,"HEIDELBERG COLLEGE",NA,NA,220,87,133,94,46,48,0.552,0.427,0.346,14606,208
"9011",203085,1996,1,0,"HEIDELBERG COLLEGE",NA,NA,303,141,162,141,68,73,0.518,0.465,0.42,15140,273
"9012",203085,1997,1,0,"HEIDELBERG COLLEGE",NA,NA,264,114,150,127,58,69,0.605,0.481,0.387,15594,249
"9013",203085,1998,1,0,"HEIDELBERG COLLEGE",NA,NA,290,138,152,130,54,76,0.551,0.448,0.355,16100,274
"9014",203085,1999,1,0,"HEIDELBERG COLLEGE",NA,NA,259,98,161,124,61,63,0.643,0.479,0.379,16422,246
"9015",203085,2000,1,0,"HEIDELBERG COLLEGE",NA,NA,277,137,140,121,39,82,0.599,0.437,0.279,16998,255
"9016",203085,2001,1,0,"HEIDELBERG COLLEGE",NA,NA,262,119,143,113,38,75,0.63,0.431,0.266,17848,228
"9017",203085,2002,1,0,"HEIDELBERG COLLEGE",NA,NA,278,160,118,103,34,69,0.431,0.371,0.288,12850,252
"9018",203085,2003,1,0,"HEIDELBERG COLLEGE",NA,NA,298,142,156,116,43,73,0.514,0.389,0.276,13620,264
"9019",203085,2004,1,0,"HEIDELBERG COLLEGE",NA,NA,354,159,195,132,47,85,0.535,0.373,0.241,14574,318
"9020",203085,2005,1,0,"Heidelberg College",NA,NA,324,135,189,174,85,89,0.659,0.537,0.45,15740,283
"9021",203085,2006,1,0,"Heidelberg College",NA,NA,267,131,136,105,38,67,0.511,0.393,0.279,17000,214
"9022",203085,2007,1,0,"Heidelberg College",NA,NA,369,149,220,130,64,66,0.443,0.352,0.291,18190,297
"9023",203085,2008,1,0,"Heidelberg University",NA,NA,402,177,225,142,61,81,0.458,0.353,0.271,19464,313
"9024",203085,2009,1,0,"Heidelberg University",NA,NA,375,168,207,118,48,70,0.417,0.315,0.232,20826,279
"9025",203085,2010,1,0,"Heidelberg University",NA,NA,334,158,176,137,57,80,0.506,0.41,0.324,22242,258
"9026",203128,1991,0,1,"HIRAM COLLEGE",1996,0,287,148,139,159,69,90,0.608,0.554,0.496,11950,255
"9027",203128,1992,0,1,"HIRAM COLLEGE",1996,0,277,134,143,116,116,0,0,0.419,0.811,12897,253
"9028",203128,1993,0,1,"HIRAM COLLEGE",1996,0,263,127,136,134,64,70,0.551,0.51,0.471,13665,231
"9029",203128,1995,0,1,"HIRAM COLLEGE",1996,0,217,119,98,124,47,77,0.647,0.571,0.48,15270,180
"9030",203128,1996,1,0,"HIRAM COLLEGE",1996,1,232,129,103,144,60,84,0.651,0.621,0.583,15600,194
"9031",203128,1997,1,0,"HIRAM COLLEGE",1996,1,240,123,117,136,54,82,0.667,0.567,0.462,16224,199
"9032",203128,1998,1,0,"HIRAM COLLEGE",1996,1,231,106,125,137,63,74,0.698,0.593,0.504,17010,200
"9033",203128,1999,1,0,"HIRAM COLLEGE",1996,1,279,143,136,153,64,89,0.622,0.548,0.471,17230,241
"9034",203128,2000,1,0,"HIRAM COLLEGE",1996,1,244,139,105,128,54,74,0.532,0.525,0.514,17870,214
"9035",203128,2001,1,0,"HIRAM COLLEGE",1996,1,269,157,112,149,52,97,0.618,0.554,0.464,18720,221
"9036",203128,2002,1,0,"HIRAM COLLEGE",1996,1,233,126,107,132,52,80,0.635,0.567,0.486,19650,191
"9037",203128,2003,1,0,"HIRAM COLLEGE",1996,1,236,127,109,151,59,92,0.724,0.64,0.541,20440,194
"9038",203128,2004,1,0,"HIRAM COLLEGE",1996,1,220,106,114,137,62,75,0.708,0.623,0.544,21533,154
"9039",203128,2005,1,0,"Hiram College",1996,1,208,101,107,125,57,68,0.673,0.601,0.533,23510,161
"9040",203128,2006,1,0,"Hiram College",1996,1,298,143,155,174,80,94,0.657,0.584,0.516,23510,176
"9041",203128,2007,1,0,"Hiram College",1996,1,333,184,149,199,77,122,0.663,0.598,0.517,24215,229
"9042",203128,2008,1,0,"Hiram College",1996,1,331,164,167,189,82,107,0.652,0.571,0.491,24940,230
"9043",203128,2009,1,0,"Hiram College",1996,1,293,143,150,154,74,80,0.559,0.526,0.493,26435,223
"9044",203128,2010,1,0,"Hiram College",1996,1,295,157,138,160,65,95,0.605,0.542,0.471,26435,215
"9045",203368,1991,1,0,"JOHN CARROLL UNIVERSITY",NA,NA,765,386,379,465,212,253,0.655,0.608,0.559,9600,692
"9046",203368,1992,1,0,"JOHN CARROLL UNIVERSITY",NA,NA,748,395,353,452,184,268,0.678,0.604,0.521,10440,685
"9047",203368,1993,1,0,"JOHN CARROLL UNIVERSITY",NA,NA,813,422,391,487,216,271,0.642,0.599,0.552,11060,746
"9048",203368,1995,1,0,"JOHN CARROLL UNIVERSITY",NA,NA,844,424,420,587,257,330,0.778,0.695,0.612,12390,784
"9049",203368,1996,1,0,"JOHN CARROLL UNIVERSITY",NA,NA,775,425,350,483,201,282,0.663,0.623,0.574,13122,712
"9050",203368,1997,1,0,"JOHN CARROLL UNIVERSITY",NA,NA,790,408,382,495,217,278,0.681,0.627,0.568,13883,728
"9051",203368,1998,1,0,"JOHN CARROLL UNIVERSITY",NA,NA,854,433,421,532,241,291,0.672,0.623,0.572,14670,772
"9052",203368,1999,1,0,"JOHN CARROLL UNIVERSITY",NA,NA,833,451,382,539,204,335,0.743,0.647,0.534,15424,756
"9053",203368,2000,1,0,"JOHN CARROLL UNIVERSITY",NA,NA,830,467,363,543,214,329,0.705,0.654,0.59,16334,750
"9054",203368,2001,1,0,"JOHN CARROLL UNIVERSITY",NA,NA,789,442,347,515,219,296,0.67,0.653,0.631,17478,711
"9055",203368,2002,1,0,"JOHN CARROLL UNIVERSITY",NA,NA,843,456,387,599,256,343,0.752,0.711,0.661,18832,763
"9056",203368,2003,1,0,"JOHN CARROLL UNIVERSITY",NA,NA,859,453,406,543,226,317,0.7,0.632,0.557,20566,760
"9057",203368,2004,1,0,"JOHN CARROLL UNIVERSITY",NA,NA,734,383,351,466,207,259,0.676,0.635,0.59,22108,641
"9058",203368,2005,1,0,"John Carroll University",NA,NA,786,401,385,504,217,287,0.716,0.641,0.564,23380,663
"9059",203368,2006,1,0,"John Carroll University",NA,NA,712,385,327,469,205,264,0.686,0.659,0.627,24782,604
"9060",203368,2007,1,0,"John Carroll University",NA,NA,720,358,362,471,216,255,0.712,0.654,0.597,26144,561
"9061",203368,2008,1,0,"John Carroll University",NA,NA,789,393,396,473,209,264,0.672,0.599,0.528,27190,580
"9062",203368,2009,1,0,"John Carroll University",NA,NA,660,335,325,373,163,210,0.627,0.565,0.502,27940,561
"9063",203368,2010,1,0,"John Carroll University",NA,NA,703,380,323,460,189,271,0.713,0.654,0.585,29250,553
"9064",203517,1991,1,0,"KENT STATE UNIVERSITY MAIN CAMPUS",NA,NA,2692,1609,1083,579,168,411,0.255,0.215,0.155,3300,2415
"9065",203517,1992,1,0,"KENT STATE UNIVERSITY MAIN CAMPUS",NA,NA,2581,1580,1001,508,135,373,0.236,0.197,0.135,3596,2302
"9066",203517,1993,1,0,"KENT STATE UNIVERSITY-MAIN CAMPUS",NA,NA,2371,1476,895,540,163,377,0.255,0.228,0.182,3740,2093
"9067",203517,1995,1,0,"KENT STATE UNIVERSITY-MAIN CAMPUS",NA,NA,2623,1580,1043,353,85,268,0.17,0.135,0.081,4084,2319
"9068",203517,1996,1,0,"KENT STATE UNIVERSITY-MAIN CAMPUS",NA,NA,2600,1516,1084,448,150,298,0.197,0.172,0.138,4288,2307
"9069",203517,1997,1,0,"KENT STATE UNIVERSITY-MAIN CAMPUS",NA,NA,2573,1524,1049,508,173,335,0.22,0.197,0.165,4460,2252
"9070",203517,1998,1,0,"KENT STATE UNIVERSITY-MAIN CAMPUS",NA,NA,3019,1867,1152,491,154,337,0.181,0.163,0.134,4660,2622
"9071",203517,1999,1,0,"KENT STATE UNIVERSITY-MAIN CAMPUS",NA,NA,3476,2160,1316,668,187,481,0.223,0.192,0.142,4011,2974
"9072",203517,2000,1,0,"KENT STATE UNIVERSITY-MAIN CAMPUS",NA,NA,3556,2184,1372,748,226,522,0.239,0.21,0.165,4234,3054
"9073",203517,2001,1,0,"KENT STATE UNIVERSITY-MAIN CAMPUS",NA,NA,3588,2202,1386,556,158,398,0.181,0.155,0.114,4490,3137
"9074",203517,2002,1,0,"KENT STATE UNIVERSITY-MAIN CAMPUS",NA,NA,3640,2232,1408,892,283,609,0.273,0.245,0.201,6374,3148
"9075",203517,2003,1,0,"KENT STATE UNIVERSITY-MAIN CAMPUS",NA,NA,3746,2293,1453,895,266,629,0.274,0.239,0.183,6882,3153
"9076",203517,2004,1,0,"KENT STATE UNIVERSITY-MAIN CAMPUS",NA,NA,3841,2428,1413,969,271,698,0.288,0.252,0.192,7504,3278
"9077",203517,2005,1,0,"Kent State University-Kent Campus",NA,NA,3727,2325,1402,970,294,676,0.291,0.26,0.21,7954,3089
"9078",203517,2006,1,0,"Kent State University-Kent Campus",NA,NA,3610,2214,1396,977,295,682,0.308,0.271,0.211,8430,2921
"9079",203517,2007,1,0,"Kent State University-Kent Campus",NA,NA,3729,2300,1429,1031,308,723,0.314,0.276,0.216,8430,2984
"9080",203517,2008,1,0,"Kent State University Kent Campus",NA,NA,3684,2261,1423,1135,325,810,0.358,0.308,0.228,8430,3039
"9081",203517,2009,1,0,"Kent State University Kent Campus",NA,NA,4003,2437,1566,1298,400,898,0.368,0.324,0.255,8726,3238
"9082",203517,2010,1,0,"Kent State University at Kent",NA,NA,3887,2325,1562,1243,396,847,0.364,0.32,0.254,9030,2931
"9083",203535,1991,1,0,"KENYON COLLEGE",NA,NA,420,218,202,347,167,180,0.826,0.826,0.827,16050,367
"9084",203535,1992,1,0,"KENYON COLLEGE",NA,NA,413,218,195,319,147,172,0.789,0.772,0.754,17060,363
"9085",203535,1993,1,0,"KENYON COLLEGE",NA,NA,408,231,177,316,129,187,0.809,0.775,0.729,18140,348
"9086",203535,1995,1,0,"KENYON COLLEGE",NA,NA,438,223,215,350,161,189,0.848,0.799,0.749,20270,380
"9087",203535,1996,1,0,"KENYON COLLEGE",NA,NA,423,238,185,338,147,191,0.802,0.799,0.795,21370,375
"9088",203535,1997,1,0,"KENYON COLLEGE",NA,NA,441,255,186,349,143,206,0.808,0.791,0.769,22200,394
"9089",203535,1998,1,0,"KENYON COLLEGE",NA,NA,451,252,199,369,156,213,0.845,0.818,0.784,22990,397
"9090",203535,1999,1,0,"KENYON COLLEGE",NA,NA,459,255,204,367,166,201,0.788,0.8,0.814,23900,403
"9091",203535,2000,1,0,"KENYON COLLEGE",NA,NA,436,227,209,371,168,203,0.894,0.851,0.804,25370,351
"9092",203535,2001,1,0,"KENYON COLLEGE",NA,NA,424,243,181,344,149,195,0.802,0.811,0.823,26800,347
"9093",203535,2002,1,0,"KENYON COLLEGE",NA,NA,440,246,194,376,158,218,0.886,0.855,0.814,27900,381
"9094",203535,2003,1,0,"KENYON COLLEGE",NA,NA,453,247,206,386,176,210,0.85,0.852,0.854,29500,387
"9095",203535,2004,1,0,"KENYON COLLEGE",NA,NA,467,237,230,396,189,207,0.873,0.848,0.822,31260,375
"9096",203535,2005,1,0,"Kenyon College",NA,NA,439,239,200,364,165,199,0.833,0.829,0.825,32980,372
"9097",203535,2006,1,0,"Kenyon College",NA,NA,457,226,231,397,190,207,0.916,0.869,0.823,34990,370
"9098",203535,2007,1,0,"Kenyon College",NA,NA,458,249,209,395,175,220,0.883,0.862,0.837,37030,366
"9099",203535,2008,1,0,"Kenyon College",NA,NA,455,237,218,404,192,212,0.895,0.888,0.881,39080,360
"9100",203535,2009,1,0,"Kenyon College",NA,NA,468,248,220,393,176,217,0.875,0.84,0.8,39810,355
"9101",203535,2010,1,0,"Kenyon College",NA,NA,483,265,218,429,191,238,0.898,0.888,0.876,39420,395
"9102",203580,1991,1,0,"LAKE ERIE COLLEGE",NA,NA,61,49,12,18,3,15,0.306,0.295,0.25,8480,59
"9103",203580,1992,1,0,"LAKE ERIE COLLEGE",NA,NA,36,29,7,14,1,13,0.448,0.389,0.143,8960,35
"9104",203580,1993,1,0,"LAKE ERIE COLLEGE",NA,NA,51,39,12,12,1,11,0.282,0.235,0.083,9600,47
"9105",203580,1995,1,0,"LAKE ERIE COLLEGE",NA,NA,66,50,16,26,5,21,0.42,0.394,0.312,12320,61
"9106",203580,1996,1,0,"LAKE ERIE COLLEGE",NA,NA,61,44,17,32,10,22,0.5,0.525,0.588,12950,56
"9107",203580,1997,1,0,"LAKE ERIE COLLEGE",NA,NA,70,47,23,29,13,16,0.34,0.414,0.565,13750,64
"9108",203580,1998,1,0,"LAKE ERIE COLLEGE",NA,NA,68,62,6,32,3,29,0.468,0.471,0.5,14298,65
"9109",203580,1999,1,0,"LAKE ERIE COLLEGE",NA,NA,103,70,33,36,8,28,0.4,0.35,0.242,14280,87
"9110",203580,2000,1,0,"LAKE ERIE COLLEGE",NA,NA,86,63,23,26,6,20,0.318,0.302,0.261,15140,79
"9111",203580,2001,1,0,"LAKE ERIE COLLEGE",NA,NA,127,98,29,46,7,39,0.398,0.362,0.241,15750,103
"9112",203580,2002,1,0,"LAKE ERIE COLLEGE",NA,NA,133,102,31,38,4,34,0.333,0.286,0.129,16370,113
"9113",203580,2003,1,0,"LAKE ERIE COLLEGE",NA,NA,120,86,34,41,13,28,0.326,0.342,0.382,16880,95
"9114",203580,2004,1,0,"LAKE ERIE COLLEGE",NA,NA,141,104,37,48,10,38,0.365,0.34,0.27,17724,115
"9115",203580,2005,1,0,"Lake Erie College",NA,NA,116,88,28,49,8,41,0.466,0.422,0.286,20500,94
"9116",203580,2006,1,0,"Lake Erie College",NA,NA,131,89,42,48,13,35,0.393,0.366,0.31,21936,112
"9117",203580,2007,1,0,"Lake Erie College",NA,NA,237,108,129,66,21,45,0.417,0.278,0.163,22814,194
"9118",203580,2008,1,0,"Lake Erie College",NA,NA,249,131,118,91,29,62,0.473,0.365,0.246,23950,206
"9119",203580,2009,1,0,"Lake Erie College",NA,NA,263,127,136,95,44,51,0.402,0.361,0.324,23950,201
"9120",203580,2010,1,0,"Lake Erie College",NA,NA,256,123,133,78,28,50,0.406,0.305,0.211,24308,204
"9121",203775,1991,1,0,"MALONE COLLEGE",NA,NA,312,206,106,89,21,68,0.33,0.285,0.198,7860,297
"9122",203775,1992,1,0,"MALONE COLLEGE",NA,NA,363,236,127,114,33,81,0.343,0.314,0.26,8490,352
"9123",203775,1993,1,0,"MALONE COLLEGE",NA,NA,427,218,209,110,34,76,0.349,0.258,0.163,9172,392
"9124",203775,1995,1,0,"MALONE COLLEGE",NA,NA,408,261,147,131,39,92,0.352,0.321,0.265,10345,390
"9125",203775,1996,1,0,"MALONE COLLEGE",NA,NA,400,234,166,141,41,100,0.427,0.352,0.247,10765,384
"9126",203775,1997,1,0,"MALONE COLLEGE",NA,NA,464,293,171,208,73,135,0.461,0.448,0.427,11280,446
"9127",203775,1998,1,0,"MALONE COLLEGE",NA,NA,398,235,163,153,56,97,0.413,0.384,0.344,11795,378
"9128",203775,1999,1,0,"MALONE COLLEGE",NA,NA,406,248,158,160,47,113,0.456,0.394,0.297,12150,388
"9129",203775,2000,1,0,"MALONE COLLEGE",NA,NA,388,240,148,157,49,108,0.45,0.405,0.331,12800,371
"9130",203775,2001,1,0,"MALONE COLLEGE",NA,NA,355,214,141,145,46,99,0.463,0.408,0.326,13310,335
"9131",203775,2002,1,0,"MALONE COLLEGE",NA,NA,348,219,129,148,54,94,0.429,0.425,0.419,13910,329
"9132",203775,2003,1,0,"MALONE COLLEGE",NA,NA,389,238,151,173,48,125,0.525,0.445,0.318,14745,369
"9133",203775,2004,1,0,"MALONE COLLEGE",NA,NA,400,239,161,181,53,128,0.536,0.452,0.329,15630,379
"9134",203775,2005,1,0,"Malone College",NA,NA,357,199,158,165,61,104,0.523,0.462,0.386,16530,323
"9135",203775,2006,1,0,"Malone College",NA,NA,341,208,133,159,58,101,0.486,0.466,0.436,17520,315
"9136",203775,2007,1,0,"Malone College",NA,NA,387,235,152,177,58,119,0.506,0.457,0.382,18600,365
"9137",203775,2008,1,0,"Malone University",NA,NA,389,233,156,147,44,103,0.442,0.378,0.282,19740,364
"9138",203775,2009,1,0,"Malone University",NA,NA,477,275,202,230,80,150,0.545,0.482,0.396,20730,432
"9139",203775,2010,1,0,"Malone University",NA,NA,375,196,179,167,68,99,0.505,0.445,0.38,21954,330
"9140",203845,1991,1,0,"MARIETTA COLLEGE",NA,NA,215,108,107,102,41,61,0.565,0.474,0.383,11800,206
"9141",203845,1992,1,0,"MARIETTA COLLEGE",NA,NA,370,150,220,165,82,83,0.553,0.446,0.373,12370,360
"9142",203845,1993,1,0,"MARIETTA COLLEGE",NA,NA,342,145,197,174,84,90,0.621,0.509,0.426,13170,324
"9143",203845,1995,1,0,"MARIETTA COLLEGE",NA,NA,292,120,172,124,51,73,0.608,0.425,0.297,14850,231
"9144",203845,1996,1,0,"MARIETTA COLLEGE",NA,NA,271,111,160,110,50,60,0.54,0.406,0.312,15490,239
"9145",203845,1997,1,0,"MARIETTA COLLEGE",NA,NA,331,163,168,157,72,85,0.521,0.474,0.429,15950,284
"9146",203845,1998,1,0,"MARIETTA COLLEGE",NA,NA,338,177,161,146,46,100,0.565,0.432,0.286,16790,294
"9147",203845,1999,1,0,"MARIETTA COLLEGE",NA,NA,302,136,166,149,70,79,0.581,0.493,0.422,17310,244
"9148",203845,2000,1,0,"MARIETTA COLLEGE",NA,NA,303,141,162,154,75,79,0.56,0.508,0.463,18010,262
"9149",203845,2001,1,0,"MARIETTA COLLEGE",NA,NA,362,151,211,164,77,87,0.576,0.453,0.365,18838,300
"9150",203845,2002,1,0,"MARIETTA COLLEGE",NA,NA,263,129,134,120,49,71,0.55,0.456,0.366,19762,231
"9151",203845,2003,1,0,"MARIETTA COLLEGE",NA,NA,376,168,208,160,70,90,0.536,0.426,0.337,20356,328
"9152",203845,2004,1,0,"MARIETTA COLLEGE",NA,NA,439,215,224,200,78,122,0.567,0.456,0.348,21170,365
"9153",203845,2005,1,0,"Marietta College",NA,NA,387,179,208,162,68,94,0.525,0.419,0.327,22070,309
"9154",203845,2006,1,0,"Marietta College",NA,NA,385,191,194,206,83,123,0.644,0.535,0.428,23200,315
"9155",203845,2007,1,0,"Marietta College",NA,NA,415,201,214,182,75,107,0.532,0.439,0.35,24220,308
"9156",203845,2008,1,0,"Marietta College",NA,NA,385,178,207,201,95,106,0.596,0.522,0.459,25430,308
"9157",203845,2009,1,0,"Marietta College",NA,NA,386,178,208,218,109,109,0.612,0.565,0.524,26386,290
"9158",203845,2010,1,0,"Marietta College",NA,NA,387,191,196,199,85,114,0.597,0.514,0.434,27640,276
"9159",204024,1991,1,0,"MIAMI UNIVERSITY OXFORD CAMPUS",NA,NA,3241,1858,1383,2040,736,1304,0.702,0.629,0.532,3692,3053
"9160",204024,1992,1,0,"MIAMI UNIVERSITY OXFORD CAMPUS",NA,NA,2985,1653,1332,1815,700,1115,0.674,0.608,0.526,4024,2779
"9161",204024,1993,1,0,"MIAMI UNIVERSITY-OXFORD",NA,NA,3264,1782,1482,1948,739,1209,0.678,0.597,0.499,4226,3021
"9162",204024,1995,1,0,"MIAMI UNIVERSITY-OXFORD",NA,NA,3211,1817,1394,1990,750,1240,0.682,0.62,0.538,4810,2896
"9163",204024,1996,1,0,"MIAMI UNIVERSITY-OXFORD",NA,NA,3342,1935,1407,2180,798,1382,0.714,0.652,0.567,5158,2984
"9164",204024,1997,1,0,"MIAMI UNIVERSITY-OXFORD",NA,NA,3379,1914,1465,2180,855,1325,0.692,0.645,0.584,5466,3039
"9165",204024,1998,1,0,"MIAMI UNIVERSITY-OXFORD",NA,NA,3332,1904,1428,2182,856,1326,0.696,0.655,0.599,5786,2983
"9166",204024,1999,1,0,"MIAMI UNIVERSITY-OXFORD",NA,NA,3588,2030,1558,2351,922,1429,0.704,0.655,0.592,5052,3185
"9167",204024,2000,1,0,"MIAMI UNIVERSITY-OXFORD",NA,NA,3359,1947,1412,2271,870,1401,0.72,0.676,0.616,5358,2973
"9168",204024,2001,1,0,"MIAMI UNIVERSITY-OXFORD",NA,NA,3440,1922,1518,2305,905,1400,0.728,0.67,0.596,5796,3005
"9169",204024,2002,1,0,"MIAMI UNIVERSITY-OXFORD",NA,NA,3614,1998,1616,2461,1008,1453,0.727,0.681,0.624,6386,3168
"9170",204024,2003,1,0,"MIAMI UNIVERSITY-OXFORD",NA,NA,3362,1844,1518,2371,1002,1369,0.742,0.705,0.66,7019,2927
"9171",204024,2004,1,0,"MIAMI UNIVERSITY-OXFORD",NA,NA,3475,1950,1525,2354,961,1393,0.714,0.677,0.63,18236,2900
"9172",204024,2005,1,0,"Miami University-Oxford",NA,NA,3150,1708,1442,2198,902,1296,0.759,0.698,0.626,19877,2679
"9173",204024,2006,1,0,"Miami University-Oxford",NA,NA,3630,2017,1613,2472,1010,1462,0.725,0.681,0.626,20991,3155
"9174",204024,2007,1,0,"Miami University-Oxford",NA,NA,3456,1902,1554,2359,968,1391,0.731,0.683,0.623,8443,2985
"9175",204024,2008,1,0,"Miami University-Oxford",NA,NA,3598,1955,1643,2357,959,1398,0.715,0.655,0.584,8178,3052
"9176",204024,2009,1,0,"Miami University-Oxford",NA,NA,3219,1745,1474,2104,855,1249,0.716,0.654,0.58,10122,2686
"9177",204024,2010,1,0,"Miami University-Oxford",NA,NA,3574,1944,1630,2368,969,1399,0.72,0.663,0.594,10427,3029
"9178",204185,1991,1,0,"MOUNT UNION COLLEGE",NA,NA,417,194,223,189,80,109,0.562,0.453,0.359,11320,374
"9179",204185,1992,1,0,"MOUNT UNION COLLEGE",NA,NA,380,178,202,170,73,97,0.545,0.447,0.361,11200,340
"9180",204185,1993,1,0,"MOUNT UNION COLLEGE",NA,NA,396,194,202,197,89,108,0.557,0.497,0.441,12320,370
"9181",204185,1995,1,0,"MOUNT UNION COLLEGE",NA,NA,478,229,249,248,107,141,0.616,0.519,0.43,13480,445
"9182",204185,1996,1,0,"MOUNT UNION COLLEGE",NA,NA,483,217,266,254,113,141,0.65,0.526,0.425,13880,451
"9183",204185,1997,1,0,"MOUNT UNION COLLEGE",NA,NA,540,297,243,306,113,193,0.65,0.567,0.465,14290,517
"9184",204185,1998,1,0,"MOUNT UNION COLLEGE",NA,NA,568,289,279,318,116,202,0.699,0.56,0.416,14480,533
"9185",204185,1999,1,0,"MOUNT UNION COLLEGE",NA,NA,601,323,278,292,86,206,0.638,0.486,0.309,14080,545
"9186",204185,2000,1,0,"MOUNT UNION COLLEGE",NA,NA,555,315,240,277,93,184,0.584,0.499,0.388,14720,516
"9187",204185,2001,1,0,"MOUNT UNION COLLEGE",NA,NA,591,329,262,298,89,209,0.635,0.504,0.34,15440,548
"9188",204185,2002,1,0,"MOUNT UNION COLLEGE",NA,NA,579,299,280,299,115,184,0.615,0.516,0.411,16240,511
"9189",204185,2003,1,0,"MOUNT UNION COLLEGE",NA,NA,579,276,303,287,114,173,0.627,0.496,0.376,16900,548
"9190",204185,2004,1,0,"MOUNT UNION COLLEGE",NA,NA,547,256,291,292,128,164,0.641,0.534,0.44,18560,486
"9191",204185,2005,1,0,"Mount Union College",NA,NA,503,260,243,274,104,170,0.654,0.545,0.428,19600,458
"9192",204185,2006,1,0,"Mount Union College",NA,NA,636,284,352,343,149,194,0.683,0.539,0.423,20720,548
"9193",204185,2007,1,0,"Mount Union College",NA,NA,593,282,311,316,130,186,0.66,0.533,0.418,21800,502
"9194",204185,2008,1,0,"Mount Union College",NA,NA,663,321,342,336,126,210,0.654,0.507,0.368,22870,539
"9195",204185,2009,1,0,"Mount Union College",NA,NA,578,286,292,315,124,191,0.668,0.545,0.425,23630,464
"9196",204185,2010,1,0,"University of Mount Union",NA,NA,630,261,369,333,151,182,0.697,0.529,0.409,24500,523
"9197",204194,1991,1,0,"MOUNT VERNON NAZARENE COLLEGE",NA,NA,231,145,86,82,31,51,0.352,0.355,0.36,5750,222
"9198",204194,1992,1,0,"MOUNT VERNON NAZARENE COLLEGE",NA,NA,283,168,115,86,36,50,0.298,0.304,0.313,6230,274
"9199",204194,1993,1,0,"MOUNT VERNON NAZARENE COLLEGE",NA,NA,335,201,134,108,35,73,0.363,0.322,0.261,7190,330
"9200",204194,1995,1,0,"MOUNT VERNON NAZARENE COLLEGE",NA,NA,379,228,151,121,51,70,0.307,0.319,0.338,8590,366
"9201",204194,1996,1,0,"MOUNT VERNON NAZARENE COLLEGE",NA,NA,407,252,155,154,43,111,0.44,0.378,0.277,9240,388
"9202",204194,1997,1,0,"MOUNT VERNON NAZARENE COLLEGE",NA,NA,333,195,138,119,45,74,0.38,0.357,0.326,9430,325
"9203",204194,1998,1,0,"MOUNT VERNON NAZARENE COLLEGE",NA,NA,345,205,140,141,44,97,0.473,0.409,0.314,10124,335
"9204",204194,1999,1,0,"MOUNT VERNON NAZARENE COLLEGE",NA,NA,393,231,162,145,49,96,0.416,0.369,0.302,10792,375
"9205",204194,2000,1,0,"MOUNT VERNON NAZARENE COLLEGE",NA,NA,365,228,137,139,39,100,0.439,0.381,0.285,11468,343
"9206",204194,2001,1,0,"MOUNT VERNON NAZARENE COLLEGE",NA,NA,321,176,145,110,34,76,0.432,0.343,0.234,12122,310
"9207",204194,2002,1,0,"MOUNT VERNON NAZARENE UNIVERSITY",NA,NA,332,203,129,129,48,81,0.399,0.389,0.372,12810,315
"9208",204194,2003,1,0,"MOUNT VERNON NAZARENE UNIVERSITY",NA,NA,373,221,152,137,51,86,0.389,0.367,0.336,13794,357
"9209",204194,2004,1,0,"MOUNT VERNON NAZARENE UNIVERSITY",NA,NA,303,184,119,130,44,86,0.467,0.429,0.37,14482,292
"9210",204194,2005,1,0,"Mount Vernon Nazarene University",NA,NA,380,241,139,149,49,100,0.415,0.392,0.353,15384,355
"9211",204194,2006,1,0,"Mount Vernon Nazarene University",NA,NA,346,201,145,160,66,94,0.468,0.462,0.455,16366,324
"9212",204194,2007,1,0,"Mount Vernon Nazarene University",NA,NA,350,210,140,171,56,115,0.548,0.489,0.4,17544,334
"9213",204194,2008,1,0,"Mount Vernon Nazarene University",NA,NA,368,234,134,183,66,117,0.5,0.497,0.493,18770,348
"9214",204194,2009,1,0,"Mount Vernon Nazarene University",NA,NA,300,190,110,172,61,111,0.584,0.573,0.555,19730,278
"9215",204194,2010,1,0,"Mount Vernon Nazarene University",NA,NA,388,240,148,217,83,134,0.558,0.559,0.561,20700,355
"9216",204617,1991,1,0,"OHIO DOMINICAN COLLEGE",NA,NA,205,108,97,54,24,30,0.278,0.263,0.247,7020,132
"9217",204617,1992,1,0,"OHIO DOMINICAN COLLEGE",NA,NA,208,121,87,56,19,37,0.306,0.269,0.218,7370,141
"9218",204617,1993,1,0,"OHIO DOMINICAN COLLEGE",NA,NA,225,123,102,61,16,45,0.366,0.271,0.157,7730,153
"9219",204617,1995,1,0,"OHIO DOMINICAN COLLEGE",NA,NA,172,110,62,46,12,34,0.309,0.267,0.194,8490,119
"9220",204617,1996,1,0,"OHIO DOMINICAN COLLEGE",NA,NA,180,113,67,52,11,41,0.363,0.289,0.164,8910,135
"9221",204617,1997,1,0,"OHIO DOMINICAN COLLEGE",NA,NA,180,101,79,65,18,47,0.465,0.361,0.228,9350,143
"9222",204617,1998,1,0,"OHIO DOMINICAN COLLEGE",NA,NA,184,118,66,73,18,55,0.466,0.397,0.273,9790,142
"9223",204617,1999,1,0,"OHIO DOMINICAN COLLEGE",NA,NA,186,120,66,68,16,52,0.433,0.366,0.242,10250,129
"9224",204617,2000,1,0,"OHIO DOMINICAN COLLEGE",NA,NA,179,118,61,48,15,33,0.28,0.268,0.246,10710,120
"9225",204617,2001,1,0,"OHIO DOMINICAN COLLEGE",NA,NA,174,116,58,51,18,33,0.284,0.293,0.31,12530,133
"9226",204617,2002,1,0,"OHIO DOMINICAN UNIVERSITY",NA,NA,251,163,88,94,34,60,0.368,0.375,0.386,16200,199
"9227",204617,2003,1,0,"OHIO DOMINICAN UNIVERSITY",NA,NA,296,191,105,88,27,61,0.319,0.297,0.257,17200,221
"9228",204617,2004,1,0,"OHIO DOMINICAN UNIVERSITY",NA,NA,415,202,213,143,57,86,0.426,0.345,0.268,18000,349
"9229",204617,2005,1,0,"Ohio Dominican University",NA,NA,372,172,200,129,65,64,0.372,0.347,0.325,19400,298
"9230",204617,2006,1,0,"Ohio Dominican University",NA,NA,354,177,177,107,51,56,0.316,0.302,0.288,20500,258
"9231",204617,2007,1,0,"Ohio Dominican University",NA,NA,391,207,184,112,48,64,0.309,0.286,0.261,21720,307
"9232",204617,2008,1,0,"Ohio Dominican University",NA,NA,356,194,162,113,49,64,0.33,0.317,0.302,22990,266
"9233",204617,2009,1,0,"Ohio Dominican University",NA,NA,274,143,131,98,40,58,0.406,0.358,0.305,24116,201
"9234",204617,2010,1,0,"Ohio Dominican University",NA,NA,272,146,126,78,30,48,0.329,0.287,0.238,24780,163
"9235",204796,1991,0,1,"OHIO STATE UNIVERSITY-MAIN CAMPUS",9999,0,5502,2705,2797,1061,375,686,0.254,0.193,0.134,2568,4641
"9236",204796,1992,0,1,"OHIO STATE UNIVERSITY-MAIN CAMPUS",9999,0,5389,2625,2764,1024,351,673,0.256,0.19,0.127,2799,4458
"9237",204796,1993,0,1,"OHIO STATE UNIVERSITY-MAIN CAMPUS",9999,0,5283,2710,2573,1074,371,703,0.259,0.203,0.144,2940,4340
"9238",204796,1995,0,1,"OHIO STATE UNIVERSITY-MAIN CAMPUS",9999,0,5788,2951,2837,1354,478,876,0.297,0.234,0.168,3273,4696
"9239",204796,1996,0,1,"OHIO STATE UNIVERSITY-MAIN CAMPUS",9999,0,6027,3018,3009,1526,565,961,0.318,0.253,0.188,3468,4920
"9240",204796,1997,0,1,"OHIO STATE UNIVERSITY-MAIN CAMPUS",9999,0,5897,3081,2816,1719,555,1164,0.378,0.292,0.197,3687,4671
"9241",204796,1998,0,1,"OHIO STATE UNIVERSITY-MAIN CAMPUS",9999,0,6151,3177,2974,1886,610,1276,0.402,0.307,0.205,3906,4950
"9242",204796,1999,0,1,"OHIO STATE UNIVERSITY-MAIN CAMPUS",9999,0,6067,3029,3038,2120,777,1343,0.443,0.349,0.256,3780,4806
"9243",204796,2000,0,1,"OHIO STATE UNIVERSITY-MAIN CAMPUS",9999,0,5831,3008,2823,2282,851,1431,0.476,0.391,0.301,4005,4584
"9244",204796,2001,0,1,"OHIO STATE UNIVERSITY-MAIN CAMPUS",9999,0,5955,2935,3020,2381,906,1475,0.503,0.4,0.3,4410,4568
"9245",204796,2002,0,1,"OHIO STATE UNIVERSITY-MAIN CAMPUS",9999,0,5936,2945,2991,2511,989,1522,0.517,0.423,0.331,5304,4606
"9246",204796,2003,0,1,"OHIO STATE UNIVERSITY-MAIN CAMPUS",9999,0,6347,3201,3146,2938,1132,1806,0.564,0.463,0.36,6228,5067
"9247",204796,2004,0,1,"OHIO STATE UNIVERSITY-MAIN CAMPUS",9999,0,6031,2891,3140,2930,1241,1689,0.584,0.486,0.395,7077,4917
"9248",204796,2005,0,1,"Ohio State University-Main Campus",9999,0,5929,3005,2924,3032,1219,1813,0.603,0.511,0.417,7509,4783
"9249",204796,2006,0,1,"Ohio State University-Main Campus",9999,0,6262,3104,3158,3295,1373,1922,0.619,0.526,0.435,7983,5059
"9250",204796,2007,0,1,"Ohio State University-Main Campus",9999,0,6155,3039,3116,3602,1534,2068,0.68,0.585,0.492,7983,4978
"9251",204796,2008,0,1,"Ohio State University-Main Campus",9999,0,6151,3068,3083,3780,1643,2137,0.697,0.615,0.533,7983,4905
"9252",204796,2009,0,1,"Ohio State University-Main Campus",9999,0,6724,3237,3487,3935,1699,2236,0.691,0.585,0.487,7983,5297
"9253",204796,2010,0,1,"Ohio State University-Main Campus",9999,0,6651,3319,3332,3907,1657,2250,0.678,0.587,0.497,8541,4981
"9254",204857,1991,0,1,"OHIO UNIVERSITY MAIN CAMPUS",9999,0,3187,1819,1368,1308,448,860,0.473,0.41,0.327,2967,2927
"9255",204857,1992,0,1,"OHIO UNIVERSITY MAIN CAMPUS",9999,0,3235,1952,1283,1396,427,969,0.496,0.432,0.333,3234,2985
"9256",204857,1993,0,1,"OHIO UNIVERSITY MAIN CAMPUS",9999,0,3148,1782,1366,1297,433,864,0.485,0.412,0.317,3384,2940
"9257",204857,1995,0,1,"OHIO UNIVERSITY MAIN CAMPUS",9999,0,3358,1939,1419,1459,479,980,0.505,0.434,0.338,3666,3114
"9258",204857,1996,0,1,"OHIO UNIVERSITY MAIN CAMPUS",9999,0,3123,1832,1291,1390,446,944,0.515,0.445,0.345,4080,2922
"9259",204857,1997,0,1,"OHIO UNIVERSITY-MAIN CAMPUS",9999,0,3255,1913,1342,1401,427,974,0.509,0.43,0.318,4275,3045
"9260",204857,1998,0,1,"OHIO UNIVERSITY-MAIN CAMPUS",9999,0,3369,1988,1381,1489,480,1009,0.508,0.442,0.348,4530,3123
"9261",204857,1999,0,1,"OHIO UNIVERSITY-MAIN CAMPUS",9999,0,3389,1977,1412,1553,490,1063,0.538,0.458,0.347,4800,3201
"9262",204857,2000,0,1,"OHIO UNIVERSITY-MAIN CAMPUS",9999,0,3586,2041,1545,1693,588,1105,0.541,0.472,0.381,5085,3359
"9263",204857,2001,0,1,"OHIO UNIVERSITY-MAIN CAMPUS",9999,0,3697,2200,1497,1778,594,1184,0.538,0.481,0.397,5493,3490
"9264",204857,2002,0,1,"OHIO UNIVERSITY-MAIN CAMPUS",9999,0,3628,2068,1560,1832,670,1162,0.562,0.505,0.429,6336,3406
"9265",204857,2003,0,1,"OHIO UNIVERSITY-MAIN CAMPUS",9999,0,3587,2026,1561,1722,638,1084,0.535,0.48,0.409,7128,3359
"9266",204857,2004,0,1,"OHIO UNIVERSITY-MAIN CAMPUS",9999,0,3734,2050,1684,1703,616,1087,0.53,0.456,0.366,7770,3498
"9267",204857,2005,0,1,"Ohio University-Main Campus",9999,0,4078,2148,1930,1788,697,1091,0.508,0.438,0.361,8235,3744
"9268",204857,2006,0,1,"Ohio University-Main Campus",9999,0,4009,2063,1946,1766,693,1073,0.52,0.441,0.356,8727,3668
"9269",204857,2007,0,1,"Ohio University-Main Campus",9999,0,3970,2059,1911,1902,781,1121,0.544,0.479,0.409,8907,3571
"9270",204857,2008,0,1,"Ohio University-Main Campus",9999,0,3908,2114,1794,1910,769,1141,0.54,0.489,0.429,8907,3457
"9271",204857,2009,0,1,"Ohio University-Main Campus",9999,0,4052,2217,1835,1954,702,1252,0.565,0.482,0.383,8973,3591
"9272",204857,2010,0,1,"Ohio University-Main Campus",9999,0,3949,2129,1820,1799,689,1110,0.521,0.456,0.379,9603,3476
"9273",206330,1991,1,0,"URBANA UNIVERSITY",NA,NA,188,66,122,16,9,7,0.106,0.085,0.074,7155,122
"9274",206330,1992,1,0,"URBANA UNIVERSITY",NA,NA,148,48,100,15,7,8,0.167,0.101,0.07,8075,95
"9275",206330,1993,1,0,"URBANA UNIVERSITY",NA,NA,200,61,139,33,15,18,0.295,0.165,0.108,9025,131
"9276",206330,1995,1,0,"URBANA UNIVERSITY",NA,NA,213,87,126,28,12,16,0.184,0.131,0.095,9454,140
"9277",206330,1996,1,0,"URBANA UNIVERSITY",NA,NA,235,94,141,31,12,19,0.202,0.132,0.085,9824,166
"9278",206330,1997,1,0,"URBANA UNIVERSITY",NA,NA,96,40,56,12,4,8,0.2,0.125,0.071,10172,75
"9279",206330,1998,1,0,"URBANA UNIVERSITY",NA,NA,143,68,75,37,13,24,0.353,0.259,0.173,10530,109
"9280",206330,1999,1,0,"URBANA UNIVERSITY",NA,NA,121,40,81,45,20,25,0.625,0.372,0.247,10846,104
"9281",206330,2000,1,0,"URBANA UNIVERSITY",NA,NA,215,84,131,38,19,19,0.226,0.177,0.145,11388,165
"9282",206330,2001,1,0,"URBANA UNIVERSITY",NA,NA,202,67,135,42,19,23,0.343,0.208,0.141,11844,142
"9283",206330,2002,1,0,"URBANA UNIVERSITY",NA,NA,150,51,99,22,11,11,0.216,0.147,0.111,12820,114
"9284",206330,2003,1,0,"URBANA UNIVERSITY",NA,NA,216,72,144,27,6,21,0.292,0.125,0.042,13540,161
"9285",206330,2004,1,0,"URBANA UNIVERSITY",NA,NA,177,70,107,38,18,20,0.286,0.215,0.168,14220,151
"9286",206330,2005,1,0,"Urbana University",NA,NA,240,74,166,51,27,24,0.324,0.212,0.163,15050,204
"9287",206330,2006,1,0,"Urbana University",NA,NA,238,91,147,61,19,42,0.462,0.256,0.129,16254,199
"9288",206330,2007,1,0,"Urbana University",NA,NA,240,101,139,57,29,28,0.277,0.238,0.209,17544,171
"9289",206330,2008,1,0,"Urbana University",NA,NA,226,72,154,67,32,35,0.486,0.296,0.208,18960,128
"9290",206330,2009,1,0,"Urbana University",NA,NA,182,75,107,28,10,18,0.24,0.154,0.093,19600,132
"9291",206330,2010,1,0,"Urbana University",NA,NA,145,68,77,36,17,19,0.279,0.248,0.221,20188,86
"9292",206589,1991,1,0,"COLLEGE OF WOOSTER",NA,NA,466,219,247,290,135,155,0.708,0.622,0.547,13410,385
"9293",206589,1992,1,0,"COLLEGE OF WOOSTER",NA,NA,459,240,219,273,118,155,0.646,0.595,0.539,14380,377
"9294",206589,1993,1,0,"COLLEGE OF WOOSTER",NA,NA,548,291,257,346,139,207,0.711,0.631,0.541,15425,454
"9295",206589,1995,1,0,"COLLEGE OF WOOSTER",NA,NA,433,228,205,347,147,200,0.877,0.801,0.717,17600,381
"9296",206589,1996,1,0,"COLLEGE OF WOOSTER",NA,NA,516,255,261,302,136,166,0.651,0.585,0.521,18380,429
"9297",206589,1997,1,0,"COLLEGE OF WOOSTER",NA,NA,538,289,249,328,130,198,0.685,0.61,0.522,19230,448
"9298",206589,1998,1,0,"COLLEGE OF WOOSTER",NA,NA,504,259,245,335,147,188,0.726,0.665,0.6,19940,436
"9299",206589,1999,1,0,"COLLEGE OF WOOSTER",NA,NA,513,265,248,372,164,208,0.785,0.725,0.661,25950,432
"9300",206589,2000,1,0,"COLLEGE OF WOOSTER",NA,NA,501,258,243,331,137,194,0.752,0.661,0.564,21520,416
"9301",206589,2001,1,0,"COLLEGE OF WOOSTER",NA,NA,532,282,250,342,143,199,0.706,0.643,0.572,22282,438
"9302",206589,2002,1,0,"COLLEGE OF WOOSTER",NA,NA,514,281,233,354,140,214,0.762,0.689,0.601,23687,380
"9303",206589,2003,1,0,"COLLEGE OF WOOSTER",NA,NA,552,281,271,373,169,204,0.726,0.676,0.624,24885,416
"9304",206589,2004,1,0,"COLLEGE OF WOOSTER",NA,NA,478,239,239,334,147,187,0.782,0.699,0.615,26380,361
"9305",206589,2005,1,0,"The College of Wooster",NA,NA,536,267,269,362,158,204,0.764,0.675,0.587,28030,431
"9306",206589,2006,1,0,"The College of Wooster",NA,NA,494,242,252,345,163,182,0.752,0.698,0.647,29840,358
"9307",206589,2007,1,0,"The College of Wooster",NA,NA,545,287,258,384,159,225,0.784,0.705,0.616,31630,395
"9308",206589,2008,1,0,"The College of Wooster",NA,NA,518,267,251,364,160,204,0.764,0.703,0.637,33520,351
"9309",206589,2009,1,0,"The College of Wooster",NA,NA,479,264,215,371,154,217,0.822,0.775,0.716,34690,327
"9310",206589,2010,1,0,"The College of Wooster",NA,NA,617,332,285,436,180,256,0.771,0.707,0.632,36320,432
"9311",206604,1991,0,1,"WRIGHT STATE UNIVERSITY MAIN CAMPUS",9999,0,2111,1061,1050,199,66,133,0.125,0.094,0.063,2674,1860
"9312",206604,1992,0,1,"WRIGHT STATE UNIVERSITY MAIN CAMPUS",9999,0,1941,1028,913,159,42,117,0.114,0.082,0.046,2934,1672
"9313",206604,1993,0,1,"WRIGHT STATE UNIVERSITY-MAIN CAMPUS",9999,0,2002,1045,957,190,73,117,0.112,0.095,0.076,3084,1658
"9314",206604,1995,0,1,"WRIGHT STATE UNIVERSITY-MAIN CAMPUS",9999,0,1910,1033,877,214,68,146,0.141,0.112,0.078,3429,1586
"9315",206604,1996,0,1,"WRIGHT STATE UNIVERSITY-MAIN CAMPUS",9999,0,1859,995,864,281,78,203,0.204,0.151,0.09,3600,1514
"9316",206604,1997,0,1,"WRIGHT STATE UNIVERSITY-MAIN CAMPUS",9999,0,2025,1103,922,336,126,210,0.19,0.166,0.137,3708,1605
"9317",206604,1998,0,1,"WRIGHT STATE UNIVERSITY-MAIN CAMPUS",9999,0,2101,1178,923,354,109,245,0.208,0.168,0.118,3930,1638
"9318",206604,1999,0,1,"WRIGHT STATE UNIVERSITY-MAIN CAMPUS",9999,0,2127,1202,925,352,99,253,0.211,0.165,0.107,4128,1617
"9319",206604,2000,0,1,"WRIGHT STATE UNIVERSITY-MAIN CAMPUS",9999,0,2124,1217,907,403,117,286,0.235,0.19,0.129,4335,1709
"9320",206604,2001,0,1,"WRIGHT STATE UNIVERSITY-MAIN CAMPUS",9999,0,2117,1165,952,373,129,244,0.209,0.176,0.136,4596,1709
"9321",206604,2002,0,1,"WRIGHT STATE UNIVERSITY-MAIN CAMPUS",9999,0,2169,1225,944,407,128,279,0.228,0.188,0.136,5262,1732
"9322",206604,2003,0,1,"WRIGHT STATE UNIVERSITY-MAIN CAMPUS",9999,0,2272,1312,960,78,16,62,0.047,0.034,0.017,5682,1739
"9323",206604,2004,0,1,"WRIGHT STATE UNIVERSITY-MAIN CAMPUS",9999,0,2289,1302,987,418,156,262,0.201,0.183,0.158,6245,1665
"9324",206604,2005,0,1,"Wright State University-Main Campus",9999,0,2302,1331,971,413,141,272,0.204,0.179,0.145,6619,1717
"9325",206604,2006,0,1,"Wright State University-Main Campus",9999,0,2178,1211,967,422,155,267,0.22,0.194,0.16,7018,1629
"9326",206604,2007,0,1,"Wright State University-Main Campus",9999,0,2371,1339,1032,447,160,287,0.214,0.189,0.155,7018,1726
"9327",206604,2008,0,1,"Wright State University-Main Campus",9999,0,2596,1496,1100,556,193,363,0.243,0.214,0.175,7018,1866
"9328",206604,2009,0,1,"Wright State University-Main Campus",9999,0,2463,1378,1085,515,196,319,0.231,0.209,0.181,7263,1790
"9329",206604,2010,0,1,"Wright State University-Main Campus",9999,0,2739,1586,1153,527,197,330,0.208,0.192,0.171,7518,1877
"9330",206622,1991,1,0,"XAVIER UNIVERSITY",NA,NA,719,380,339,383,193,190,0.5,0.533,0.569,9700,634
"9331",206622,1992,1,0,"XAVIER UNIVERSITY",NA,NA,672,331,341,345,166,179,0.541,0.513,0.487,10450,592
"9332",206622,1993,1,0,"XAVIER UNIVERSITY",NA,NA,696,381,315,368,170,198,0.52,0.529,0.54,10970,623
"9333",206622,1995,1,0,"XAVIER UNIVERSITY",NA,NA,698,396,302,394,177,217,0.548,0.564,0.586,12270,628
"9334",206622,1996,1,0,"XAVIER UNIVERSITY",NA,NA,778,461,317,458,184,274,0.594,0.589,0.58,12950,697
"9335",206622,1997,1,0,"XAVIER UNIVERSITY",NA,NA,757,439,318,512,220,292,0.665,0.676,0.692,13650,675
"9336",206622,1998,1,0,"XAVIER UNIVERSITY",NA,NA,831,483,348,541,227,314,0.65,0.651,0.652,14400,755
"9337",206622,1999,1,0,"XAVIER UNIVERSITY",NA,NA,771,464,307,540,213,327,0.705,0.7,0.694,14950,681
"9338",206622,2000,1,0,"XAVIER UNIVERSITY",NA,NA,776,436,340,515,223,292,0.67,0.664,0.656,15680,678
"9339",206622,2001,1,0,"XAVIER UNIVERSITY",NA,NA,795,426,369,555,249,306,0.718,0.698,0.675,16540,708
"9340",206622,2002,1,0,"XAVIER UNIVERSITY",NA,NA,757,424,333,518,224,294,0.693,0.684,0.673,17780,659
"9341",206622,2003,1,0,"XAVIER UNIVERSITY",NA,NA,786,428,358,526,230,296,0.692,0.669,0.642,18850,672
"9342",206622,2004,1,0,"XAVIER UNIVERSITY",NA,NA,878,470,408,611,268,343,0.73,0.696,0.657,20100,725
"9343",206622,2005,1,0,"Xavier University",NA,NA,765,430,335,523,206,317,0.737,0.684,0.615,21850,607
"9344",206622,2006,1,0,"Xavier University",NA,NA,812,459,353,574,244,330,0.719,0.707,0.691,23270,654
"9345",206622,2007,1,0,"Xavier University",NA,NA,858,447,411,572,268,304,0.68,0.667,0.652,23990,706
"9346",206622,2008,1,0,"Xavier University",NA,NA,859,436,423,542,244,298,0.683,0.631,0.577,26250,686
"9347",206622,2009,1,0,"Xavier University",NA,NA,1178,637,541,779,352,427,0.67,0.661,0.651,27900,1019
"9348",206622,2010,1,0,"Xavier University",NA,NA,1042,554,488,641,298,343,0.619,0.615,0.611,29300,836
"9349",206695,1991,0,1,"YOUNGSTOWN STATE UNIVERSITY",2000,0,1904,981,923,88,31,57,0.058,0.046,0.034,2415,1665
"9350",206695,1992,0,1,"YOUNGSTOWN STATE UNIVERSITY",2000,0,1908,962,946,129,59,70,0.073,0.068,0.062,2640,1649
"9351",206695,1993,0,1,"YOUNGSTOWN STATE UNIVERSITY",2000,0,1967,1005,962,180,78,102,0.102,0.092,0.081,2772,1708
"9352",206695,1995,0,1,"YOUNGSTOWN STATE UNIVERSITY",2000,0,1905,1004,901,208,85,123,0.122,0.109,0.094,3084,1661
"9353",206695,1996,0,1,"YOUNGSTOWN STATE UNIVERSITY",2000,0,1685,859,826,212,88,124,0.144,0.126,0.107,3336,1429
"9354",206695,1997,0,1,"YOUNGSTOWN STATE UNIVERSITY",2000,0,1764,924,840,231,85,146,0.158,0.131,0.101,3558,1480
"9355",206695,1998,0,1,"YOUNGSTOWN STATE UNIVERSITY",2000,0,1839,954,885,250,81,169,0.177,0.136,0.092,3762,1553
"9356",206695,1999,0,1,"YOUNGSTOWN STATE UNIVERSITY",2000,0,1911,954,957,241,89,152,0.159,0.126,0.093,3783,1580
"9357",206695,2000,1,0,"YOUNGSTOWN STATE UNIVERSITY",2000,1,1853,943,910,220,95,125,0.133,0.119,0.104,3876,1563
"9358",206695,2001,1,0,"YOUNGSTOWN STATE UNIVERSITY",2000,1,1951,1041,910,243,81,162,0.156,0.125,0.089,4083,1566
"9359",206695,2002,1,0,"YOUNGSTOWN STATE UNIVERSITY",2000,1,1944,1058,886,234,76,158,0.149,0.12,0.086,4868,1548
"9360",206695,2003,1,0,"YOUNGSTOWN STATE UNIVERSITY",2000,1,1976,1048,928,207,73,134,0.128,0.105,0.079,4320,1574
"9361",206695,2004,1,0,"YOUNGSTOWN STATE UNIVERSITY",2000,1,2025,1081,944,247,91,156,0.144,0.122,0.096,4647,1561
"9362",206695,2005,1,0,"Youngstown State University",2000,1,2012,1029,983,177,61,116,0.113,0.088,0.062,5000,1503
"9363",206695,2006,1,0,"Youngstown State University",2000,1,2169,1095,1074,187,74,113,0.103,0.086,0.069,5364,1589
"9364",206695,2007,1,0,"Youngstown State University",2000,1,2140,1101,1039,168,70,98,0.089,0.079,0.067,5364,1487
"9365",206695,2008,1,0,"Youngstown State University",2000,1,2189,1090,1099,199,74,125,0.115,0.091,0.067,5364,1579
"9366",206695,2009,1,0,"Youngstown State University",2000,1,2564,1306,1258,240,111,129,0.099,0.094,0.088,6727,1755
"9367",206695,2010,1,0,"Youngstown State University",2000,1,2633,1330,1303,250,122,128,0.096,0.095,0.094,6970,1803
"9368",206914,1991,1,0,"CAMERON UNIVERSITY",NA,NA,466,220,246,23,9,14,0.064,0.049,0.037,1377,329
"9369",206914,1992,1,0,"CAMERON UNIVERSITY",NA,NA,577,323,254,27,6,21,0.065,0.047,0.024,1377,394
"9370",206914,1993,1,0,"CAMERON UNIVERSITY",NA,NA,626,350,276,54,26,28,0.08,0.086,0.094,1510,447
"9371",206914,1995,1,0,"CAMERON UNIVERSITY",NA,NA,620,358,262,61,26,35,0.098,0.098,0.099,1362,435
"9372",206914,1996,1,0,"CAMERON UNIVERSITY",NA,NA,616,353,263,63,25,38,0.108,0.102,0.095,1759,441
"9373",206914,1997,1,0,"CAMERON UNIVERSITY",NA,NA,615,322,293,50,21,29,0.09,0.081,0.072,1872,424
"9374",206914,1998,1,0,"CAMERON UNIVERSITY",NA,NA,590,327,263,35,13,22,0.067,0.059,0.049,1895,406
"9375",206914,1999,1,0,"CAMERON UNIVERSITY",NA,NA,673,355,318,54,16,38,0.107,0.08,0.05,1470,430
"9376",206914,2000,1,0,"CAMERON UNIVERSITY",NA,NA,620,339,281,68,24,44,0.13,0.11,0.085,1470,367
"9377",206914,2001,1,0,"CAMERON UNIVERSITY",NA,NA,673,355,318,55,16,39,0.11,0.082,0.05,1572,430
"9378",206914,2002,1,0,"CAMERON UNIVERSITY",NA,NA,583,330,253,39,17,22,0.067,0.067,0.067,1682,372
"9379",206914,2003,1,0,"CAMERON UNIVERSITY",NA,NA,667,375,292,34,15,19,0.051,0.051,0.051,1950,385
"9380",206914,2004,1,0,"CAMERON UNIVERSITY",NA,NA,762,409,353,31,10,21,0.051,0.041,0.028,2100,466
"9381",206914,2005,1,0,"Cameron University",NA,NA,714,430,284,37,22,15,0.035,0.052,0.077,2220,396
"9382",206914,2006,1,0,"Cameron University",NA,NA,686,402,284,40,16,24,0.06,0.058,0.056,2352,376
"9383",206914,2007,1,0,"Cameron University",NA,NA,716,382,334,50,22,28,0.073,0.07,0.066,2571,379
"9384",206914,2008,1,0,"Cameron University",NA,NA,817,457,360,66,22,44,0.096,0.081,0.061,2805,389
"9385",206914,2009,1,0,"Cameron University",NA,NA,855,489,366,73,28,45,0.092,0.085,0.077,2805,410
"9386",206914,2010,1,0,"Cameron University",NA,NA,892,520,372,43,21,22,0.042,0.048,0.056,2963,378
"9387",207209,1991,1,0,"LANGSTON UNIVERSITY",NA,NA,525,295,230,19,2,17,0.058,0.036,0.009,1347,53
"9388",207209,1992,1,0,"LANGSTON UNIVERSITY",NA,NA,411,215,196,23,4,19,0.088,0.056,0.02,1360,55
"9389",207209,1993,1,0,"LANGSTON UNIVERSITY",NA,NA,479,253,226,28,10,18,0.071,0.058,0.044,1441,36
"9390",207209,1995,1,0,"LANGSTON UNIVERSITY",NA,NA,485,220,265,24,7,17,0.077,0.049,0.026,1707,29
"9391",207209,1996,1,0,"LANGSTON UNIVERSITY",NA,NA,518,259,259,33,8,25,0.096,0.064,0.031,1707,29
"9392",207209,1997,1,0,"LANGSTON UNIVERSITY",NA,NA,566,304,262,34,3,31,0.102,0.06,0.011,1893,18
"9393",207209,1998,1,0,"LANGSTON UNIVERSITY",NA,NA,517,262,255,22,3,19,0.072,0.043,0.012,1896,9
"9394",207209,1999,1,0,"LANGSTON UNIVERSITY",NA,NA,446,232,214,17,4,13,0.056,0.038,0.019,1410,9
"9395",207209,2000,1,0,"LANGSTON UNIVERSITY",NA,NA,690,328,362,40,14,26,0.079,0.058,0.039,1485,19
"9396",207209,2001,1,0,"LANGSTON UNIVERSITY",NA,NA,446,232,214,18,5,13,0.056,0.04,0.023,635,9
"9397",207209,2002,1,0,"LANGSTON UNIVERSITY",NA,NA,492,248,244,31,8,23,0.093,0.063,0.033,1635,23
"9398",207209,2003,1,0,"LANGSTON UNIVERSITY",NA,NA,553,256,297,23,9,14,0.055,0.042,0.03,1818,23
"9399",207209,2004,1,0,"LANGSTON UNIVERSITY",NA,NA,530,245,285,16,6,10,0.041,0.03,0.021,1909,14
"9400",207209,2005,1,0,"Langston University",NA,NA,670,316,354,31,3,28,0.089,0.046,0.008,1946,14
"9401",207209,2006,1,0,"Langston University",NA,NA,533,271,262,32,8,24,0.089,0.06,0.031,2190,18
"9402",207209,2007,1,0,"Langston University",NA,NA,559,270,289,48,8,40,0.148,0.086,0.028,2409,21
"9403",207209,2008,1,0,"Langston University",NA,NA,593,281,312,19,2,17,0.06,0.032,0.006,2640,10
"9404",207209,2009,1,0,"Langston University",NA,NA,561,253,308,17,6,11,0.044,0.03,0.019,2640,9
"9405",207209,2010,1,0,"Langston University",NA,NA,469,226,243,11,2,9,0.04,0.023,0.008,2772,17
"9406",207306,1991,1,0,"NORTHWESTERN OKLAHOMA STATE UNIVERSITY",NA,NA,356,176,180,43,18,25,0.142,0.121,0.1,1423,323
"9407",207306,1992,1,0,"NORTHWESTERN OKLAHOMA STATE UNIVERSITY",NA,NA,317,164,153,36,13,23,0.14,0.114,0.085,1423,296
"9408",207306,1993,1,0,"NORTHWESTERN OKLAHOMA STATE UNIVERSITY",NA,NA,228,119,109,33,12,21,0.176,0.145,0.11,1423,211
"9409",207306,1995,1,0,"NORTHWESTERN OKLAHOMA STATE UNIVERSITY",NA,NA,240,127,113,39,11,28,0.22,0.162,0.097,1718,226
"9410",207306,1996,1,0,"NORTHWESTERN OKLAHOMA STATE UNIVERSITY",NA,NA,234,110,124,22,11,11,0.1,0.094,0.089,1748,204
"9411",207306,1997,1,0,"NORTHWESTERN OKLAHOMA STATE UNIVERSITY",NA,NA,293,148,145,35,11,24,0.162,0.119,0.076,1834,259
"9412",207306,1998,1,0,"NORTHWESTERN OKLAHOMA STATE UNIVERSITY",NA,NA,290,147,143,35,15,20,0.136,0.121,0.105,1874,258
"9413",207306,1999,1,0,"NORTHWESTERN OKLAHOMA STATE UNIVERSITY",NA,NA,310,138,172,36,16,20,0.145,0.116,0.093,1584,276
"9414",207306,2000,1,0,"NORTHWESTERN OKLAHOMA STATE UNIVERSITY",NA,NA,329,159,170,46,15,31,0.195,0.14,0.088,1584,297
"9415",207306,2001,1,0,"NORTHWESTERN OKLAHOMA STATE UNIVERSITY",NA,NA,310,138,172,36,16,20,0.145,0.116,0.093,1641,276
"9416",207306,2002,1,0,"NORTHWESTERN OKLAHOMA STATE UNIVERSITY",NA,NA,298,164,134,56,19,37,0.226,0.188,0.142,1756,253
"9417",207306,2003,1,0,"NORTHWESTERN OKLAHOMA STATE UNIVERSITY",NA,NA,308,139,169,45,20,25,0.18,0.146,0.118,2015,271
"9418",207306,2004,1,0,"NORTHWESTERN OKLAHOMA STATE UNIVERSITY",NA,NA,292,156,136,40,12,28,0.18,0.137,0.088,2263,248
"9419",207306,2005,1,0,"Northwestern Oklahoma State University",NA,NA,279,150,129,37,10,27,0.18,0.133,0.078,2604,229
"9420",207306,2006,1,0,"Northwestern Oklahoma State University",NA,NA,243,121,122,29,9,20,0.165,0.119,0.074,2922,192
"9421",207306,2007,1,0,"Northwestern Oklahoma State University",NA,NA,328,173,155,43,13,30,0.173,0.131,0.084,3232,272
"9422",207306,2008,1,0,"Northwestern Oklahoma State University",NA,NA,317,162,155,47,14,33,0.204,0.148,0.09,3604,258
"9423",207306,2009,1,0,"Northwestern Oklahoma State University",NA,NA,402,199,203,32,8,24,0.121,0.08,0.039,3604,280
"9424",207306,2010,1,0,"Northwestern Oklahoma State University",NA,NA,382,182,200,51,16,35,0.192,0.134,0.08,3836,262
"9425",207324,1991,0,1,"OKLAHOMA CHRISTIAN UNIVERSITY OF SCIENCE AND ARTS",2000,0,304,160,144,76,37,39,0.244,0.25,0.257,4840,233
"9426",207324,1992,0,1,"OKLAHOMA CHRISTIAN UNIVERSITY OF SCIENCE AND ARTS",2000,0,355,183,172,97,41,56,0.306,0.273,0.238,5280,309
"9427",207324,1993,0,1,"OKLAHOMA CHRISTIAN UNIVERSITY OF SCIENCE AND ARTS",2000,0,291,157,134,56,31,25,0.159,0.192,0.231,5780,251
"9428",207324,1995,0,1,"OKLAHOMA CHRISTIAN UNIVERSITY OF SCIENCE AND ARTS",2000,0,320,158,162,78,28,50,0.316,0.244,0.173,7160,281
"9429",207324,1996,0,1,"OKLAHOMA CHRISTIAN UNIVERSITY OF SCIENCE AND ARTS",2000,0,464,234,230,106,41,65,0.278,0.228,0.178,7500,409
"9430",207324,1997,0,1,"OKLAHOMA CHRISTIAN UNIVERSITY OF SCIENCE AND ARTS",2000,0,453,222,231,73,32,41,0.185,0.161,0.139,7600,390
"9431",207324,1998,0,1,"OKLAHOMA CHRISTIAN UNIVERSITY OF SCIENCE AND ARTS",2000,0,468,277,191,93,33,60,0.217,0.199,0.173,8200,400
"9432",207324,1999,0,1,"OKLAHOMA CHRISTIAN UNIVERSITY OF SCIENCE AND ARTS",2000,0,391,219,172,123,44,79,0.361,0.315,0.256,8110,346
"9433",207324,2000,1,0,"OKLAHOMA CHRISTIAN UNIVERSITY",2000,1,449,226,223,100,45,55,0.243,0.223,0.202,9700,402
"9434",207324,2001,1,0,"OKLAHOMA CHRISTIAN UNIVERSITY",2000,1,465,234,231,107,42,65,0.278,0.23,0.182,10500,409
"9435",207324,2002,1,0,"OKLAHOMA CHRISTIAN UNIVERSITY",2000,1,405,215,190,93,43,50,0.233,0.23,0.226,11100,343
"9436",207324,2003,1,0,"OKLAHOMA CHRISTIAN UNIVERSITY",2000,1,356,199,157,99,38,61,0.306,0.278,0.242,11490,306
"9437",207324,2004,1,0,"OKLAHOMA CHRISTIAN UNIVERSITY",2000,1,545,291,254,117,50,67,0.23,0.215,0.197,11780,469
"9438",207324,2005,1,0,"Oklahoma Christian University",2000,1,523,270,253,144,57,87,0.322,0.275,0.225,12486,461
"9439",207324,2006,1,0,"Oklahoma Christian University",2000,1,512,260,252,166,76,90,0.346,0.324,0.302,13422,443
"9440",207324,2007,1,0,"Oklahoma Christian University",2000,1,521,269,252,148,63,85,0.316,0.284,0.25,14020,431
"9441",207324,2008,1,0,"Oklahoma Christian University",2000,1,430,206,224,113,50,63,0.306,0.263,0.223,14690,347
"9442",207324,2009,1,0,"Oklahoma Christian University",2000,1,471,218,253,148,67,81,0.372,0.314,0.265,14690,375
"9443",207324,2010,1,0,"Oklahoma Christian University",2000,1,497,247,250,166,77,89,0.36,0.334,0.308,15600,379
"9444",207388,1991,1,0,"OKLAHOMA STATE UNIVERSITY MAIN CAMPUS",NA,NA,2092,1038,1054,399,144,255,0.246,0.191,0.137,1758,1732
"9445",207388,1992,1,0,"OKLAHOMA STATE UNIVERSITY MAIN CAMPUS",NA,NA,2148,1116,1032,400,130,270,0.242,0.186,0.126,1758,1746
"9446",207388,1993,1,0,"OKLAHOMA STATE UNIVERSITY-MAIN CAMPUS",NA,NA,2050,999,1051,377,130,247,0.247,0.184,0.124,1882,1685
"9447",207388,1995,1,0,"OKLAHOMA STATE UNIVERSITY-MAIN CAMPUS",NA,NA,2362,1185,1177,475,186,289,0.244,0.201,0.158,2148,1953
"9448",207388,1996,1,0,"OKLAHOMA STATE UNIVERSITY-MAIN CAMPUS",NA,NA,2336,1223,1113,488,155,333,0.272,0.209,0.139,2161,1905
"9449",207388,1997,1,0,"OKLAHOMA STATE UNIVERSITY-MAIN CAMPUS",NA,NA,2321,1214,1107,565,194,371,0.306,0.243,0.175,2356,1920
"9450",207388,1998,1,0,"OKLAHOMA STATE UNIVERSITY-MAIN CAMPUS",NA,NA,2584,1301,1283,624,226,398,0.306,0.241,0.176,2356,2141
"9451",207388,1999,1,0,"OKLAHOMA STATE UNIVERSITY-MAIN CAMPUS",NA,NA,2795,1491,1304,705,206,499,0.335,0.252,0.158,1890,2304
"9452",207388,2000,1,0,"OKLAHOMA STATE UNIVERSITY-MAIN CAMPUS",NA,NA,2953,1615,1338,802,272,530,0.328,0.272,0.203,1890,2440
"9453",207388,2001,1,0,"OKLAHOMA STATE UNIVERSITY-MAIN CAMPUS",NA,NA,3111,1594,1517,834,285,549,0.344,0.268,0.188,2022,2499
"9454",207388,2002,1,0,"OKLAHOMA STATE UNIVERSITY-MAIN CAMPUS",NA,NA,3206,1698,1508,939,327,612,0.36,0.293,0.217,2163,2641
"9455",207388,2003,1,0,"OKLAHOMA STATE UNIVERSITY-MAIN CAMPUS",NA,NA,3128,1666,1462,958,336,622,0.373,0.306,0.23,2596,2576
"9456",207388,2004,1,0,"OKLAHOMA STATE UNIVERSITY-MAIN CAMPUS",NA,NA,3126,1601,1525,991,360,631,0.394,0.317,0.236,2910,2560
"9457",207388,2005,1,0,"Oklahoma State University-Main Campus",NA,NA,3221,1662,1559,1106,436,670,0.403,0.343,0.28,3099,2630
"9458",207388,2006,1,0,"Oklahoma State University-Main Campus",NA,NA,3132,1658,1474,1068,383,685,0.413,0.341,0.26,3263,2567
"9459",207388,2007,1,0,"Oklahoma State University-Main Campus",NA,NA,3111,1599,1512,1013,399,614,0.384,0.326,0.264,3585,2450
"9460",207388,2008,1,0,"Oklahoma State University-Main Campus",NA,NA,2946,1501,1445,992,361,631,0.42,0.337,0.25,3941,2333
"9461",207388,2009,1,0,"Oklahoma State University-Main Campus",NA,NA,2973,1544,1429,997,365,632,0.409,0.335,0.255,3941,2248
"9462",207388,2010,1,0,"Oklahoma State University-Main Campus",NA,NA,3403,1761,1642,1320,497,823,0.467,0.388,0.303,4103,2519
"9463",207500,1991,1,0,"UNIVERSITY OF OKLAHOMA NORMAN CAMPUS",NA,NA,2249,1082,1167,277,101,176,0.163,0.123,0.087,1722,1686
"9464",207500,1992,1,0,"UNIVERSITY OF OKLAHOMA NORMAN CAMPUS",NA,NA,2376,1164,1212,264,110,154,0.132,0.111,0.091,1768,1705
"9465",207500,1993,1,0,"UNIVERSITY OF OKLAHOMA NORMAN CAMPUS",NA,NA,2235,1072,1163,337,139,198,0.185,0.151,0.12,1901,1671
"9466",207500,1995,1,0,"UNIVERSITY OF OKLAHOMA NORMAN CAMPUS",NA,NA,2712,1321,1391,519,191,328,0.248,0.191,0.137,2024,1960
"9467",207500,1996,1,0,"UNIVERSITY OF OKLAHOMA NORMAN CAMPUS",NA,NA,2605,1264,1341,525,200,325,0.257,0.202,0.149,2178,1896
"9468",207500,1997,1,0,"UNIVERSITY OF OKLAHOMA NORMAN CAMPUS",NA,NA,2895,1523,1372,552,195,357,0.234,0.191,0.142,2309,2083
"9469",207500,1998,1,0,"UNIVERSITY OF OKLAHOMA NORMAN CAMPUS",NA,NA,3148,1618,1530,641,214,427,0.264,0.204,0.14,2313,2293
"9470",207500,1999,1,0,"UNIVERSITY OF OKLAHOMA NORMAN CAMPUS",NA,NA,3206,1603,1603,619,237,382,0.238,0.193,0.148,1890,2326
"9471",207500,2000,1,0,"UNIVERSITY OF OKLAHOMA NORMAN CAMPUS",NA,NA,3326,1760,1566,791,268,523,0.297,0.238,0.171,1890,2480
"9472",207500,2001,1,0,"UNIVERSITY OF OKLAHOMA NORMAN CAMPUS",NA,NA,3629,1908,1721,897,332,565,0.296,0.247,0.193,2022,2782
"9473",207500,2002,1,0,"UNIVERSITY OF OKLAHOMA NORMAN CAMPUS",NA,NA,3749,1940,1809,973,350,623,0.321,0.26,0.193,2163,2940
"9474",207500,2003,1,0,"UNIVERSITY OF OKLAHOMA NORMAN CAMPUS",NA,NA,3729,1921,1808,1100,406,694,0.361,0.295,0.225,2541,2907
"9475",207500,2004,1,0,"UNIVERSITY OF OKLAHOMA NORMAN CAMPUS",NA,NA,3537,1876,1661,1122,397,725,0.386,0.317,0.239,2778,2778
"9476",207500,2005,1,0,"University of Oklahoma Norman Campus",NA,NA,3189,1695,1494,1107,418,689,0.406,0.347,0.28,2862,2448
"9477",207500,2006,1,0,"University of Oklahoma Norman Campus",NA,NA,3285,1732,1553,1190,457,733,0.423,0.362,0.294,3006,2445
"9478",207500,2007,1,0,"University of Oklahoma Norman Campus",NA,NA,3824,2043,1781,1331,452,879,0.43,0.348,0.254,3261,2858
"9479",207500,2008,1,0,"University of Oklahoma Norman Campus",NA,NA,3750,2058,1692,1394,525,869,0.422,0.372,0.31,3537,2913
"9480",207500,2009,1,0,"University of Oklahoma Norman Campus",NA,NA,3700,1917,1783,1411,555,856,0.446,0.381,0.311,3537,2695
"9481",207500,2010,1,0,"University of Oklahoma Norman Campus",NA,NA,3669,1945,1724,1455,549,906,0.466,0.397,0.318,3678,2117
"9482",207722,1991,0,1,"UNIVERSITY OF SCIENCE AND ARTS OF OKLAHOMA",9999,0,203,143,60,16,2,14,0.098,0.079,0.033,1316,174
"9483",207722,1992,0,1,"UNIVERSITY OF SCIENCE AND ARTS OF OKLAHOMA",9999,0,219,151,68,33,10,23,0.152,0.151,0.147,1316,192
"9484",207722,1993,0,1,"UNIVERSITY OF SCIENCE AND ARTS OF OKLAHOMA",9999,0,207,128,79,21,6,15,0.117,0.101,0.076,1408,180
"9485",207722,1995,0,1,"UNIVERSITY OF SCIENCE AND ARTS OF OKLAHOMA",9999,0,259,164,95,33,6,27,0.165,0.127,0.063,1538,209
"9486",207722,1996,0,1,"UNIVERSITY OF SCIENCE AND ARTS OF OKLAHOMA",9999,0,261,138,123,26,11,15,0.109,0.1,0.089,1568,203
"9487",207722,1997,0,1,"UNIVERSITY OF SCIENCE AND ARTS OF OKLAHOMA",9999,0,222,133,89,32,9,23,0.173,0.144,0.101,1725,184
"9488",207722,1998,0,1,"UNIVERSITY OF SCIENCE AND ARTS OF OKLAHOMA",9999,0,279,159,120,48,19,29,0.182,0.172,0.158,1740,231
"9489",207722,1999,0,1,"UNIVERSITY OF SCIENCE AND ARTS OF OKLAHOMA",9999,0,229,133,96,32,12,20,0.15,0.14,0.125,1470,179
"9490",207722,2000,0,1,"UNIVERSITY OF SCIENCE AND ARTS OF OKLAHOMA",9999,0,206,135,71,29,6,23,0.17,0.141,0.085,1176,149
"9491",207722,2001,0,1,"UNIVERSITY OF SCIENCE AND ARTS OF OKLAHOMA",9999,0,261,138,123,26,11,15,0.109,0.1,0.089,1699,203
"9492",207722,2002,0,1,"UNIVERSITY OF SCIENCE AND ARTS OF OKLAHOMA",9999,0,280,186,94,44,11,33,0.177,0.157,0.117,1699,216
"9493",207722,2003,0,1,"UNIVERSITY OF SCIENCE AND ARTS OF OKLAHOMA",9999,0,282,172,110,54,11,43,0.25,0.191,0.1,1680,216
"9494",207722,2004,0,1,"UNIVERSITY OF SCIENCE AND ARTS OF OKLAHOMA",9999,0,244,148,96,45,13,32,0.216,0.184,0.135,1824,187
"9495",207722,2005,0,1,"University of Science and Arts of Oklahoma",9999,0,233,122,111,61,30,31,0.254,0.262,0.27,1992,182
"9496",207722,2006,0,1,"University of Science and Arts of Oklahoma",9999,0,208,139,69,58,16,42,0.302,0.279,0.232,2112,156
"9497",207722,2007,0,1,"University of Science and Arts of Oklahoma",9999,0,198,123,75,51,13,38,0.309,0.258,0.173,2304,150
"9498",207722,2008,0,1,"University of Science and Arts of Oklahoma",9999,0,203,126,77,88,28,60,0.476,0.433,0.364,2616,142
"9499",207722,2009,0,1,"University of Science and Arts of Oklahoma",9999,0,166,113,53,49,12,37,0.327,0.295,0.226,2616,121
"9500",207722,2010,0,1,"University of Science and Arts of Oklahoma",9999,0,199,129,70,54,13,41,0.318,0.271,0.186,2808,143
"9501",207847,1991,1,0,"SOUTHEASTERN OKLAHOMA STATE UNIVERSITY",NA,NA,537,291,246,55,21,34,0.117,0.102,0.085,1340,323
"9502",207847,1992,1,0,"SOUTHEASTERN OKLAHOMA STATE UNIVERSITY",NA,NA,503,287,216,60,19,41,0.143,0.119,0.088,1350,298
"9503",207847,1993,1,0,"SOUTHEASTERN OKLAHOMA STATE UNIVERSITY",NA,NA,541,295,246,77,31,46,0.156,0.142,0.126,1494,336
"9504",207847,1995,1,0,"SOUTHEASTERN OKLAHOMA STATE UNIVERSITY",NA,NA,570,282,288,91,48,43,0.152,0.16,0.167,1665,347
"9505",207847,1996,1,0,"SOUTHEASTERN OKLAHOMA STATE UNIVERSITY",NA,NA,579,266,313,78,41,37,0.139,0.135,0.131,1687,361
"9506",207847,1997,1,0,"SOUTHEASTERN OKLAHOMA STATE UNIVERSITY",NA,NA,578,314,264,89,33,56,0.178,0.154,0.125,1879,339
"9507",207847,1998,1,0,"SOUTHEASTERN OKLAHOMA STATE UNIVERSITY",NA,NA,499,260,239,59,21,38,0.146,0.118,0.088,1889,316
"9508",207847,1999,1,0,"SOUTHEASTERN OKLAHOMA STATE UNIVERSITY",NA,NA,572,307,265,67,26,41,0.134,0.117,0.098,1485,316
"9509",207847,2000,1,0,"SOUTHEASTERN OKLAHOMA STATE UNIVERSITY",NA,NA,509,261,248,54,21,33,0.126,0.106,0.085,1372,307
"9510",207847,2001,1,0,"SOUTHEASTERN OKLAHOMA STATE UNIVERSITY",NA,NA,579,266,313,75,40,35,0.132,0.13,0.128,1467,361
"9511",207847,2002,1,0,"SOUTHEASTERN OKLAHOMA STATE UNIVERSITY",NA,NA,577,287,290,64,29,35,0.122,0.111,0.1,1569,392
"9512",207847,2003,1,0,"SOUTHEASTERN OKLAHOMA STATE UNIVERSITY",NA,NA,651,339,312,70,27,43,0.127,0.108,0.087,1950,395
"9513",207847,2004,1,0,"SOUTHEASTERN OKLAHOMA STATE UNIVERSITY",NA,NA,609,310,299,59,29,30,0.097,0.097,0.097,2126,360
"9514",207847,2005,1,0,"Southeastern Oklahoma State University",NA,NA,587,298,289,62,22,40,0.134,0.106,0.076,2195,352
"9515",207847,2006,1,0,"Southeastern Oklahoma State University",NA,NA,586,313,273,67,26,41,0.131,0.114,0.095,2897,337
"9516",207847,2007,1,0,"Southeastern Oklahoma State University",NA,NA,631,326,305,82,33,49,0.15,0.13,0.108,3249,376
"9517",207847,2008,1,0,"Southeastern Oklahoma State University",NA,NA,583,296,287,68,29,39,0.132,0.117,0.101,3639,321
"9518",207847,2009,1,0,"Southeastern Oklahoma State University",NA,NA,639,313,326,84,38,46,0.147,0.131,0.117,3639,355
"9519",207847,2010,1,0,"Southeastern Oklahoma State University",NA,NA,651,344,307,55,20,35,0.102,0.084,0.065,3875,350
"9520",207865,1991,1,0,"SOUTHWESTERN OKLAHOMA STATE UNIVERSITY",NA,NA,867,502,365,70,24,46,0.092,0.081,0.066,1295,767
"9521",207865,1992,1,0,"SOUTHWESTERN OKLAHOMA STATE UNIVERSITY",NA,NA,945,534,411,79,21,58,0.109,0.084,0.051,1310,855
"9522",207865,1993,1,0,"SOUTHWESTERN OKLAHOMA STATE UNIVERSITY",NA,NA,791,409,382,68,19,49,0.12,0.086,0.05,1392,704
"9523",207865,1995,1,0,"SOUTHWESTERN OKLAHOMA STATE UNIVERSITY",NA,NA,769,470,299,123,34,89,0.189,0.16,0.114,1599,671
"9524",207865,1996,1,0,"SOUTHWESTERN OKLAHOMA STATE UNIVERSITY",NA,NA,737,386,351,92,34,58,0.15,0.125,0.097,1599,671
"9525",207865,1997,1,0,"SOUTHWESTERN OKLAHOMA STATE UNIVERSITY",NA,NA,717,386,331,107,28,79,0.205,0.149,0.085,1798,632
"9526",207865,1998,1,0,"SOUTHWESTERN OKLAHOMA STATE UNIVERSITY",NA,NA,866,453,413,136,38,98,0.216,0.157,0.092,1798,752
"9527",207865,1999,1,0,"SOUTHWESTERN OKLAHOMA STATE UNIVERSITY",NA,NA,779,448,331,116,35,81,0.181,0.149,0.106,1485,681
"9528",207865,2000,1,0,"SOUTHWESTERN OKLAHOMA STATE UNIVERSITY",NA,NA,815,464,351,135,27,108,0.233,0.166,0.077,1485,688
"9529",207865,2001,1,0,"SOUTHWESTERN OKLAHOMA STATE UNIVERSITY",NA,NA,853,481,372,128,45,83,0.173,0.15,0.121,1589,708
"9530",207865,2002,1,0,"SOUTHWESTERN OKLAHOMA STATE UNIVERSITY",NA,NA,926,486,440,121,46,75,0.154,0.131,0.105,1700,771
"9531",207865,2003,1,0,"SOUTHWESTERN OKLAHOMA STATE UNIVERSITY",NA,NA,980,492,488,119,38,81,0.165,0.121,0.078,1950,758
"9532",207865,2004,1,0,"SOUTHWESTERN OKLAHOMA STATE UNIVERSITY",NA,NA,941,493,448,130,41,89,0.181,0.138,0.092,2100,744
"9533",207865,2005,1,0,"Southwestern Oklahoma State University",NA,NA,766,403,363,127,43,84,0.208,0.166,0.118,2490,592
"9534",207865,2006,1,0,"Southwestern Oklahoma State University",NA,NA,844,485,359,129,31,98,0.202,0.153,0.086,2700,640
"9535",207865,2007,1,0,"Southwestern Oklahoma State University",NA,NA,896,552,344,116,32,84,0.152,0.129,0.093,3000,690
"9536",207865,2008,1,0,"Southwestern Oklahoma State University",NA,NA,920,511,409,124,41,83,0.162,0.135,0.1,3360,724
"9537",207865,2009,1,0,"Southwestern Oklahoma State University",NA,NA,900,481,419,105,30,75,0.156,0.117,0.072,3360,662
"9538",207865,2010,1,0,"Southwestern Oklahoma State University",NA,NA,977,529,448,123,44,79,0.149,0.126,0.098,3405,697
"9539",208822,1991,1,0,"GEORGE FOX COLLEGE",NA,NA,258,154,104,91,33,58,0.377,0.353,0.317,9114,239
"9540",208822,1992,1,0,"GEORGE FOX COLLEGE",NA,NA,282,176,106,134,52,82,0.466,0.475,0.491,10040,264
"9541",208822,1993,1,0,"GEORGE FOX COLLEGE",NA,NA,343,198,145,159,62,97,0.49,0.464,0.428,11740,313
"9542",208822,1995,1,0,"GEORGE FOX UNIVERSITY",NA,NA,347,232,115,162,54,108,0.465,0.467,0.47,13690,312
"9543",208822,1996,1,0,"GEORGE FOX UNIVERSITY",NA,NA,386,250,136,200,71,129,0.516,0.518,0.522,14520,356
"9544",208822,1997,1,0,"GEORGE FOX UNIVERSITY",NA,NA,345,225,120,212,70,142,0.631,0.614,0.583,15520,277
"9545",208822,1998,1,0,"GEORGE FOX UNIVERSITY",NA,NA,361,240,121,208,73,135,0.562,0.576,0.603,15950,223
"9546",208822,1999,1,0,"GEORGE FOX UNIVERSITY",NA,NA,282,163,119,145,48,97,0.595,0.514,0.403,16600,265
"9547",208822,2000,1,0,"GEORGE FOX UNIVERSITY",NA,NA,352,205,147,209,81,128,0.624,0.594,0.551,17300,295
"9548",208822,2001,1,0,"GEORGE FOX UNIVERSITY",NA,NA,301,180,121,172,64,108,0.6,0.571,0.529,18000,268
"9549",208822,2002,1,0,"GEORGE FOX UNIVERSITY",NA,NA,319,204,115,171,60,111,0.544,0.536,0.522,18575,286
"9550",208822,2003,1,0,"GEORGE FOX UNIVERSITY",NA,NA,336,203,133,177,73,104,0.512,0.527,0.549,19500,293
"9551",208822,2004,1,0,"GEORGE FOX UNIVERSITY",NA,NA,397,259,138,235,79,156,0.602,0.592,0.572,20280,339
"9552",208822,2005,1,0,"George Fox University",NA,NA,460,287,173,241,86,155,0.54,0.524,0.497,21400,379
"9553",208822,2006,1,0,"George Fox University",NA,NA,415,262,153,223,81,142,0.542,0.537,0.529,22250,325
"9554",208822,2007,1,0,"George Fox University",NA,NA,435,279,156,225,61,164,0.588,0.517,0.391,23470,338
"9555",208822,2008,1,0,"George Fox University",NA,NA,401,245,156,204,74,130,0.531,0.509,0.474,24870,291
"9556",208822,2009,1,0,"George Fox University",NA,NA,411,239,172,249,102,147,0.615,0.606,0.593,25860,329
"9557",208822,2010,1,0,"George Fox University",NA,NA,488,287,201,275,119,156,0.544,0.564,0.592,27640,342
"9558",209056,1991,0,1,"LEWIS AND CLARK COLLEGE",1995,0,357,213,144,191,72,119,0.559,0.535,0.5,13470,309
"9559",209056,1992,0,1,"LEWIS AND CLARK COLLEGE",1995,0,395,235,160,221,78,143,0.609,0.559,0.488,14265,341
"9560",209056,1993,0,1,"LEWIS AND CLARK COLLEGE",1995,0,469,274,195,259,113,146,0.533,0.552,0.579,15051,396
"9561",209056,1995,1,0,"LEWIS AND CLARK COLLEGE",1995,1,455,280,175,228,85,143,0.511,0.501,0.486,16820,333
"9562",209056,1996,1,0,"LEWIS AND CLARK COLLEGE",1995,1,443,262,181,249,91,158,0.603,0.562,0.503,17740,318
"9563",209056,1997,1,0,"LEWIS AND CLARK COLLEGE",1995,1,463,272,191,289,121,168,0.618,0.624,0.634,18530,298
"9564",209056,1998,1,0,"LEWIS AND CLARK COLLEGE",1995,1,424,253,171,249,94,155,0.613,0.587,0.55,19356,295
"9565",209056,1999,1,0,"LEWIS AND CLARK COLLEGE",1995,1,510,307,203,330,127,203,0.661,0.647,0.626,20136,325
"9566",209056,2000,1,0,"LEWIS AND CLARK COLLEGE",1995,1,426,263,163,251,91,160,0.608,0.589,0.558,21330,291
"9567",209056,2001,1,0,"LEWIS & CLARK COLLEGE",1995,1,415,240,175,277,109,168,0.7,0.667,0.623,22410,283
"9568",209056,2002,1,0,"LEWIS & CLARK COLLEGE",1995,1,503,309,194,339,123,216,0.699,0.674,0.634,23530,303
"9569",209056,2003,1,0,"LEWIS & CLARK COLLEGE",1995,1,493,308,185,352,127,225,0.731,0.714,0.686,24486,351
"9570",209056,2004,1,0,"LEWIS & CLARK COLLEGE",1995,1,537,329,208,366,143,223,0.678,0.682,0.688,25938,364
"9571",209056,2005,1,0,"Lewis & Clark College",1995,1,490,294,196,324,125,199,0.677,0.661,0.638,27494,339
"9572",209056,2006,1,0,"Lewis & Clark College",1995,1,508,318,190,349,129,220,0.692,0.687,0.679,29556,307
"9573",209056,2007,1,0,"Lewis & Clark College",1995,1,506,322,184,338,108,230,0.714,0.668,0.587,31624,312
"9574",209056,2008,1,0,"Lewis & Clark College",1995,1,534,323,211,381,135,246,0.762,0.713,0.64,33490,295
"9575",209056,2009,1,0,"Lewis & Clark College",1995,1,494,298,196,327,122,205,0.688,0.662,0.622,34995,266
"9576",209056,2010,1,0,"Lewis & Clark College",1995,1,491,306,185,364,125,239,0.781,0.741,0.676,36394,311
"9577",209065,1991,1,0,"LINFIELD COLLEGE",NA,NA,429,242,187,234,89,145,0.599,0.545,0.476,11150,371
"9578",209065,1992,1,0,"LINFIELD COLLEGE",NA,NA,428,265,163,234,68,166,0.626,0.547,0.417,11870,380
"9579",209065,1993,1,0,"LINFIELD COLLEGE",NA,NA,436,235,201,254,110,144,0.613,0.583,0.547,12700,382
"9580",209065,1995,1,0,"LINFIELD COLLEGE",NA,NA,438,260,178,276,105,171,0.658,0.63,0.59,14300,377
"9581",209065,1996,1,0,"LINFIELD COLLEGE",NA,NA,445,238,207,272,109,163,0.685,0.611,0.527,15096,393
"9582",209065,1997,1,0,"LINFIELD COLLEGE",NA,NA,410,235,175,244,91,153,0.651,0.595,0.52,15994,352
"9583",209065,1998,1,0,"LINFIELD COLLEGE",NA,NA,415,232,183,238,81,157,0.677,0.573,0.443,16960,356
"9584",209065,1999,1,0,"LINFIELD COLLEGE",NA,NA,397,227,170,227,74,153,0.674,0.572,0.435,17590,314
"9585",209065,2000,1,0,"LINFIELD COLLEGE",NA,NA,434,228,206,281,113,168,0.737,0.647,0.549,18450,338
"9586",209065,2001,1,0,"LINFIELD COLLEGE",NA,NA,422,232,190,250,89,161,0.694,0.592,0.468,19380,363
"9587",209065,2002,1,0,"LINFIELD COLLEGE",NA,NA,425,245,180,258,92,166,0.678,0.607,0.511,20160,361
"9588",209065,2003,1,0,"LINFIELD COLLEGE",NA,NA,448,243,205,286,101,185,0.761,0.638,0.493,20770,372
"9589",209065,2004,1,0,"LINFIELD COLLEGE",NA,NA,432,222,210,249,106,143,0.644,0.576,0.505,21800,333
"9590",209065,2005,1,0,"Linfield College",NA,NA,481,260,221,293,113,180,0.692,0.609,0.511,22790,399
"9591",209065,2006,1,0,"Linfield College",NA,NA,445,243,202,265,104,161,0.663,0.596,0.515,23930,346
"9592",209065,2007,1,0,"Linfield College",NA,NA,476,276,200,281,96,185,0.67,0.59,0.48,25390,310
"9593",209065,2008,1,0,"Linfield College",NA,NA,474,274,200,290,106,184,0.672,0.612,0.53,27150,314
"9594",209065,2009,1,0,"Linfield College",NA,NA,420,252,168,226,76,150,0.595,0.538,0.452,28760,294
"9595",209065,2010,1,0,"Linfield College",NA,NA,528,310,218,302,117,185,0.597,0.572,0.537,30300,369
"9596",209542,1991,0,1,"OREGON STATE UNIVERSITY",9999,0,1543,696,847,403,184,219,0.315,0.261,0.217,2505,1224
"9597",209542,1992,0,1,"OREGON STATE UNIVERSITY",9999,0,1703,771,932,442,179,263,0.341,0.26,0.192,2691,1385
"9598",209542,1993,0,1,"OREGON STATE UNIVERSITY",9999,0,1625,705,920,395,169,226,0.321,0.243,0.184,2877,1269
"9599",209542,1995,0,1,"OREGON STATE UNIVERSITY",9999,0,2018,965,1053,561,194,367,0.38,0.278,0.184,3312,1615
"9600",209542,1996,0,1,"OREGON STATE UNIVERSITY",9999,0,1833,883,950,492,181,311,0.352,0.268,0.191,3447,1450
"9601",209542,1997,0,1,"OREGON STATE UNIVERSITY",9999,0,1869,860,1009,525,212,313,0.364,0.281,0.21,3510,1516
"9602",209542,1998,0,1,"OREGON STATE UNIVERSITY",9999,0,2229,1105,1124,615,210,405,0.366,0.276,0.187,3549,1756
"9603",209542,1999,0,1,"OREGON STATE UNIVERSITY",9999,0,2772,1319,1453,847,333,514,0.39,0.306,0.229,3561,2188
"9604",209542,2000,0,1,"OREGON STATE UNIVERSITY",9999,0,2652,1250,1402,770,311,459,0.367,0.29,0.222,2694,2080
"9605",209542,2001,0,1,"OREGON STATE UNIVERSITY",9999,0,2982,1467,1515,885,356,529,0.361,0.297,0.235,2802,2374
"9606",209542,2002,0,1,"OREGON STATE UNIVERSITY",9999,0,2864,1437,1427,906,319,587,0.409,0.316,0.224,2886,2249
"9607",209542,2003,0,1,"OREGON STATE UNIVERSITY",9999,0,2862,1371,1491,811,321,490,0.357,0.283,0.215,3642,2228
"9608",209542,2004,0,1,"OREGON STATE UNIVERSITY",9999,0,2803,1367,1436,860,320,540,0.395,0.307,0.223,4113,2199
"9609",209542,2005,0,1,"Oregon State University",9999,0,2817,1385,1432,819,306,513,0.37,0.291,0.214,4176,2120
"9610",209542,2006,0,1,"Oregon State University",9999,0,2898,1413,1485,872,341,531,0.376,0.301,0.23,4320,2085
"9611",209542,2007,0,1,"Oregon State University",9999,0,2974,1436,1538,879,333,546,0.38,0.296,0.217,4464,2072
"9612",209542,2008,0,1,"Oregon State University",9999,0,3006,1422,1584,922,373,549,0.386,0.307,0.235,4608,2058
"9613",209542,2009,0,1,"Oregon State University",9999,0,3314,1620,1694,1072,400,672,0.415,0.323,0.236,5436,2330
"9614",209542,2010,0,1,"Oregon State University",9999,0,3480,1677,1803,1145,447,698,0.416,0.329,0.248,5760,2467
"9615",209551,1991,0,1,"UNIVERSITY OF OREGON",9999,0,1919,1068,851,683,238,445,0.417,0.356,0.28,2598,1540
"9616",209551,1992,0,1,"UNIVERSITY OF OREGON",9999,0,2279,1179,1100,808,315,493,0.418,0.355,0.286,2721,1724
"9617",209551,1993,0,1,"UNIVERSITY OF OREGON",9999,0,2513,1422,1091,951,346,605,0.426,0.378,0.317,2916,1978
"9618",209551,1995,0,1,"UNIVERSITY OF OREGON",9999,0,2583,1429,1154,950,329,621,0.435,0.368,0.285,3381,2012
"9619",209551,1996,0,1,"UNIVERSITY OF OREGON",9999,0,2580,1444,1136,958,349,609,0.422,0.371,0.307,3540,2001
"9620",209551,1997,0,1,"UNIVERSITY OF OREGON",9999,0,2384,1307,1077,856,314,542,0.415,0.359,0.292,3648,1835
"9621",209551,1998,0,1,"UNIVERSITY OF OREGON",9999,0,2304,1289,1015,839,280,559,0.434,0.364,0.276,3771,1720
"9622",209551,1999,0,1,"UNIVERSITY OF OREGON",9999,0,2453,1393,1060,931,314,617,0.443,0.38,0.296,2694,1844
"9623",209551,2000,0,1,"UNIVERSITY OF OREGON",9999,0,2809,1527,1282,1089,384,705,0.462,0.388,0.3,2694,2171
"9624",209551,2001,0,1,"UNIVERSITY OF OREGON",9999,0,3049,1687,1362,1244,464,780,0.462,0.408,0.341,2802,2386
"9625",209551,2002,0,1,"UNIVERSITY OF OREGON",9999,0,3272,1834,1438,1353,500,853,0.465,0.414,0.348,2907,2565
"9626",209551,2003,0,1,"UNIVERSITY OF OREGON",9999,0,2826,1594,1232,1300,519,781,0.49,0.46,0.421,3543,2158
"9627",209551,2004,0,1,"UNIVERSITY OF OREGON",9999,0,3138,1734,1404,1377,539,838,0.483,0.439,0.384,4077,2466
"9628",209551,2005,0,1,"University of Oregon",9999,0,3138,1721,1417,1282,506,776,0.451,0.409,0.357,4164,2457
"9629",209551,2006,0,1,"University of Oregon",9999,0,3349,1821,1528,1468,575,893,0.49,0.438,0.376,4341,2555
"9630",209551,2007,0,1,"University of Oregon",9999,0,3505,1839,1666,1528,629,899,0.489,0.436,0.378,4494,2622
"9631",209551,2008,0,1,"University of Oregon",9999,0,4191,2129,2062,1903,824,1079,0.507,0.454,0.4,5202,3198
"9632",209551,2009,0,1,"University of Oregon",9999,0,3788,2027,1761,1900,778,1122,0.553,0.502,0.442,6180,2814
"9633",209551,2010,0,1,"University of Oregon",9999,0,3911,2065,1846,1953,790,1163,0.563,0.499,0.428,6930,2808
"9634",209612,1991,1,0,"PACIFIC UNIVERSITY",NA,NA,261,154,107,93,38,55,0.357,0.356,0.355,11200,220
"9635",209612,1992,1,0,"PACIFIC UNIVERSITY",NA,NA,226,142,84,103,39,64,0.451,0.456,0.464,12320,170
"9636",209612,1993,1,0,"PACIFIC UNIVERSITY",NA,NA,280,164,116,126,47,79,0.482,0.45,0.405,13470,195
"9637",209612,1995,1,0,"PACIFIC UNIVERSITY",NA,NA,242,153,89,108,33,75,0.49,0.446,0.371,14920,182
"9638",209612,1996,1,0,"PACIFIC UNIVERSITY",NA,NA,268,179,89,117,36,81,0.452,0.437,0.404,15654,200
"9639",209612,1997,1,0,"PACIFIC UNIVERSITY",NA,NA,261,175,86,129,39,90,0.514,0.494,0.453,16220,208
"9640",209612,1998,1,0,"PACIFIC UNIVERSITY",NA,NA,246,157,89,133,39,94,0.599,0.541,0.438,16694,175
"9641",209612,1999,1,0,"PACIFIC UNIVERSITY",NA,NA,292,175,117,164,70,94,0.537,0.562,0.598,16800,190
"9642",209612,2000,1,0,"PACIFIC UNIVERSITY",NA,NA,303,198,105,158,58,100,0.505,0.521,0.552,17305,229
"9643",209612,2001,1,0,"PACIFIC UNIVERSITY",NA,NA,310,206,104,171,47,124,0.602,0.552,0.452,18000,224
"9644",209612,2002,1,0,"PACIFIC UNIVERSITY",NA,NA,275,166,109,171,64,107,0.645,0.622,0.587,18766,201
"9645",209612,2003,1,0,"PACIFIC UNIVERSITY",NA,NA,303,174,129,158,58,100,0.575,0.521,0.45,19330,212
"9646",209612,2004,1,0,"PACIFIC UNIVERSITY",NA,NA,294,181,113,164,62,102,0.564,0.558,0.549,20104,184
"9647",209612,2005,1,0,"Pacific University",NA,NA,324,204,120,165,52,113,0.554,0.509,0.433,20908,223
"9648",209612,2006,1,0,"Pacific University",NA,NA,360,206,154,194,72,122,0.592,0.539,0.468,21954,202
"9649",209612,2007,1,0,"Pacific University",NA,NA,372,242,130,194,59,135,0.558,0.522,0.454,25830,233
"9650",209612,2008,1,0,"Pacific University",NA,NA,345,227,118,174,60,114,0.502,0.504,0.508,27604,207
"9651",209612,2009,1,0,"Pacific University",NA,NA,333,204,129,213,82,131,0.642,0.64,0.636,29290,199
"9652",209612,2010,1,0,"Pacific University",NA,NA,474,231,243,229,109,120,0.52,0.483,0.449,30990,259
"9653",209807,1991,0,1,"PORTLAND STATE UNIVERSITY",9999,0,670,330,340,86,34,52,0.158,0.128,0.1,2538,411
"9654",209807,1992,0,1,"PORTLAND STATE UNIVERSITY",9999,0,651,343,308,94,42,52,0.152,0.144,0.136,2658,417
"9655",209807,1993,0,1,"PORTLAND STATE UNIVERSITY",9999,0,684,330,354,74,31,43,0.13,0.108,0.088,2826,430
"9656",209807,1995,0,1,"PORTLAND STATE UNIVERSITY",9999,0,682,358,324,82,29,53,0.148,0.12,0.09,3183,463
"9657",209807,1996,0,1,"PORTLAND STATE UNIVERSITY",9999,0,726,351,375,97,34,63,0.18,0.134,0.091,3342,436
"9658",209807,1997,0,1,"PORTLAND STATE UNIVERSITY",9999,0,743,368,375,96,37,59,0.16,0.129,0.099,3357,481
"9659",209807,1998,0,1,"PORTLAND STATE UNIVERSITY",9999,0,800,419,381,101,28,73,0.174,0.126,0.073,3438,511
"9660",209807,1999,0,1,"PORTLAND STATE UNIVERSITY",9999,0,896,496,400,118,39,79,0.159,0.132,0.098,2694,581
"9661",209807,2000,0,1,"PORTLAND STATE UNIVERSITY",9999,0,915,480,435,133,50,83,0.173,0.145,0.115,2694,564
"9662",209807,2001,0,1,"PORTLAND STATE UNIVERSITY",9999,0,1020,548,472,129,42,87,0.159,0.126,0.089,2808,622
"9663",209807,2002,0,1,"PORTLAND STATE UNIVERSITY",9999,0,1177,632,545,153,43,110,0.174,0.13,0.079,2892,787
"9664",209807,2003,0,1,"PORTLAND STATE UNIVERSITY",9999,0,1264,668,596,159,55,104,0.156,0.126,0.092,3240,799
"9665",209807,2004,0,1,"PORTLAND STATE UNIVERSITY",9999,0,1173,627,546,167,51,116,0.185,0.142,0.093,3690,778
"9666",209807,2005,0,1,"Portland State University",9999,0,1200,636,564,172,66,106,0.167,0.143,0.117,3810,734
"9667",209807,2006,0,1,"Portland State University",9999,0,1283,695,588,200,67,133,0.191,0.156,0.114,3930,828
"9668",209807,2007,0,1,"Portland State University",9999,0,1427,759,668,252,93,159,0.21,0.177,0.139,4314,904
"9669",209807,2008,0,1,"Portland State University",9999,0,1567,839,728,264,105,159,0.19,0.168,0.144,4905,982
"9670",209807,2009,0,1,"Portland State University",9999,0,1551,800,751,296,109,187,0.234,0.191,0.145,5321,957
"9671",209807,2010,0,1,"Portland State University",9999,0,1366,733,633,288,123,165,0.225,0.211,0.194,5648,783
"9672",209922,1991,1,0,"REED COLLEGE",NA,NA,292,146,146,139,71,68,0.466,0.476,0.486,16700,226
"9673",209922,1992,1,0,"REED COLLEGE",NA,NA,310,173,137,148,58,90,0.52,0.477,0.423,18190,218
"9674",209922,1993,1,0,"REED COLLEGE",NA,NA,328,171,157,148,80,68,0.398,0.451,0.51,19250,251
"9675",209922,1995,1,0,"REED COLLEGE",NA,NA,352,188,164,166,78,88,0.468,0.472,0.476,20760,249
"9676",209922,1996,1,0,"REED COLLEGE",NA,NA,357,200,157,159,59,100,0.5,0.445,0.376,21490,252
"9677",209922,1997,1,0,"REED COLLEGE",NA,NA,315,176,139,146,59,87,0.494,0.463,0.424,22340,212
"9678",209922,1998,1,0,"REED COLLEGE",NA,NA,338,164,174,165,86,79,0.482,0.488,0.494,23120,220
"9679",209922,1999,1,0,"REED COLLEGE",NA,NA,331,182,149,172,78,94,0.516,0.52,0.523,23880,254
"9680",209922,2000,1,0,"REED COLLEGE",NA,NA,358,202,156,204,79,125,0.619,0.57,0.506,24820,234
"9681",209922,2001,1,0,"REED COLLEGE",NA,NA,349,198,151,203,84,119,0.601,0.582,0.556,26060,229
"9682",209922,2002,1,0,"REED COLLEGE",NA,NA,307,160,147,182,79,103,0.644,0.593,0.537,27360,207
"9683",209922,2003,1,0,"REED COLLEGE",NA,NA,297,153,144,169,74,95,0.621,0.569,0.514,29000,195
"9684",209922,2004,1,0,"REED COLLEGE",NA,NA,333,186,147,199,78,121,0.65,0.598,0.531,30670,192
"9685",209922,2005,1,0,"Reed College",NA,NA,348,197,151,204,80,124,0.629,0.586,0.53,32360,222
"9686",209922,2006,1,0,"Reed College",NA,NA,371,207,164,222,91,131,0.633,0.598,0.555,34300,229
"9687",209922,2007,1,0,"Reed College",NA,NA,337,187,150,236,99,137,0.733,0.7,0.66,36190,189
"9688",209922,2008,1,0,"Reed College",NA,NA,329,194,135,219,88,131,0.675,0.666,0.652,37960,164
"9689",209922,2009,1,0,"Reed College",NA,NA,367,192,175,253,122,131,0.682,0.689,0.697,39440,193
"9690",209922,2010,1,0,"Reed College",NA,NA,373,212,161,247,105,142,0.67,0.662,0.652,40940,246
"9691",210146,1991,0,1,"SOUTHERN OREGON STATE COLLEGE",9999,0,553,303,250,66,26,40,0.132,0.119,0.104,2415,491
"9692",210146,1992,0,1,"SOUTHERN OREGON STATE COLLEGE",9999,0,588,301,287,63,24,39,0.13,0.107,0.084,2487,510
"9693",210146,1993,0,1,"SOUTHERN OREGON STATE COLLEGE",9999,0,601,324,277,75,19,56,0.173,0.125,0.069,2667,523
"9694",210146,1995,0,1,"SOUTHERN OREGON STATE COLLEGE",9999,0,661,362,299,89,33,56,0.155,0.135,0.11,2949,554
"9695",210146,1996,0,1,"SOUTHERN OREGON STATE COLLEGE",9999,0,701,388,313,111,48,63,0.162,0.158,0.153,3147,605
"9696",210146,1997,0,1,"SOUTHERN OREGON UNIVERSITY",9999,0,759,426,333,142,47,95,0.223,0.187,0.141,3204,631
"9697",210146,1998,0,1,"SOUTHERN OREGON UNIVERSITY",9999,0,670,403,267,124,40,84,0.208,0.185,0.15,3198,554
"9698",210146,1999,0,1,"SOUTHERN OREGON UNIVERSITY",9999,0,754,431,323,136,46,90,0.209,0.18,0.142,2520,611
"9699",210146,2000,0,1,"SOUTHERN OREGON UNIVERSITY",9999,0,681,390,291,130,45,85,0.218,0.191,0.155,2520,565
"9700",210146,2001,0,1,"SOUTHERN OREGON UNIVERSITY",9999,0,759,436,323,149,47,102,0.234,0.196,0.146,2628,618
"9701",210146,2002,0,1,"SOUTHERN OREGON UNIVERSITY",9999,0,787,412,375,166,56,110,0.267,0.211,0.149,2706,646
"9702",210146,2003,0,1,"SOUTHERN OREGON UNIVERSITY",9999,0,896,497,399,158,51,107,0.215,0.176,0.128,3138,734
"9703",210146,2004,0,1,"SOUTHERN OREGON UNIVERSITY",9999,0,744,409,335,100,30,70,0.171,0.134,0.09,3609,599
"9704",210146,2005,0,1,"Southern Oregon University",9999,0,707,417,290,110,30,80,0.192,0.156,0.103,3720,598
"9705",210146,2006,0,1,"Southern Oregon University",9999,0,707,401,306,110,31,79,0.197,0.156,0.101,3831,568
"9706",210146,2007,0,1,"Southern Oregon University",9999,0,703,405,298,127,37,90,0.222,0.181,0.124,3960,571
"9707",210146,2008,0,1,"Southern Oregon University",9999,0,675,407,268,147,46,101,0.248,0.218,0.172,4326,517
"9708",210146,2009,0,1,"Southern Oregon University",9999,0,652,378,274,131,37,94,0.249,0.201,0.135,4788,516
"9709",210146,2010,0,1,"Southern Oregon University",9999,0,735,435,300,176,55,121,0.278,0.239,0.183,4914,557
"9710",210401,1991,1,0,"WILLAMETTE UNIVERSITY",NA,NA,390,221,169,253,99,154,0.697,0.649,0.586,12480,304
"9711",210401,1992,1,0,"WILLAMETTE UNIVERSITY",NA,NA,385,231,154,256,103,153,0.662,0.665,0.669,13030,308
"9712",210401,1993,1,0,"WILLAMETTE UNIVERSITY",NA,NA,381,218,163,249,101,148,0.679,0.654,0.62,13665,297
"9713",210401,1995,1,0,"WILLAMETTE UNIVERSITY",NA,NA,432,248,184,330,132,198,0.798,0.764,0.717,16400,349
"9714",210401,1996,1,0,"WILLAMETTE UNIVERSITY",NA,NA,419,241,178,304,115,189,0.784,0.726,0.646,18300,321
"9715",210401,1997,1,0,"WILLAMETTE UNIVERSITY",NA,NA,410,224,186,299,131,168,0.75,0.729,0.704,20200,295
"9716",210401,1998,1,0,"WILLAMETTE UNIVERSITY",NA,NA,406,236,170,263,105,158,0.67,0.648,0.618,21000,293
"9717",210401,1999,1,0,"WILLAMETTE UNIVERSITY",NA,NA,363,190,173,242,100,142,0.747,0.667,0.578,21700,224
"9718",210401,2000,1,0,"WILLAMETTE UNIVERSITY",NA,NA,506,292,214,336,124,212,0.726,0.664,0.579,22700,312
"9719",210401,2001,1,0,"WILLAMETTE UNIVERSITY",NA,NA,476,261,215,345,143,202,0.774,0.725,0.665,23150,328
"9720",210401,2002,1,0,"WILLAMETTE UNIVERSITY",NA,NA,353,181,172,210,92,118,0.652,0.595,0.535,24050,207
"9721",210401,2003,1,0,"WILLAMETTE UNIVERSITY",NA,NA,541,312,229,383,143,240,0.769,0.708,0.624,25300,330
"9722",210401,2004,1,0,"WILLAMETTE UNIVERSITY",NA,NA,510,284,226,361,155,206,0.725,0.708,0.686,26690,315
"9723",210401,2005,1,0,"Willamette University",NA,NA,440,240,200,307,130,177,0.738,0.698,0.65,28250,270
"9724",210401,2006,1,0,"Willamette University",NA,NA,482,260,222,333,139,194,0.746,0.691,0.626,29850,286
"9725",210401,2007,1,0,"Willamette University",NA,NA,444,238,206,315,130,185,0.777,0.709,0.631,31760,271
"9726",210401,2008,1,0,"Willamette University",NA,NA,482,278,204,333,129,204,0.734,0.691,0.632,33750,307
"9727",210401,2009,1,0,"Willamette University",NA,NA,541,294,247,384,165,219,0.745,0.71,0.668,35400,358
"9728",210401,2010,1,0,"Willamette University",NA,NA,427,235,192,301,119,182,0.775,0.705,0.62,37150,300
"9729",210429,1991,0,1,"WESTERN OREGON STATE COLLEGE",9999,0,576,367,209,98,22,76,0.207,0.17,0.105,2406,519
"9730",210429,1992,0,1,"WESTERN OREGON STATE COLLEGE",9999,0,626,394,232,112,36,76,0.193,0.179,0.155,2481,569
"9731",210429,1993,0,1,"WESTERN OREGON STATE COLLEGE",9999,0,675,404,271,133,31,102,0.252,0.197,0.114,2637,599
"9732",210429,1995,0,1,"WESTERN OREGON STATE COLLEGE",9999,0,641,380,261,95,22,73,0.192,0.148,0.084,2985,563
"9733",210429,1996,0,1,"WESTERN OREGON STATE COLLEGE",9999,0,742,448,294,107,33,74,0.165,0.144,0.112,3099,640
"9734",210429,1997,0,1,"WESTERN OREGON UNIVERSITY",9999,0,759,481,278,103,35,68,0.141,0.136,0.126,3153,645
"9735",210429,1998,0,1,"WESTERN OREGON UNIVERSITY",9999,0,700,425,275,116,26,90,0.212,0.166,0.095,3198,609
"9736",210429,1999,0,1,"WESTERN OREGON UNIVERSITY",9999,0,770,460,310,141,45,96,0.209,0.183,0.145,2520,664
"9737",210429,2000,0,1,"WESTERN OREGON UNIVERSITY",9999,0,825,524,301,176,55,121,0.231,0.213,0.183,2520,692
"9738",210429,2001,0,1,"WESTERN OREGON UNIVERSITY",9999,0,811,536,275,144,25,119,0.222,0.178,0.091,2622,653
"9739",210429,2002,0,1,"WESTERN OREGON UNIVERSITY",9999,0,769,466,303,142,36,106,0.228,0.185,0.119,2700,649
"9740",210429,2003,0,1,"WESTERN OREGON UNIVERSITY",9999,0,903,555,348,144,37,107,0.193,0.159,0.106,3240,771
"9741",210429,2004,0,1,"WESTERN OREGON UNIVERSITY",9999,0,795,447,348,138,55,83,0.186,0.174,0.158,3240,635
"9742",210429,2005,0,1,"Western Oregon University",9999,0,849,511,338,132,36,96,0.188,0.155,0.107,3366,658
"9743",210429,2006,0,1,"Western Oregon University",9999,0,750,485,265,150,40,110,0.227,0.2,0.151,3510,557
"9744",210429,2007,0,1,"Western Oregon University",9999,0,916,527,389,184,54,130,0.247,0.201,0.139,4500,679
"9745",210429,2008,0,1,"Western Oregon University",9999,0,882,524,358,197,58,139,0.265,0.223,0.162,5175,658
"9746",210429,2009,0,1,"Western Oregon University",9999,0,933,553,380,192,39,153,0.277,0.206,0.103,5640,691
"9747",210429,2010,0,1,"Western Oregon University",9999,0,1039,636,403,204,45,159,0.25,0.196,0.112,6135,722
"9748",210571,1991,1,0,"ALBRIGHT COLLEGE",NA,NA,236,120,116,143,58,85,0.708,0.606,0.5,13560,199
"9749",210571,1992,1,0,"ALBRIGHT COLLEGE",NA,NA,310,135,175,160,81,79,0.585,0.516,0.463,13960,267
"9750",210571,1993,1,0,"ALBRIGHT COLLEGE",NA,NA,227,140,87,147,50,97,0.693,0.648,0.575,15010,204
"9751",210571,1995,1,0,"ALBRIGHT COLLEGE",NA,NA,312,153,159,169,66,103,0.673,0.542,0.415,16575,260
"9752",210571,1996,1,0,"ALBRIGHT COLLEGE",NA,NA,354,190,164,215,77,138,0.726,0.607,0.47,17395,310
"9753",210571,1997,1,0,"ALBRIGHT COLLEGE",NA,NA,295,137,158,176,83,93,0.679,0.597,0.525,18310,248
"9754",210571,1998,1,0,"ALBRIGHT COLLEGE",NA,NA,355,187,168,176,71,105,0.561,0.496,0.423,18890,301
"9755",210571,1999,1,0,"ALBRIGHT COLLEGE",NA,NA,392,242,150,203,61,142,0.587,0.518,0.407,18910,311
"9756",210571,2000,1,0,"ALBRIGHT COLLEGE",NA,NA,407,231,176,207,84,123,0.532,0.509,0.477,19760,319
"9757",210571,2001,1,0,"ALBRIGHT COLLEGE",NA,NA,402,243,159,215,75,140,0.576,0.535,0.472,20750,323
"9758",210571,2002,1,0,"ALBRIGHT COLLEGE",NA,NA,453,250,203,254,104,150,0.6,0.561,0.512,21790,352
"9759",210571,2003,1,0,"ALBRIGHT COLLEGE",NA,NA,456,259,197,252,96,156,0.602,0.553,0.487,22880,363
"9760",210571,2004,1,0,"ALBRIGHT COLLEGE",NA,NA,505,319,186,268,86,182,0.571,0.531,0.462,24030,389
"9761",210571,2005,1,0,"Albright College",NA,NA,450,254,196,234,85,149,0.587,0.52,0.434,25232,350
"9762",210571,2006,1,0,"Albright College",NA,NA,458,233,225,210,87,123,0.528,0.459,0.387,26620,347
"9763",210571,2007,1,0,"Albright College",NA,NA,512,307,205,247,90,157,0.511,0.482,0.439,28084,412
"9764",210571,2008,1,0,"Albright College",NA,NA,505,260,245,224,86,138,0.531,0.444,0.351,29770,347
"9765",210571,2009,1,0,"Albright College",NA,NA,541,317,224,268,83,185,0.584,0.495,0.371,30800,376
"9766",210571,2010,1,0,"Albright College",NA,NA,485,255,230,230,90,140,0.549,0.474,0.391,31940,325
"9767",210669,1991,1,0,"ALLEGHENY COLLEGE",NA,NA,606,289,317,354,173,181,0.626,0.584,0.546,14850,545
"9768",210669,1992,1,0,"ALLEGHENY COLLEGE",NA,NA,471,251,220,295,114,181,0.721,0.626,0.518,15750,428
"9769",210669,1993,1,0,"ALLEGHENY COLLEGE",NA,NA,481,247,234,301,126,175,0.708,0.626,0.538,16700,446
"9770",210669,1995,1,0,"ALLEGHENY COLLEGE",NA,NA,564,284,280,353,162,191,0.672,0.626,0.579,18020,516
"9771",210669,1996,1,0,"ALLEGHENY COLLEGE",NA,NA,523,311,212,346,125,221,0.711,0.662,0.59,18720,505
"9772",210669,1997,1,0,"ALLEGHENY COLLEGE",NA,NA,541,289,252,328,139,189,0.654,0.606,0.552,19360,510
"9773",210669,1998,1,0,"ALLEGHENY COLLEGE",NA,NA,545,272,273,321,144,177,0.651,0.589,0.527,20020,487
"9774",210669,1999,1,0,"ALLEGHENY COLLEGE",NA,NA,562,284,278,374,167,207,0.729,0.665,0.601,20410,521
"9775",210669,2000,1,0,"ALLEGHENY COLLEGE",NA,NA,561,291,270,393,175,218,0.749,0.701,0.648,21290,538
"9776",210669,2001,1,0,"ALLEGHENY COLLEGE",NA,NA,486,271,215,312,128,184,0.679,0.642,0.595,22210,443
"9777",210669,2002,1,0,"ALLEGHENY COLLEGE",NA,NA,536,271,265,374,165,209,0.771,0.698,0.623,23100,500
"9778",210669,2003,1,0,"ALLEGHENY COLLEGE",NA,NA,478,234,244,317,143,174,0.744,0.663,0.586,24100,434
"9779",210669,2004,1,0,"ALLEGHENY COLLEGE",NA,NA,647,341,306,465,206,259,0.76,0.719,0.673,25250,604
"9780",210669,2005,1,0,"Allegheny College",NA,NA,561,311,250,424,181,243,0.781,0.756,0.724,26650,515
"9781",210669,2006,1,0,"Allegheny College",NA,NA,570,322,248,398,159,239,0.742,0.698,0.641,28000,528
"9782",210669,2007,1,0,"Allegheny College",NA,NA,581,351,230,431,159,272,0.775,0.742,0.691,29680,517
"9783",210669,2008,1,0,"Allegheny College",NA,NA,562,306,256,412,179,233,0.761,0.733,0.699,31680,481
"9784",210669,2009,1,0,"Allegheny College",NA,NA,580,299,281,395,177,218,0.729,0.681,0.63,33240,493
"9785",210669,2010,1,0,"Allegheny College",NA,NA,594,332,262,415,173,242,0.729,0.699,0.66,34490,489
"9786",210775,1991,1,0,"ALVERNIA COLLEGE",NA,NA,194,128,66,56,16,40,0.312,0.289,0.242,6935,188
"9787",210775,1992,1,0,"ALVERNIA COLLEGE",NA,NA,182,103,79,26,7,19,0.184,0.143,0.089,7995,172
"9788",210775,1993,1,0,"ALVERNIA COLLEGE",NA,NA,157,103,54,48,14,34,0.33,0.306,0.259,8419,152
"9789",210775,1995,1,0,"ALVERNIA COLLEGE",NA,NA,150,76,74,46,14,32,0.421,0.307,0.189,9850,133
"9790",210775,1996,1,0,"ALVERNIA COLLEGE",NA,NA,143,73,70,44,16,28,0.384,0.308,0.229,10700,137
"9791",210775,1997,1,0,"ALVERNIA COLLEGE",NA,NA,155,95,60,64,26,38,0.4,0.413,0.433,11320,145
"9792",210775,1998,1,0,"ALVERNIA COLLEGE",NA,NA,168,93,75,56,16,40,0.43,0.333,0.213,11680,149
"9793",210775,1999,1,0,"ALVERNIA COLLEGE",NA,NA,204,101,103,79,34,45,0.446,0.387,0.33,11730,169
"9794",210775,2000,1,0,"ALVERNIA COLLEGE",NA,NA,236,149,87,70,22,48,0.322,0.297,0.253,12950,197
"9795",210775,2001,1,0,"ALVERNIA COLLEGE",NA,NA,248,159,89,90,28,62,0.39,0.363,0.315,14000,213
"9796",210775,2002,1,0,"ALVERNIA COLLEGE",NA,NA,242,153,89,89,29,60,0.392,0.368,0.326,15000,197
"9797",210775,2003,1,0,"ALVERNIA COLLEGE",NA,NA,278,165,113,99,32,67,0.406,0.356,0.283,16200,240
"9798",210775,2004,1,0,"ALVERNIA COLLEGE",NA,NA,310,197,113,123,29,94,0.477,0.397,0.257,17500,242
"9799",210775,2005,1,0,"Alvernia College",NA,NA,262,149,113,100,35,65,0.436,0.382,0.31,18900,213
"9800",210775,2006,1,0,"Alvernia College",NA,NA,300,188,112,114,43,71,0.378,0.38,0.384,20220,237
"9801",210775,2007,1,0,"Alvernia College",NA,NA,302,165,137,107,48,59,0.358,0.354,0.35,21400,268
"9802",210775,2008,1,0,"Alvernia College",NA,NA,383,233,150,148,44,104,0.446,0.386,0.293,22800,329
"9803",210775,2009,1,0,"Alvernia University",NA,NA,328,188,140,124,53,71,0.378,0.378,0.379,23900,264
"9804",210775,2010,1,0,"Alvernia University",NA,NA,388,268,120,142,39,103,0.384,0.366,0.325,24980,322
"9805",211088,1991,1,0,"BEAVER COLLEGE",NA,NA,140,110,30,92,13,79,0.718,0.657,0.433,10960,117
"9806",211088,1992,1,0,"BEAVER COLLEGE",NA,NA,163,120,43,81,15,66,0.55,0.497,0.349,11710,140
"9807",211088,1993,1,0,"BEAVER COLLEGE",NA,NA,227,166,61,131,35,96,0.578,0.577,0.574,12510,187
"9808",211088,1995,1,0,"BEAVER COLLEGE",NA,NA,257,186,71,145,36,109,0.586,0.564,0.507,13970,213
"9809",211088,1996,1,0,"BEAVER COLLEGE",NA,NA,292,219,73,131,29,102,0.466,0.449,0.397,14870,217
"9810",211088,1997,1,0,"BEAVER COLLEGE",NA,NA,260,191,69,142,34,108,0.565,0.546,0.493,15840,203
"9811",211088,1998,1,0,"BEAVER COLLEGE",NA,NA,334,248,86,189,46,143,0.577,0.566,0.535,16520,272
"9812",211088,1999,1,0,"BEAVER COLLEGE",NA,NA,307,238,69,154,28,126,0.529,0.502,0.406,16880,262
"9813",211088,2000,1,0,"BEAVER COLLEGE",NA,NA,294,228,66,147,27,120,0.526,0.5,0.409,17550,228
"9814",211088,2001,1,0,"ARCADIA UNIVERSITY",NA,NA,293,203,90,158,47,111,0.547,0.539,0.522,18390,244
"9815",211088,2002,1,0,"ARCADIA UNIVERSITY",NA,NA,399,308,91,237,55,182,0.591,0.594,0.604,19660,327
"9816",211088,2003,1,0,"ARCADIA UNIVERSITY",NA,NA,489,360,129,259,77,182,0.506,0.53,0.597,20990,409
"9817",211088,2004,1,0,"ARCADIA UNIVERSITY",NA,NA,476,343,133,247,67,180,0.525,0.519,0.504,22440,398
"9818",211088,2005,1,0,"Arcadia University",NA,NA,432,315,117,232,59,173,0.549,0.537,0.504,23990,353
"9819",211088,2006,1,0,"Arcadia University",NA,NA,572,452,120,336,72,264,0.584,0.587,0.6,25650,470
"9820",211088,2007,1,0,"Arcadia University",NA,NA,476,364,112,253,53,200,0.549,0.532,0.473,27440,395
"9821",211088,2008,1,0,"Arcadia University",NA,NA,593,434,159,294,73,221,0.509,0.496,0.459,29340,302
"9822",211088,2009,1,0,"Arcadia University",NA,NA,529,381,148,257,70,187,0.491,0.486,0.473,30780,398
"9823",211088,2010,1,0,"Arcadia University",NA,NA,552,397,155,317,75,242,0.61,0.574,0.484,32140,404
"9824",211158,1991,1,0,"BLOOMSBURG UNIVERSITY OF PENNSYLVANIA",NA,NA,1080,664,416,443,132,311,0.468,0.41,0.317,2968,1010
"9825",211158,1992,1,0,"BLOOMSBURG UNIVERSITY OF PENNSYLVANIA",NA,NA,1047,696,351,423,87,336,0.483,0.404,0.248,3068,951
"9826",211158,1993,1,0,"BLOOMSBURG UNIVERSITY OF PENNSYLVANIA",NA,NA,1017,615,402,379,115,264,0.429,0.373,0.286,3458,925
"9827",211158,1995,1,0,"BLOOMSBURG UNIVERSITY OF PENNSYLVANIA",NA,NA,1054,689,365,372,88,284,0.412,0.353,0.241,3915,974
"9828",211158,1996,1,0,"BLOOMSBURG UNIVERSITY OF PENNSYLVANIA",NA,NA,1556,994,562,567,147,420,0.422,0.364,0.262,4162,1469
"9829",211158,1997,1,0,"BLOOMSBURG UNIVERSITY OF PENNSYLVANIA",NA,NA,1355,893,462,459,125,334,0.374,0.339,0.271,4277,1242
"9830",211158,1998,1,0,"BLOOMSBURG UNIVERSITY OF PENNSYLVANIA",NA,NA,1377,890,487,465,102,363,0.408,0.338,0.209,4277,1261
"9831",211158,1999,1,0,"BLOOMSBURG UNIVERSITY OF PENNSYLVANIA",NA,NA,1402,891,511,527,164,363,0.407,0.376,0.321,3618,1299
"9832",211158,2000,1,0,"BLOOMSBURG UNIVERSITY OF PENNSYLVANIA",NA,NA,1414,912,502,587,153,434,0.476,0.415,0.305,3792,1325
"9833",211158,2001,1,0,"BLOOMSBURG UNIVERSITY OF PENNSYLVANIA",NA,NA,1684,1021,663,646,183,463,0.454,0.384,0.276,4016,1564
"9834",211158,2002,1,0,"BLOOMSBURG UNIVERSITY OF PENNSYLVANIA",NA,NA,1478,938,540,650,169,481,0.513,0.44,0.313,4378,1337
"9835",211158,2003,1,0,"BLOOMSBURG UNIVERSITY OF PENNSYLVANIA",NA,NA,1665,1000,665,677,201,476,0.476,0.407,0.302,4598,1481
"9836",211158,2004,1,0,"BLOOMSBURG UNIVERSITY OF PENNSYLVANIA",NA,NA,1533,947,586,631,198,433,0.457,0.412,0.338,4810,1296
"9837",211158,2005,1,0,"Bloomsburg University of Pennsylvania",NA,NA,1690,1050,640,693,207,486,0.463,0.41,0.323,4906,1411
"9838",211158,2006,1,0,"Bloomsburg University of Pennsylvania",NA,NA,1630,987,643,696,221,475,0.481,0.427,0.344,5038,1329
"9839",211158,2007,1,0,"Bloomsburg University of Pennsylvania",NA,NA,1679,969,710,710,237,473,0.488,0.423,0.334,5177,1332
"9840",211158,2008,1,0,"Bloomsburg University of Pennsylvania",NA,NA,1805,1028,777,781,263,518,0.504,0.433,0.338,5358,1432
"9841",211158,2009,1,0,"Bloomsburg University of Pennsylvania",NA,NA,2031,1221,810,772,252,520,0.426,0.38,0.311,5554,1554
"9842",211158,2010,1,0,"Bloomsburg University of Pennsylvania",NA,NA,2136,1263,873,808,251,557,0.441,0.378,0.288,5804,1768
"9843",211291,1991,1,0,"BUCKNELL UNIVERSITY",NA,NA,907,410,497,776,408,368,0.898,0.856,0.821,15650,827
"9844",211291,1992,1,0,"BUCKNELL UNIVERSITY",NA,NA,890,426,464,739,376,363,0.852,0.83,0.81,16670,835
"9845",211291,1993,1,0,"BUCKNELL UNIVERSITY",NA,NA,854,454,400,717,324,393,0.866,0.84,0.81,17730,785
"9846",211291,1995,1,0,"BUCKNELL UNIVERSITY",NA,NA,910,474,436,736,342,394,0.831,0.809,0.784,19470,788
"9847",211291,1996,1,0,"BUCKNELL UNIVERSITY",NA,NA,895,440,455,761,365,396,0.9,0.85,0.802,20360,798
"9848",211291,1997,1,0,"BUCKNELL UNIVERSITY",NA,NA,898,426,472,752,380,372,0.873,0.837,0.805,21210,788
"9849",211291,1998,1,0,"BUCKNELL UNIVERSITY",NA,NA,954,468,486,840,427,413,0.883,0.881,0.879,22005,829
"9850",211291,1999,1,0,"BUCKNELL UNIVERSITY",NA,NA,886,425,461,764,396,368,0.866,0.862,0.859,22740,763
"9851",211291,2000,1,0,"BUCKNELL UNIVERSITY",NA,NA,914,454,460,773,376,397,0.874,0.846,0.817,23698,774
"9852",211291,2001,1,0,"BUCKNELL UNIVERSITY",NA,NA,913,468,445,784,367,417,0.891,0.859,0.825,25144,787
"9853",211291,2002,1,0,"BUCKNELL UNIVERSITY",NA,NA,914,455,459,764,371,393,0.864,0.836,0.808,27340,772
"9854",211291,2003,1,0,"BUCKNELL UNIVERSITY",NA,NA,906,462,444,794,374,420,0.909,0.876,0.842,28764,752
"9855",211291,2004,1,0,"BUCKNELL UNIVERSITY",NA,NA,906,447,459,813,397,416,0.931,0.897,0.865,30534,735
"9856",211291,2005,1,0,"Bucknell University",NA,NA,920,504,416,804,352,452,0.897,0.874,0.846,32592,727
"9857",211291,2006,1,0,"Bucknell University",NA,NA,921,458,463,792,383,409,0.893,0.86,0.827,34731,736
"9858",211291,2007,1,0,"Bucknell University",NA,NA,887,441,446,774,373,401,0.909,0.873,0.836,37934,743
"9859",211291,2008,1,0,"Bucknell University",NA,NA,956,529,427,814,357,457,0.864,0.851,0.836,39434,789
"9860",211291,2009,1,0,"Bucknell University",NA,NA,920,466,454,780,371,409,0.878,0.848,0.817,40594,765
"9861",211291,2010,1,0,"Bucknell University",NA,NA,929,491,438,782,355,427,0.87,0.842,0.811,42112,741
"9862",211352,1991,1,0,"CABRINI COLLEGE",NA,NA,137,93,44,73,19,54,0.581,0.533,0.432,8830,129
"9863",211352,1992,1,0,"CABRINI COLLEGE",NA,NA,161,115,46,91,24,67,0.583,0.565,0.522,9500,145
"9864",211352,1993,1,0,"CABRINI COLLEGE",NA,NA,224,158,66,115,29,86,0.544,0.513,0.439,10232,210
"9865",211352,1995,1,0,"CABRINI COLLEGE",NA,NA,218,150,68,110,25,85,0.567,0.505,0.368,11600,183
"9866",211352,1996,1,0,"CABRINI COLLEGE",NA,NA,247,186,61,114,23,91,0.489,0.462,0.377,12160,205
"9867",211352,1997,1,0,"CABRINI COLLEGE",NA,NA,339,231,108,160,39,121,0.524,0.472,0.361,12700,301
"9868",211352,1998,1,0,"CABRINI COLLEGE",NA,NA,304,209,95,152,35,117,0.56,0.5,0.368,14650,261
"9869",211352,1999,1,0,"CABRINI COLLEGE",NA,NA,248,163,85,124,30,94,0.577,0.5,0.353,15250,183
"9870",211352,2000,1,0,"CABRINI COLLEGE",NA,NA,359,221,138,161,50,111,0.502,0.448,0.362,16150,298
"9871",211352,2001,1,0,"CABRINI COLLEGE",NA,NA,374,221,153,166,50,116,0.525,0.444,0.327,17340,297
"9872",211352,2002,1,0,"CABRINI COLLEGE",NA,NA,408,277,131,191,53,138,0.498,0.468,0.405,18470,329
"9873",211352,2003,1,0,"CABRINI COLLEGE",NA,NA,401,270,131,184,55,129,0.478,0.459,0.42,19670,344
"9874",211352,2004,1,0,"CABRINI COLLEGE",NA,NA,390,257,133,155,45,110,0.428,0.397,0.338,21450,303
"9875",211352,2005,1,0,"Cabrini College",NA,NA,526,385,141,257,60,197,0.512,0.489,0.426,23200,468
"9876",211352,2006,1,0,"Cabrini College",NA,NA,529,337,192,232,63,169,0.501,0.439,0.328,25120,449
"9877",211352,2007,1,0,"Cabrini College",NA,NA,513,329,184,202,66,136,0.413,0.394,0.359,27200,416
"9878",211352,2008,1,0,"Cabrini College",NA,NA,503,341,162,210,62,148,0.434,0.417,0.383,29100,405
"9879",211352,2009,1,0,"Cabrini College",NA,NA,357,237,120,178,57,121,0.51,0.499,0.475,30120,245
"9880",211352,2010,1,0,"Cabrini College",NA,NA,339,222,117,174,47,127,0.572,0.513,0.402,31174,259
"9881",211361,1991,1,0,"CALIFORNIA UNIVERSITY OF PENNSYLVANIA",NA,NA,1107,565,542,141,48,93,0.165,0.127,0.089,3128,1018
"9882",211361,1992,1,0,"CALIFORNIA UNIVERSITY OF PENNSYLVANIA",NA,NA,962,436,526,139,45,94,0.216,0.144,0.086,3384,888
"9883",211361,1993,1,0,"CALIFORNIA UNIVERSITY OF PENNSYLVANIA",NA,NA,951,401,550,145,55,90,0.224,0.152,0.1,3760,893
"9884",211361,1995,1,0,"CALIFORNIA UNIVERSITY OF PENNSYLVANIA",NA,NA,892,465,427,124,45,79,0.17,0.139,0.105,4136,825
"9885",211361,1996,1,0,"CALIFORNIA UNIVERSITY OF PENNSYLVANIA",NA,NA,805,398,407,140,47,93,0.234,0.174,0.115,4304,731
"9886",211361,1997,1,0,"CALIFORNIA UNIVERSITY OF PENNSYLVANIA",NA,NA,942,446,496,163,64,99,0.222,0.173,0.129,4475,857
"9887",211361,1998,1,0,"CALIFORNIA UNIVERSITY OF PENNSYLVANIA",NA,NA,931,480,451,180,68,112,0.233,0.193,0.151,4545,868
"9888",211361,1999,1,0,"CALIFORNIA UNIVERSITY OF PENNSYLVANIA",NA,NA,924,484,440,162,48,114,0.236,0.175,0.109,3618,869
"9889",211361,2000,1,0,"CALIFORNIA UNIVERSITY OF PENNSYLVANIA",NA,NA,840,398,442,187,83,104,0.261,0.223,0.188,3792,789
"9890",211361,2001,1,0,"CALIFORNIA UNIVERSITY OF PENNSYLVANIA",NA,NA,817,413,404,208,84,124,0.3,0.255,0.208,4016,754
"9891",211361,2002,1,0,"CALIFORNIA UNIVERSITY OF PENNSYLVANIA",NA,NA,893,464,429,224,95,129,0.278,0.251,0.221,4378,622
"9892",211361,2003,1,0,"CALIFORNIA UNIVERSITY OF PENNSYLVANIA",NA,NA,982,520,462,251,105,146,0.281,0.256,0.227,4598,708
"9893",211361,2004,1,0,"CALIFORNIA UNIVERSITY OF PENNSYLVANIA",NA,NA,1038,519,519,293,127,166,0.32,0.282,0.245,4810,780
"9894",211361,2005,1,0,"California University of Pennsylvania",NA,NA,1247,640,607,298,119,179,0.28,0.239,0.196,4906,950
"9895",211361,2006,1,0,"California University of Pennsylvania",NA,NA,1260,685,575,313,124,189,0.276,0.248,0.216,5038,897
"9896",211361,2007,1,0,"California University of Pennsylvania",NA,NA,1250,622,628,281,124,157,0.252,0.225,0.197,5178,946
"9897",211361,2008,1,0,"California University of Pennsylvania",NA,NA,1363,748,615,355,130,225,0.301,0.26,0.211,5358,1091
"9898",211361,2009,1,0,"California University of Pennsylvania",NA,NA,1373,679,694,323,156,167,0.246,0.235,0.225,5554,1009
"9899",211361,2010,1,0,"California University of Pennsylvania",NA,NA,1351,711,640,332,136,196,0.276,0.246,0.212,5804,1107
"9900",211431,1991,1,0,"CARLOW COLLEGE",NA,NA,144,138,6,59,2,57,0.413,0.41,0.333,8752,129
"9901",211431,1992,1,0,"CARLOW COLLEGE",NA,NA,159,148,11,50,2,48,0.324,0.314,0.182,9190,140
"9902",211431,1993,1,0,"CARLOW COLLEGE",NA,NA,169,158,11,80,3,77,0.487,0.473,0.273,9650,151
"9903",211431,1995,1,0,"CARLOW COLLEGE",NA,NA,125,122,3,57,2,55,0.451,0.456,0.667,10588,106
"9904",211431,1996,1,0,"CARLOW COLLEGE",NA,NA,148,145,3,65,0,65,0.448,0.439,0,11064,119
"9905",211431,1997,1,0,"CARLOW COLLEGE",NA,NA,142,139,3,50,1,49,0.352,0.352,0.333,11708,117
"9906",211431,1998,1,0,"CARLOW COLLEGE",NA,NA,163,157,6,43,3,40,0.255,0.264,0.5,12332,118
"9907",211431,1999,1,0,"CARLOW COLLEGE",NA,NA,130,128,2,47,0,47,0.367,0.362,0,12450,102
"9908",211431,2000,1,0,"CARLOW COLLEGE",NA,NA,180,178,2,85,0,85,0.478,0.472,0,12950,140
"9909",211431,2001,1,0,"CARLOW COLLEGE",NA,NA,177,170,7,65,0,65,0.382,0.367,0,13468,146
"9910",211431,2002,1,0,"CARLOW COLLEGE",NA,NA,238,231,7,79,0,79,0.342,0.332,0,14006,179
"9911",211431,2003,1,0,"CARLOW COLLEGE",NA,NA,236,229,7,71,3,68,0.297,0.301,0.429,14776,183
"9912",211431,2004,1,0,"CARLOW UNIVERSITY",NA,NA,231,226,5,87,1,86,0.38,0.377,0.2,15806,187
"9913",211431,2005,1,0,"Carlow University",NA,NA,273,264,9,102,3,99,0.375,0.374,0.333,16754,234
"9914",211431,2006,1,0,"Carlow University",NA,NA,262,250,12,114,3,111,0.444,0.435,0.25,17760,201
"9915",211431,2007,1,0,"Carlow University",NA,NA,199,194,5,93,0,93,0.479,0.467,0,18736,149
"9916",211431,2008,1,0,"Carlow University",NA,NA,226,215,11,99,2,97,0.451,0.438,0.182,19860,153
"9917",211431,2009,1,0,"Carlow University",NA,NA,250,245,5,100,1,99,0.404,0.4,0.2,20854,183
"9918",211431,2010,1,0,"Carlow University",NA,NA,189,181,8,76,1,75,0.414,0.402,0.125,22400,103
"9919",211440,1991,1,0,"CARNEGIE MELLON UNIVERSITY",NA,NA,1170,335,835,657,464,193,0.576,0.562,0.556,15350,721
"9920",211440,1992,1,0,"CARNEGIE MELLON UNIVERSITY",NA,NA,1141,354,787,666,440,226,0.638,0.584,0.559,16000,626
"9921",211440,1993,1,0,"CARNEGIE MELLON UNIVERSITY",NA,NA,1189,358,831,752,510,242,0.676,0.632,0.614,16960,590
"9922",211440,1995,1,0,"CARNEGIE MELLON UNIVERSITY",NA,NA,1233,376,857,772,515,257,0.683,0.626,0.601,18600,605
"9923",211440,1996,1,0,"CARNEGIE MELLON UNIVERSITY",NA,NA,1386,472,914,903,563,340,0.72,0.652,0.616,19500,667
"9924",211440,1997,1,0,"CARNEGIE MELLON UNIVERSITY",NA,NA,1270,464,806,841,522,319,0.688,0.662,0.648,20375,597
"9925",211440,1998,1,0,"CARNEGIE MELLON UNIVERSITY",NA,NA,1303,445,858,848,539,309,0.694,0.651,0.628,21405,574
"9926",211440,1999,1,0,"CARNEGIE MELLON UNIVERSITY",NA,NA,1255,487,768,833,491,342,0.702,0.664,0.639,22100,564
"9927",211440,2000,1,0,"CARNEGIE MELLON UNIVERSITY",NA,NA,1325,516,809,920,537,383,0.742,0.694,0.664,24600,548
"9928",211440,2001,1,0,"CARNEGIE MELLON UNIVERSITY",NA,NA,1317,534,783,927,526,401,0.751,0.704,0.672,25670,565
"9929",211440,2002,1,0,"CARNEGIE MELLON UNIVERSITY",NA,NA,1364,542,822,957,557,400,0.738,0.702,0.678,26910,603
"9930",211440,2003,1,0,"CARNEGIE MELLON UNIVERSITY",NA,NA,1338,528,810,903,532,371,0.703,0.675,0.657,28766,563
"9931",211440,2004,1,0,"CARNEGIE MELLON UNIVERSITY",NA,NA,1359,510,849,940,579,361,0.708,0.692,0.682,30650,562
"9932",211440,2005,1,0,"Carnegie Mellon University",NA,NA,1408,533,875,1000,611,389,0.73,0.71,0.698,31650,600
"9933",211440,2006,1,0,"Carnegie Mellon University",NA,NA,1421,552,869,1033,630,403,0.73,0.727,0.725,33050,567
"9934",211440,2007,1,0,"Carnegie Mellon University",NA,NA,1407,554,853,1046,612,434,0.783,0.743,0.717,35580,570
"9935",211440,2008,1,0,"Carnegie Mellon University",NA,NA,1462,625,837,1050,580,470,0.752,0.718,0.693,38430,565
"9936",211440,2009,1,0,"Carnegie Mellon University",NA,NA,1423,611,812,1026,558,468,0.766,0.721,0.687,39470,623
"9937",211440,2010,1,0,"Carnegie Mellon University",NA,NA,1484,619,865,1119,630,489,0.79,0.754,0.728,41500,616
"9938",211468,1991,1,0,"CEDAR CREST COLLEGE",NA,NA,120,120,0,62,0,62,0.517,0.517,NA,12210,110
"9939",211468,1992,1,0,"CEDAR CREST COLLEGE",NA,NA,187,186,1,74,0,74,0.398,0.396,0,12940,157
"9940",211468,1993,1,0,"CEDAR CREST COLLEGE",NA,NA,198,196,2,83,1,82,0.418,0.419,0.5,13720,177
"9941",211468,1995,1,0,"CEDAR CREST COLLEGE",NA,NA,164,164,0,90,0,90,0.549,0.549,NA,14770,140
"9942",211468,1996,1,0,"CEDAR CREST COLLEGE",NA,NA,329,328,1,189,0,189,0.576,0.574,0,15210,274
"9943",211468,1997,1,0,"CEDAR CREST COLLEGE",NA,NA,195,194,1,122,1,121,0.624,0.626,1,15920,155
"9944",211468,1998,1,0,"CEDAR CREST COLLEGE",NA,NA,187,185,2,104,1,103,0.557,0.556,0.5,16550,156
"9945",211468,1999,1,0,"CEDAR CREST COLLEGE",NA,NA,218,218,0,115,0,115,0.527,0.528,NA,17100,166
"9946",211468,2000,1,0,"CEDAR CREST COLLEGE",NA,NA,200,198,2,109,0,109,0.55,0.545,0,17790,141
"9947",211468,2001,1,0,"CEDAR CREST COLLEGE",NA,NA,170,170,0,78,0,78,0.459,0.459,NA,18680,143
"9948",211468,2002,1,0,"CEDAR CREST COLLEGE",NA,NA,185,185,0,89,0,89,0.481,0.481,NA,19615,152
"9949",211468,2003,1,0,"CEDAR CREST COLLEGE",NA,NA,233,233,0,105,0,105,0.451,0.451,NA,20596,198
"9950",211468,2004,1,0,"CEDAR CREST COLLEGE",NA,NA,237,237,0,114,0,114,0.481,0.481,NA,21630,205
"9951",211468,2005,1,0,"Cedar Crest College",NA,NA,203,202,1,82,1,81,0.401,0.404,1,22712,179
"9952",211468,2006,1,0,"Cedar Crest College",NA,NA,254,251,3,124,1,123,0.49,0.488,0.333,23848,220
"9953",211468,2007,1,0,"Cedar Crest College",NA,NA,222,221,1,112,0,112,0.507,0.505,0,25040,193
"9954",211468,2008,1,0,"Cedar Crest College",NA,NA,194,194,0,114,0,114,0.588,0.588,NA,26668,156
"9955",211468,2009,1,0,"Cedar Crest College",NA,NA,195,194,1,84,0,84,0.433,0.431,0,27735,157
"9956",211468,2010,1,0,"Cedar Crest College",NA,NA,91,90,1,36,0,36,0.4,0.396,0,28567,62
"9957",211556,1991,1,0,"CHATHAM COLLEGE",NA,NA,100,100,0,52,0,52,0.52,0.52,NA,11065,80
"9958",211556,1992,1,0,"CHATHAM COLLEGE",NA,NA,89,89,0,42,0,42,0.472,0.472,NA,11990,75
"9959",211556,1993,1,0,"CHATHAM COLLEGE",NA,NA,87,87,0,41,0,41,0.471,0.471,NA,12630,81
"9960",211556,1995,1,0,"CHATHAM COLLEGE",NA,NA,109,109,0,48,0,48,0.44,0.44,NA,14196,94
"9961",211556,1996,1,0,"CHATHAM COLLEGE",NA,NA,102,102,0,60,0,60,0.588,0.588,NA,14616,87
"9962",211556,1997,1,0,"CHATHAM COLLEGE",NA,NA,92,92,0,51,0,51,0.554,0.554,NA,15340,79
"9963",211556,1998,1,0,"CHATHAM COLLEGE",NA,NA,142,142,0,63,0,63,0.444,0.444,NA,16406,118
"9964",211556,1999,1,0,"CHATHAM COLLEGE",NA,NA,126,126,0,62,0,62,0.492,0.492,NA,17388,87
"9965",211556,2000,1,0,"CHATHAM COLLEGE",NA,NA,138,138,0,54,0,54,0.391,0.391,NA,18080,112
"9966",211556,2001,1,0,"CHATHAM COLLEGE",NA,NA,133,133,0,56,0,56,0.421,0.421,NA,18804,99
"9967",211556,2002,1,0,"CHATHAM COLLEGE",NA,NA,108,108,0,49,0,49,0.454,0.454,NA,19576,77
"9968",211556,2003,1,0,"CHATHAM COLLEGE",NA,NA,74,74,0,38,0,38,0.514,0.514,NA,20360,58
"9969",211556,2004,1,0,"CHATHAM COLLEGE",NA,NA,90,90,0,50,0,50,0.556,0.556,NA,21780,52
"9970",211556,2005,1,0,"Chatham College",NA,NA,116,116,0,57,0,57,0.491,0.491,NA,22870,78
"9971",211556,2006,1,0,"Chatham University",NA,NA,147,147,0,75,0,75,0.51,0.51,NA,24014,100
"9972",211556,2007,1,0,"Chatham University",NA,NA,175,175,0,77,0,77,0.44,0.44,NA,25216,122
"9973",211556,2008,1,0,"Chatham University",NA,NA,176,176,0,82,0,82,0.466,0.466,NA,26476,104
"9974",211556,2009,1,0,"Chatham University",NA,NA,131,131,0,66,0,66,0.504,0.504,NA,27270,78
"9975",211556,2010,1,0,"Chatham University",NA,NA,150,150,0,72,0,72,0.48,0.48,NA,28088,73
"9976",211583,1991,1,0,"CHESTNUT HILL COLLEGE",NA,NA,111,111,0,54,0,54,0.486,0.486,NA,8250,71
"9977",211583,1992,1,0,"CHESTNUT HILL COLLEGE",NA,NA,145,145,0,76,0,76,0.524,0.524,NA,8950,116
"9978",211583,1993,1,0,"CHESTNUT HILL COLLEGE",NA,NA,132,132,0,73,0,73,0.553,0.553,NA,9525,91
"9979",211583,1995,1,0,"CHESTNUT HILL COLLEGE",NA,NA,83,83,0,53,0,53,0.639,0.639,NA,11865,57
"9980",211583,1996,1,0,"CHESTNUT HILL COLLEGE",NA,NA,77,77,0,46,0,46,0.597,0.597,NA,13148,47
"9981",211583,1997,1,0,"CHESTNUT HILL COLLEGE",NA,NA,92,92,0,51,0,51,0.554,0.554,NA,14585,67
"9982",211583,1998,1,0,"CHESTNUT HILL COLLEGE",NA,NA,95,93,2,42,0,42,0.452,0.442,0,15198,48
"9983",211583,1999,1,0,"CHESTNUT HILL COLLEGE",NA,NA,102,101,1,45,1,44,0.436,0.441,1,15454,63
"9984",211583,2000,1,0,"CHESTNUT HILL COLLEGE",NA,NA,104,98,6,51,1,50,0.51,0.49,0.167,16200,51
"9985",211583,2001,1,0,"CHESTNUT HILL COLLEGE",NA,NA,94,94,0,50,0,50,0.532,0.532,NA,16990,55
"9986",211583,2002,1,0,"CHESTNUT HILL COLLEGE",NA,NA,105,104,1,27,0,27,0.26,0.257,0,17500,52
"9987",211583,2003,1,0,"CHESTNUT HILL COLLEGE",NA,NA,188,125,63,66,19,47,0.376,0.351,0.302,18375,122
"9988",211583,2004,1,0,"CHESTNUT HILL COLLEGE",NA,NA,197,115,82,62,24,38,0.33,0.315,0.293,19660,115
"9989",211583,2005,1,0,"Chestnut Hill College",NA,NA,219,150,69,73,23,50,0.333,0.333,0.333,20840,124
"9990",211583,2006,1,0,"Chestnut Hill College",NA,NA,214,155,59,78,22,56,0.361,0.364,0.373,23600,144
"9991",211583,2007,1,0,"Chestnut Hill College",NA,NA,234,128,106,63,24,39,0.305,0.269,0.226,24900,154
"9992",211583,2008,1,0,"Chestnut Hill College",NA,NA,194,115,79,72,24,48,0.417,0.371,0.304,26000,113
"9993",211583,2009,1,0,"Chestnut Hill College",NA,NA,273,164,109,101,27,74,0.451,0.37,0.248,27000,155
"9994",211583,2010,1,0,"Chestnut Hill College",NA,NA,219,125,94,82,31,51,0.408,0.374,0.33,28100,145
"9995",211608,1991,1,0,"CHEYNEY UNIVERSITY OF PENNSYLVANIA",NA,NA,324,139,185,33,14,19,0.137,0.102,0.076,2838,7
"9996",211608,1992,1,0,"CHEYNEY UNIVERSITY OF PENNSYLVANIA",NA,NA,375,184,191,19,2,17,0.092,0.051,0.01,2938,2
"9997",211608,1993,1,0,"CHEYNEY UNIVERSITY OF PENNSYLVANIA",NA,NA,287,128,159,23,11,12,0.094,0.08,0.069,3319,2
"9998",211608,1995,1,0,"CHEYNEY UNIVERSITY OF PENNSYLVANIA",NA,NA,256,131,125,20,5,15,0.114,0.078,0.04,3729,1
"9999",211608,1996,1,0,"CHEYNEY UNIVERSITY OF PENNSYLVANIA",NA,NA,236,124,112,16,2,14,0.113,0.068,0.018,3922,0
"10000",211608,1997,1,0,"CHEYNEY UNIVERSITY OF PENNSYLVANIA",NA,NA,236,122,114,18,4,14,0.115,0.076,0.035,4023,2
"10001",211608,1998,1,0,"CHEYNEY UNIVERSITY OF PENNSYLVANIA",NA,NA,235,147,88,23,3,20,0.136,0.098,0.034,4023,1
"10002",211608,1999,1,0,"CHEYNEY UNIVERSITY OF PENNSYLVANIA",NA,NA,254,152,102,37,9,28,0.184,0.146,0.088,3618,0
"10003",211608,2000,1,0,"CHEYNEY UNIVERSITY OF PENNSYLVANIA",NA,NA,291,151,140,34,9,25,0.166,0.117,0.064,3792,0
"10004",211608,2001,1,0,"CHEYNEY UNIVERSITY OF PENNSYLVANIA",NA,NA,292,146,146,32,7,25,0.171,0.11,0.048,4016,0
"10005",211608,2002,1,0,"CHEYNEY UNIVERSITY OF PENNSYLVANIA",NA,NA,247,132,115,25,5,20,0.152,0.101,0.043,4378,1
"10006",211608,2003,1,0,"CHEYNEY UNIVERSITY OF PENNSYLVANIA",NA,NA,378,208,170,51,13,38,0.183,0.135,0.076,4598,1
"10007",211608,2004,1,0,"CHEYNEY UNIVERSITY OF PENNSYLVANIA",NA,NA,422,225,197,56,20,36,0.16,0.133,0.102,4810,0
"10008",211608,2005,1,0,"Cheyney University of Pennsylvania",NA,NA,397,219,178,51,21,30,0.137,0.128,0.118,4906,3
"10009",211608,2006,1,0,"Cheyney University of Pennsylvania",NA,NA,437,238,199,47,15,32,0.134,0.108,0.075,5038,1
"10010",211608,2007,1,0,"Cheyney University of Pennsylvania",NA,NA,278,166,112,26,5,21,0.126,0.094,0.045,5177,1
"10011",211608,2008,1,0,"Cheyney University of Pennsylvania",NA,NA,280,157,123,31,6,25,0.159,0.111,0.049,5358,2
"10012",211608,2009,1,0,"Cheyney University of Pennsylvania",NA,NA,372,199,173,22,7,15,0.075,0.059,0.04,5554,2
"10013",211608,2010,1,0,"Cheyney University of Pennsylvania",NA,NA,471,258,213,25,5,20,0.078,0.053,0.023,5804,7
"10014",211644,1991,1,0,"CLARION UNIVERSITY OF PENNSYLVANIA",NA,NA,973,584,389,232,64,168,0.288,0.238,0.165,3147,923
"10015",211644,1992,1,0,"CLARION UNIVERSITY OF PENNSYLVANIA",NA,NA,1093,679,414,246,60,186,0.274,0.225,0.145,3328,1037
"10016",211644,1993,1,0,"CLARION UNIVERSITY OF PENNSYLVANIA",NA,NA,1081,650,431,246,70,176,0.271,0.228,0.162,3710,1035
"10017",211644,1995,1,0,"CLARION UNIVERSITY OF PENNSYLVANIA",NA,NA,1241,768,473,210,46,164,0.214,0.169,0.097,4054,1156
"10018",211644,1996,1,0,"CLARION UNIVERSITY OF PENNSYLVANIA",NA,NA,1215,711,504,284,79,205,0.288,0.234,0.157,4268,1141
"10019",211644,1997,1,0,"CLARION UNIVERSITY OF PENNSYLVANIA",NA,NA,1220,751,469,294,84,210,0.28,0.241,0.179,4378,1145
"10020",211644,1998,1,0,"CLARION UNIVERSITY OF PENNSYLVANIA",NA,NA,1191,717,474,250,64,186,0.259,0.21,0.135,4569,1110
"10021",211644,1999,1,0,"CLARION UNIVERSITY OF PENNSYLVANIA",NA,NA,1286,806,480,295,80,215,0.267,0.229,0.167,3618,1194
"10022",211644,2000,1,0,"CLARION UNIVERSITY OF PENNSYLVANIA",NA,NA,1305,813,492,330,99,231,0.284,0.253,0.201,3792,1191
"10023",211644,2001,1,0,"CLARION UNIVERSITY OF PENNSYLVANIA",NA,NA,1286,814,472,313,82,231,0.284,0.243,0.174,4016,1176
"10024",211644,2002,1,0,"CLARION UNIVERSITY OF PENNSYLVANIA",NA,NA,1249,745,504,367,117,250,0.336,0.294,0.232,4378,1144
"10025",211644,2003,1,0,"CLARION UNIVERSITY OF PENNSYLVANIA",NA,NA,1219,729,490,366,113,253,0.347,0.3,0.231,4598,1125
"10026",211644,2004,1,0,"CLARION UNIVERSITY OF PENNSYLVANIA",NA,NA,1203,683,520,296,103,193,0.283,0.246,0.198,4810,1071
"10027",211644,2005,1,0,"Clarion University of Pennsylvania",NA,NA,1173,731,442,288,92,196,0.268,0.246,0.208,4906,1066
"10028",211644,2006,1,0,"Clarion University of Pennsylvania",NA,NA,1295,758,537,323,110,213,0.281,0.249,0.205,5038,1173
"10029",211644,2007,1,0,"Clarion University of Pennsylvania",NA,NA,1381,799,582,417,142,275,0.344,0.302,0.244,5176,1246
"10030",211644,2008,1,0,"Clarion University of Pennsylvania",NA,NA,1305,747,558,355,116,239,0.32,0.272,0.208,5358,1134
"10031",211644,2009,1,0,"Clarion University of Pennsylvania",NA,NA,1384,805,579,395,122,273,0.339,0.285,0.211,5554,1195
"10032",211644,2010,1,0,"Clarion University of Pennsylvania",NA,NA,1309,811,498,430,127,303,0.374,0.328,0.255,5804,1117
"10033",211981,1991,1,0,"DELAWARE VALLEY COLLEGE OF SCIENCE AND AGRICULTURE",NA,NA,332,140,192,98,43,55,0.393,0.295,0.224,10126,314
"10034",211981,1992,1,0,"DELAWARE VALLEY COLLEGE OF SCIENCE AND AGRICULTURE",NA,NA,347,146,201,132,61,71,0.486,0.38,0.303,11090,326
"10035",211981,1993,1,0,"DELAWARE VALLEY COLLEGE OF SCIENCE AND AGRICULTURE",NA,NA,435,212,223,142,65,77,0.363,0.326,0.291,11645,413
"10036",211981,1995,1,0,"DELAWARE VALLEY COLLEGE",NA,NA,384,193,191,138,45,93,0.482,0.359,0.236,13208,363
"10037",211981,1996,1,0,"DELAWARE VALLEY COLLEGE",NA,NA,385,177,208,149,67,82,0.463,0.387,0.322,13708,353
"10038",211981,1997,1,0,"DELAWARE VALLEY COLLEGE",NA,NA,407,185,222,149,58,91,0.492,0.366,0.261,14256,372
"10039",211981,1998,1,0,"DELAWARE VALLEY COLLEGE",NA,NA,400,203,197,172,70,102,0.503,0.43,0.355,14826,380
"10040",211981,1999,1,0,"DELAWARE VALLEY COLLEGE",NA,NA,327,172,155,109,41,68,0.395,0.333,0.265,15300,292
"10041",211981,2000,1,0,"DELAWARE VALLEY COLLEGE",NA,NA,380,188,192,160,63,97,0.516,0.421,0.328,16148,339
"10042",211981,2001,1,0,"DELAWARE VALLEY COLLEGE",NA,NA,355,157,198,126,53,73,0.465,0.355,0.268,16874,311
"10043",211981,2002,1,0,"DELAWARE VALLEY COLLEGE",NA,NA,406,204,202,159,59,100,0.49,0.392,0.292,17680,366
"10044",211981,2003,1,0,"DELAWARE VALLEY COLLEGE",NA,NA,438,198,240,164,70,94,0.475,0.374,0.292,18654,316
"10045",211981,2004,1,0,"DELAWARE VALLEY COLLEGE",NA,NA,450,257,193,186,48,138,0.537,0.413,0.249,19588,389
"10046",211981,2005,1,0,"Delaware Valley College",NA,NA,448,271,177,206,54,152,0.561,0.46,0.305,20664,384
"10047",211981,2006,1,0,"Delaware Valley College",NA,NA,447,264,183,220,68,152,0.576,0.492,0.372,21800,389
"10048",211981,2007,1,0,"Delaware Valley College",NA,NA,475,270,205,221,79,142,0.526,0.465,0.385,23110,433
"10049",211981,2008,1,0,"Delaware Valley College",NA,NA,429,253,176,220,78,142,0.561,0.513,0.443,24728,380
"10050",211981,2009,1,0,"Delaware Valley College",NA,NA,452,252,200,227,74,153,0.607,0.502,0.37,25692,395
"10051",211981,2010,1,0,"Delaware Valley College",NA,NA,490,297,193,238,66,172,0.579,0.486,0.342,27234,429
"10052",212009,1991,1,0,"DICKINSON COLLEGE",NA,NA,557,317,240,433,184,249,0.785,0.777,0.767,15565,513
"10053",212009,1992,1,0,"DICKINSON COLLEGE",NA,NA,569,342,227,428,178,250,0.731,0.752,0.784,16760,519
"10054",212009,1993,1,0,"DICKINSON COLLEGE",NA,NA,482,277,205,330,124,206,0.744,0.685,0.605,17775,441
"10055",212009,1995,1,0,"DICKINSON COLLEGE",NA,NA,520,286,234,393,174,219,0.766,0.756,0.744,19750,468
"10056",212009,1996,1,0,"DICKINSON COLLEGE",NA,NA,491,264,227,371,168,203,0.769,0.756,0.74,20750,445
"10057",212009,1997,1,0,"DICKINSON COLLEGE",NA,NA,563,354,209,429,148,281,0.794,0.762,0.708,21600,523
"10058",212009,1998,1,0,"DICKINSON COLLEGE",NA,NA,541,334,207,417,155,262,0.784,0.771,0.749,22600,513
"10059",212009,1999,1,0,"DICKINSON COLLEGE",NA,NA,620,399,221,505,178,327,0.82,0.815,0.805,23120,577
"10060",212009,2000,1,0,"DICKINSON COLLEGE",NA,NA,594,340,254,464,188,276,0.812,0.781,0.74,24050,550
"10061",212009,2001,1,0,"DICKINSON COLLEGE",NA,NA,611,321,290,484,218,266,0.829,0.792,0.752,25250,559
"10062",212009,2002,1,0,"DICKINSON COLLEGE",NA,NA,572,328,244,459,185,274,0.835,0.802,0.758,26400,501
"10063",212009,2003,1,0,"DICKINSON COLLEGE",NA,NA,624,356,268,496,205,291,0.817,0.795,0.765,28380,541
"10064",212009,2004,1,0,"DICKINSON COLLEGE",NA,NA,605,329,276,472,197,275,0.836,0.78,0.714,30000,489
"10065",212009,2005,1,0,"Dickinson College",NA,NA,647,359,288,530,227,303,0.844,0.819,0.788,31800,511
"10066",212009,2006,1,0,"Dickinson College",NA,NA,617,360,257,499,199,300,0.833,0.809,0.774,33470,477
"10067",212009,2007,1,0,"Dickinson College",NA,NA,619,319,300,515,237,278,0.872,0.832,0.79,35450,483
"10068",212009,2008,1,0,"Dickinson College",NA,NA,613,337,276,495,204,291,0.863,0.808,0.739,37900,467
"10069",212009,2009,1,0,"Dickinson College",NA,NA,581,340,241,472,191,281,0.827,0.812,0.793,39780,462
"10070",212009,2010,1,0,"Dickinson College",NA,NA,657,355,302,535,240,295,0.831,0.814,0.795,41170,504
"10071",212054,1991,0,1,"DREXEL UNIVERSITY",9999,0,1207,364,843,115,31,84,0.231,0.095,0.037,10860,823
"10072",212054,1992,0,1,"DREXEL UNIVERSITY",9999,0,1054,340,714,94,30,64,0.188,0.089,0.042,11635,721
"10073",212054,1993,0,1,"DREXEL UNIVERSITY",9999,0,1126,383,743,86,27,59,0.154,0.076,0.036,12326,709
"10074",212054,1995,0,1,"DREXEL UNIVERSITY",9999,0,935,341,594,111,40,71,0.208,0.119,0.067,13844,629
"10075",212054,1996,0,1,"DREXEL UNIVERSITY",9999,0,1348,476,872,172,76,96,0.202,0.128,0.087,14472,894
"10076",212054,1997,0,1,"DREXEL UNIVERSITY",9999,0,1776,729,1047,231,73,158,0.217,0.13,0.07,14036,1027
"10077",212054,1998,0,1,"DREXEL UNIVERSITY",9999,0,2087,792,1295,247,73,174,0.22,0.118,0.056,15574,1350
"10078",212054,1999,0,1,"DREXEL UNIVERSITY",9999,0,1898,725,1173,269,94,175,0.241,0.142,0.08,15240,1257
"10079",212054,2000,0,1,"DREXEL UNIVERSITY",9999,0,2125,810,1315,275,97,178,0.22,0.129,0.074,15927,1317
"10080",212054,2001,0,1,"DREXEL UNIVERSITY",9999,0,1934,759,1175,313,124,189,0.249,0.162,0.106,16644,1117
"10081",212054,2002,0,1,"DREXEL UNIVERSITY",9999,0,1937,709,1228,374,150,224,0.316,0.193,0.122,17393,1394
"10082",212054,2003,0,1,"DREXEL UNIVERSITY",9999,0,1980,768,1212,486,176,310,0.404,0.245,0.145,19700,1433
"10083",212054,2004,0,1,"DREXEL UNIVERSITY",9999,0,2069,732,1337,477,193,284,0.388,0.231,0.144,20800,1514
"10084",212054,2005,0,1,"Drexel University",9999,0,2346,916,1430,663,274,389,0.425,0.283,0.192,21700,1530
"10085",212054,2006,0,1,"Drexel University",9999,0,2256,930,1326,598,219,379,0.408,0.265,0.165,26000,1526
"10086",212054,2007,0,1,"Drexel University",9999,0,2260,945,1315,640,254,386,0.409,0.283,0.193,27200,1461
"10087",212054,2008,0,1,"Drexel University",9999,0,2402,992,1410,579,206,373,0.376,0.241,0.146,28500,1468
"10088",212054,2009,0,1,"Drexel University",9999,0,2268,898,1370,516,209,307,0.342,0.228,0.153,29800,1253
"10089",212054,2010,0,1,"Drexel University",9999,0,2696,1200,1496,735,275,460,0.383,0.273,0.184,30900,1616
"10090",212106,1991,1,0,"DUQUESNE UNIVERSITY",NA,NA,870,475,395,381,166,215,0.453,0.438,0.42,9750,812
"10091",212106,1992,1,0,"DUQUESNE UNIVERSITY",NA,NA,1026,588,438,441,165,276,0.469,0.43,0.377,10470,925
"10092",212106,1993,1,0,"DUQUESNE UNIVERSITY",NA,NA,971,547,424,418,182,236,0.431,0.43,0.429,11328,848
"10093",212106,1995,1,0,"DUQUESNE UNIVERSITY",NA,NA,1215,703,512,523,193,330,0.469,0.43,0.377,12578,1055
"10094",212106,1996,1,0,"DUQUESNE UNIVERSITY",NA,NA,1196,690,506,558,204,354,0.513,0.467,0.403,13396,957
"10095",212106,1997,1,0,"DUQUESNE UNIVERSITY",NA,NA,1211,716,495,599,225,374,0.522,0.495,0.455,14066,951
"10096",212106,1998,1,0,"DUQUESNE UNIVERSITY",NA,NA,1253,771,482,615,210,405,0.525,0.491,0.436,14699,1027
"10097",212106,1999,1,0,"DUQUESNE UNIVERSITY",NA,NA,1211,686,525,590,216,374,0.545,0.487,0.411,14378,996
"10098",212106,2000,1,0,"DUQUESNE UNIVERSITY",NA,NA,1257,733,524,650,243,407,0.555,0.517,0.464,15169,1091
"10099",212106,2001,1,0,"DUQUESNE UNIVERSITY",NA,NA,1176,684,492,596,219,377,0.551,0.507,0.445,16049,1038
"10100",212106,2002,1,0,"DUQUESNE UNIVERSITY",NA,NA,1429,875,554,748,253,495,0.566,0.523,0.457,17012,1253
"10101",212106,2003,1,0,"DUQUESNE UNIVERSITY",NA,NA,1485,899,586,774,283,491,0.546,0.521,0.483,17837,1258
"10102",212106,2004,1,0,"DUQUESNE UNIVERSITY",NA,NA,1208,700,508,656,251,405,0.579,0.543,0.494,18693,1017
"10103",212106,2005,1,0,"Duquesne University",NA,NA,1325,811,514,711,244,467,0.576,0.537,0.475,19721,1156
"10104",212106,2006,1,0,"Duquesne University",NA,NA,1321,779,542,700,268,432,0.555,0.53,0.494,20855,1168
"10105",212106,2007,1,0,"Duquesne University",NA,NA,1354,785,569,796,307,489,0.623,0.588,0.54,22054,1204
"10106",212106,2008,1,0,"Duquesne University",NA,NA,1425,838,587,801,308,493,0.588,0.562,0.525,23470,1270
"10107",212106,2009,1,0,"Duquesne University",NA,NA,1425,814,611,787,296,491,0.603,0.552,0.484,24385,1221
"10108",212106,2010,1,0,"Duquesne University",NA,NA,1411,821,590,834,318,516,0.629,0.591,0.539,25336,1221
"10109",212115,1991,1,0,"EAST STROUDSBURG UNIVERSITY OF PENNSYLVANIA",NA,NA,699,382,317,129,31,98,0.256,0.185,0.098,3088,636
"10110",212115,1992,1,0,"EAST STROUDSBURG UNIVERSITY OF PENNSYLVANIA",NA,NA,628,368,260,143,39,104,0.283,0.228,0.15,3352,581
"10111",212115,1993,1,0,"EAST STROUDSBURG UNIVERSITY OF PENNSYLVANIA",NA,NA,799,446,353,161,39,122,0.274,0.202,0.11,3664,733
"10112",212115,1995,1,0,"EAST STROUDSBURG UNIVERSITY OF PENNSYLVANIA",NA,NA,820,457,363,169,45,124,0.271,0.206,0.124,4016,776
"10113",212115,1996,1,0,"EAST STROUDSBURG UNIVERSITY OF PENNSYLVANIA",NA,NA,872,499,373,198,50,148,0.297,0.227,0.134,4194,808
"10114",212115,1997,1,0,"EAST STROUDSBURG UNIVERSITY OF PENNSYLVANIA",NA,NA,886,532,354,166,34,132,0.248,0.187,0.096,4322,799
"10115",212115,1998,1,0,"EAST STROUDSBURG UNIVERSITY OF PENNSYLVANIA",NA,NA,856,475,381,182,53,129,0.272,0.213,0.139,4314,767
"10116",212115,1999,1,0,"EAST STROUDSBURG UNIVERSITY OF PENNSYLVANIA",NA,NA,843,522,321,163,42,121,0.232,0.193,0.131,3618,744
"10117",212115,2000,1,0,"EAST STROUDSBURG UNIVERSITY OF PENNSYLVANIA",NA,NA,878,522,356,193,57,136,0.26,0.22,0.16,3792,791
"10118",212115,2001,1,0,"EAST STROUDSBURG UNIVERSITY OF PENNSYLVANIA",NA,NA,969,564,405,259,66,193,0.342,0.267,0.163,4016,880
"10119",212115,2002,1,0,"EAST STROUDSBURG UNIVERSITY OF PENNSYLVANIA",NA,NA,1123,587,536,314,100,214,0.365,0.28,0.187,4378,1020
"10120",212115,2003,1,0,"EAST STROUDSBURG UNIVERSITY OF PENNSYLVANIA",NA,NA,1076,650,426,394,107,287,0.442,0.366,0.251,4598,993
"10121",212115,2004,1,0,"EAST STROUDSBURG UNIVERSITY OF PENNSYLVANIA",NA,NA,1165,709,456,420,122,298,0.42,0.361,0.268,4810,1059
"10122",212115,2005,1,0,"East Stroudsburg University of Pennsylvania",NA,NA,1087,634,453,392,110,282,0.445,0.361,0.243,4906,1001
"10123",212115,2006,1,0,"East Stroudsburg University of Pennsylvania",NA,NA,1239,716,523,454,147,307,0.429,0.366,0.281,5038,975
"10124",212115,2007,1,0,"East Stroudsburg University of Pennsylvania",NA,NA,1183,612,571,422,156,266,0.435,0.357,0.273,5178,922
"10125",212115,2008,1,0,"East Stroudsburg University of Pennsylvania",NA,NA,1262,655,607,458,167,291,0.444,0.363,0.275,5358,945
"10126",212115,2009,1,0,"East Stroudsburg University of Pennsylvania",NA,NA,1342,737,605,466,167,299,0.406,0.347,0.276,5554,955
"10127",212115,2010,1,0,"East Stroudsburg University of Pennsylvania",NA,NA,1144,658,486,422,137,285,0.433,0.369,0.282,5804,899
"10128",212133,1991,1,0,"EASTERN COLLEGE",NA,NA,134,87,47,55,16,39,0.448,0.41,0.34,9525,97
"10129",212133,1992,1,0,"EASTERN COLLEGE",NA,NA,183,130,53,82,20,62,0.477,0.448,0.377,9875,146
"10130",212133,1993,1,0,"EASTERN COLLEGE",NA,NA,162,113,49,76,22,54,0.478,0.469,0.449,10620,126
"10131",212133,1995,1,0,"EASTERN COLLEGE",NA,NA,226,171,55,103,21,82,0.48,0.456,0.382,11780,179
"10132",212133,1996,1,0,"EASTERN COLLEGE",NA,NA,245,168,77,138,34,104,0.619,0.563,0.442,12250,197
"10133",212133,1997,1,0,"EASTERN COLLEGE",NA,NA,305,211,94,171,40,131,0.621,0.561,0.426,12735,259
"10134",212133,1998,1,0,"EASTERN COLLEGE",NA,NA,317,220,97,168,48,120,0.545,0.53,0.495,13235,254
"10135",212133,1999,1,0,"EASTERN COLLEGE",NA,NA,379,274,105,190,41,149,0.544,0.501,0.39,13728,346
"10136",212133,2000,1,0,"EASTERN COLLEGE",NA,NA,400,279,121,229,60,169,0.606,0.573,0.496,14560,346
"10137",212133,2001,1,0,"EASTERN UNIVERSITY",NA,NA,427,287,140,216,69,147,0.512,0.506,0.493,15150,342
"10138",212133,2002,1,0,"EASTERN UNIVERSITY",NA,NA,405,288,117,211,49,162,0.562,0.521,0.419,15832,322
"10139",212133,2003,1,0,"EASTERN UNIVERSITY",NA,NA,438,298,140,242,74,168,0.564,0.553,0.529,16780,355
"10140",212133,2004,1,0,"EASTERN UNIVERSITY",NA,NA,450,294,156,243,82,161,0.548,0.54,0.526,17700,360
"10141",212133,2005,1,0,"Eastern University",NA,NA,445,300,145,239,70,169,0.563,0.537,0.483,18830,350
"10142",212133,2006,1,0,"Eastern University",NA,NA,494,336,158,230,70,160,0.476,0.466,0.443,20030,377
"10143",212133,2007,1,0,"Eastern University",NA,NA,483,319,164,206,58,148,0.464,0.427,0.354,21350,318
"10144",212133,2008,1,0,"Eastern University",NA,NA,550,367,183,233,68,165,0.45,0.424,0.372,22670,342
"10145",212133,2009,1,0,"Eastern University",NA,NA,489,318,171,213,61,152,0.478,0.436,0.357,23770,328
"10146",212133,2010,1,0,"Eastern University",NA,NA,449,302,147,195,67,128,0.424,0.434,0.456,24550,264
"10147",212160,1991,1,0,"EDINBORO UNIVERSITY OF PENNSYLVANIA",NA,NA,1456,853,603,243,65,178,0.209,0.167,0.108,3013,1302
"10148",212160,1992,1,0,"EDINBORO UNIVERSITY OF PENNSYLVANIA",NA,NA,1500,857,643,257,75,182,0.212,0.171,0.117,3161,1375
"10149",212160,1993,1,0,"EDINBORO UNIVERSITY OF PENNSYLVANIA",NA,NA,1315,763,552,221,65,156,0.204,0.168,0.118,3531,1209
"10150",212160,1995,1,0,"EDINBORO UNIVERSITY OF PENNSYLVANIA",NA,NA,1332,763,569,213,69,144,0.189,0.16,0.121,3924,1186
"10151",212160,1996,1,0,"EDINBORO UNIVERSITY OF PENNSYLVANIA",NA,NA,1250,707,543,214,69,145,0.205,0.171,0.127,4082,1160
"10152",212160,1997,1,0,"EDINBORO UNIVERSITY OF PENNSYLVANIA",NA,NA,1251,729,522,234,63,171,0.235,0.187,0.121,4192,1143
"10153",212160,1998,1,0,"EDINBORO UNIVERSITY OF PENNSYLVANIA",NA,NA,1205,691,514,210,54,156,0.226,0.174,0.105,3468,1107
"10154",212160,1999,1,0,"EDINBORO UNIVERSITY OF PENNSYLVANIA",NA,NA,1256,749,507,227,48,179,0.239,0.181,0.095,3618,1139
"10155",212160,2000,1,0,"EDINBORO UNIVERSITY OF PENNSYLVANIA",NA,NA,1304,731,573,297,88,209,0.286,0.228,0.154,3792,1160
"10156",212160,2001,1,0,"EDINBORO UNIVERSITY OF PENNSYLVANIA",NA,NA,1409,831,578,323,99,224,0.27,0.229,0.171,4016,1228
"10157",212160,2002,1,0,"EDINBORO UNIVERSITY OF PENNSYLVANIA",NA,NA,1372,788,584,297,86,211,0.268,0.216,0.147,4378,1204
"10158",212160,2003,1,0,"EDINBORO UNIVERSITY OF PENNSYLVANIA",NA,NA,1392,818,574,304,103,201,0.246,0.218,0.179,4598,1219
"10159",212160,2004,1,0,"EDINBORO UNIVERSITY OF PENNSYLVANIA",NA,NA,1232,712,520,272,81,191,0.268,0.221,0.156,4810,1062
"10160",212160,2005,1,0,"Edinboro University of Pennsylvania",NA,NA,1268,719,549,297,82,215,0.299,0.234,0.149,4906,1104
"10161",212160,2006,1,0,"Edinboro University of Pennsylvania",NA,NA,1212,671,541,230,63,167,0.249,0.19,0.116,5038,1036
"10162",212160,2007,1,0,"Edinboro University of Pennsylvania",NA,NA,1243,707,536,239,75,164,0.232,0.192,0.14,5177,1005
"10163",212160,2008,1,0,"Edinboro University of Pennsylvania",NA,NA,1219,697,522,245,77,168,0.241,0.201,0.148,5358,1041
"10164",212160,2009,1,0,"Edinboro University of Pennsylvania",NA,NA,1407,803,604,266,82,184,0.229,0.189,0.136,5554,1221
"10165",212160,2010,1,0,"Edinboro University of Pennsylvania",NA,NA,1551,927,624,340,103,237,0.256,0.219,0.165,5804,1337
"10166",212197,1991,1,0,"ELIZABETHTOWN COLLEGE",NA,NA,455,309,146,265,78,187,0.605,0.582,0.534,11650,427
"10167",212197,1992,1,0,"ELIZABETHTOWN COLLEGE",NA,NA,442,318,124,256,52,204,0.642,0.579,0.419,12550,429
"10168",212197,1993,1,0,"ELIZABETHTOWN COLLEGE",NA,NA,424,276,148,270,76,194,0.703,0.637,0.514,13600,412
"10169",212197,1995,1,0,"ELIZABETHTOWN COLLEGE",NA,NA,434,307,127,282,72,210,0.684,0.65,0.567,15490,411
"10170",212197,1996,1,0,"ELIZABETHTOWN COLLEGE",NA,NA,429,295,134,263,73,190,0.644,0.613,0.545,15890,403
"10171",212197,1997,1,0,"ELIZABETHTOWN COLLEGE",NA,NA,438,298,140,265,74,191,0.641,0.605,0.529,16680,409
"10172",212197,1998,1,0,"ELIZABETHTOWN COLLEGE",NA,NA,422,271,151,265,87,178,0.657,0.628,0.576,17500,400
"10173",212197,1999,1,0,"ELIZABETHTOWN COLLEGE",NA,NA,477,298,179,277,102,175,0.587,0.581,0.57,17770,438
"10174",212197,2000,1,0,"ELIZABETHTOWN COLLEGE",NA,NA,474,318,156,310,98,212,0.667,0.654,0.628,19100,436
"10175",212197,2001,1,0,"ELIZABETHTOWN COLLEGE",NA,NA,514,319,195,326,116,210,0.658,0.634,0.595,20200,482
"10176",212197,2002,1,0,"ELIZABETHTOWN COLLEGE",NA,NA,456,304,152,293,85,208,0.684,0.643,0.559,21350,418
"10177",212197,2003,1,0,"ELIZABETHTOWN COLLEGE",NA,NA,495,326,169,328,100,228,0.699,0.663,0.592,22500,458
"10178",212197,2004,1,0,"ELIZABETHTOWN COLLEGE",NA,NA,535,344,191,385,125,260,0.756,0.72,0.654,23710,508
"10179",212197,2005,1,0,"Elizabethtown College",NA,NA,500,337,163,356,104,252,0.748,0.712,0.638,25200,466
"10180",212197,2006,1,0,"Elizabethtown College",NA,NA,528,345,183,372,125,247,0.716,0.705,0.683,26950,497
"10181",212197,2007,1,0,"Elizabethtown College",NA,NA,487,324,163,344,113,231,0.713,0.706,0.693,29000,446
"10182",212197,2008,1,0,"Elizabethtown College",NA,NA,508,331,177,328,114,214,0.647,0.646,0.644,30650,457
"10183",212197,2009,1,0,"Elizabethtown College",NA,NA,544,340,204,391,133,258,0.759,0.719,0.652,31800,489
"10184",212197,2010,1,0,"Elizabethtown College",NA,NA,491,303,188,339,104,235,0.776,0.69,0.553,33250,426
"10185",212577,1991,1,0,"FRANKLIN AND MARSHALL COLLEGE",NA,NA,504,228,276,355,173,182,0.798,0.704,0.627,16385,398
"10186",212577,1992,1,0,"FRANKLIN AND MARSHALL COLLEGE",NA,NA,486,222,264,351,182,169,0.761,0.722,0.689,22370,385
"10187",212577,1993,1,0,"FRANKLIN AND MARSHALL COLLEGE",NA,NA,507,229,278,364,190,174,0.76,0.718,0.683,23655,387
"10188",212577,1995,1,0,"FRANKLIN AND MARSHALL COLLEGE",NA,NA,498,234,264,372,179,193,0.825,0.747,0.678,21350,406
"10189",212577,1996,1,0,"FRANKLIN AND MARSHALL COLLEGE",NA,NA,522,272,250,408,175,233,0.857,0.782,0.7,21990,430
"10190",212577,1997,1,0,"FRANKLIN AND MARSHALL COLLEGE",NA,NA,504,251,253,402,202,200,0.797,0.798,0.798,22714,410
"10191",212577,1998,1,0,"FRANKLIN AND MARSHALL COLLEGE",NA,NA,502,257,245,394,175,219,0.852,0.785,0.714,23214,399
"10192",212577,1999,1,0,"FRANKLIN AND MARSHALL COLLEGE",NA,NA,515,253,262,387,181,206,0.814,0.751,0.691,23720,443
"10193",212577,2000,1,0,"FRANKLIN AND MARSHALL COLLEGE",NA,NA,510,251,259,382,179,203,0.809,0.749,0.691,24816,421
"10194",212577,2001,1,0,"FRANKLIN AND MARSHALL COLLEGE",NA,NA,510,248,262,401,190,211,0.851,0.786,0.725,26060,410
"10195",212577,2002,1,0,"FRANKLIN AND MARSHALL COLLEGE",NA,NA,534,248,286,388,189,199,0.802,0.727,0.661,27230,403
"10196",212577,2003,1,0,"FRANKLIN AND MARSHALL COLLEGE",NA,NA,503,233,270,398,198,200,0.858,0.791,0.733,28810,379
"10197",212577,2004,1,0,"FRANKLIN AND MARSHALL COLLEGE",NA,NA,529,241,288,424,219,205,0.851,0.802,0.76,30390,422
"10198",212577,2005,1,0,"Franklin and Marshall College",NA,NA,581,298,283,468,211,257,0.862,0.806,0.746,32480,447
"10199",212577,2006,1,0,"Franklin and Marshall College",NA,NA,523,274,249,413,196,217,0.792,0.79,0.787,34400,321
"10200",212577,2007,1,0,"Franklin and Marshall College",NA,NA,569,301,268,477,214,263,0.874,0.838,0.799,36430,417
"10201",212577,2008,1,0,"Franklin and Marshall College",NA,NA,588,321,267,485,210,275,0.857,0.825,0.787,38580,443
"10202",212577,2009,1,0,"Franklin and Marshall College",NA,NA,629,334,295,511,229,282,0.844,0.812,0.776,39930,475
"10203",212577,2010,1,0,"Franklin and Marshall College",NA,NA,629,345,284,525,227,298,0.864,0.835,0.799,41090,473
"10204",212601,1991,1,0,"GANNON UNIVERSITY",NA,NA,465,264,201,186,79,107,0.405,0.4,0.393,8719,440
"10205",212601,1992,1,0,"GANNON UNIVERSITY",NA,NA,406,244,162,152,54,98,0.402,0.374,0.333,9198,383
"10206",212601,1993,1,0,"GANNON UNIVERSITY",NA,NA,450,257,193,177,79,98,0.381,0.393,0.409,9842,427
"10207",212601,1995,1,0,"GANNON UNIVERSITY",NA,NA,394,225,169,174,73,101,0.449,0.442,0.432,11114,369
"10208",212601,1996,1,0,"GANNON UNIVERSITY",NA,NA,504,305,199,229,72,157,0.515,0.454,0.362,11694,474
"10209",212601,1997,1,0,"GANNON UNIVERSITY",NA,NA,533,318,215,244,74,170,0.535,0.458,0.344,12264,503
"10210",212601,1998,1,0,"GANNON UNIVERSITY",NA,NA,608,360,248,282,95,187,0.519,0.464,0.383,12744,556
"10211",212601,1999,1,0,"GANNON UNIVERSITY",NA,NA,503,314,189,246,67,179,0.57,0.489,0.354,13820,476
"10212",212601,2000,1,0,"GANNON UNIVERSITY",NA,NA,563,327,236,257,87,170,0.52,0.456,0.369,13670,524
"10213",212601,2001,1,0,"GANNON UNIVERSITY",NA,NA,525,313,212,244,83,161,0.514,0.465,0.392,14490,479
"10214",212601,2002,1,0,"GANNON UNIVERSITY",NA,NA,536,311,225,255,80,175,0.563,0.476,0.356,15330,496
"10215",212601,2003,1,0,"GANNON UNIVERSITY",NA,NA,587,339,248,246,91,155,0.457,0.419,0.367,16220,539
"10216",212601,2004,1,0,"GANNON UNIVERSITY",NA,NA,522,317,205,248,84,164,0.517,0.475,0.41,17550,458
"10217",212601,2005,1,0,"Gannon University",NA,NA,619,375,244,292,104,188,0.501,0.472,0.426,18775,558
"10218",212601,2006,1,0,"Gannon University",NA,NA,600,352,248,280,97,183,0.52,0.467,0.391,20090,529
"10219",212601,2007,1,0,"Gannon University",NA,NA,610,365,245,276,96,180,0.493,0.452,0.392,21480,509
"10220",212601,2008,1,0,"Gannon University",NA,NA,620,367,253,289,106,183,0.499,0.466,0.419,22830,544
"10221",212601,2009,1,0,"Gannon University",NA,NA,648,382,266,310,106,204,0.534,0.478,0.398,23745,523
"10222",212601,2010,1,0,"Gannon University",NA,NA,617,362,255,276,100,176,0.486,0.447,0.392,24765,503
"10223",212832,1991,1,0,"GWYNEDD-MERCY COLLEGE",NA,NA,89,79,10,25,1,24,0.304,0.281,0.1,8600,70
"10224",212832,1992,1,0,"GWYNEDD-MERCY COLLEGE",NA,NA,89,72,17,34,2,32,0.444,0.382,0.118,10150,77
"10225",212832,1993,1,0,"GWYNEDD-MERCY COLLEGE",NA,NA,86,74,12,32,2,30,0.405,0.372,0.167,10960,68
"10226",212832,1995,1,0,"GWYNEDD-MERCY COLLEGE",NA,NA,40,35,5,16,0,16,0.457,0.4,0,12017,33
"10227",212832,1996,1,0,"GWYNEDD-MERCY COLLEGE",NA,NA,44,32,12,16,3,13,0.406,0.364,0.25,12650,36
"10228",212832,1997,1,0,"GWYNEDD MERCY COLLEGE",NA,NA,65,54,11,26,4,22,0.407,0.4,0.364,13180,50
"10229",212832,1998,1,0,"GWYNEDD MERCY COLLEGE",NA,NA,143,100,43,44,9,35,0.35,0.308,0.209,13710,129
"10230",212832,1999,1,0,"GWYNEDD MERCY COLLEGE",NA,NA,146,114,32,56,13,43,0.377,0.384,0.406,13500,131
"10231",212832,2000,1,0,"GWYNEDD MERCY COLLEGE",NA,NA,179,141,38,70,10,60,0.426,0.391,0.263,14400,156
"10232",212832,2001,1,0,"GWYNEDD MERCY COLLEGE",NA,NA,176,140,36,85,15,70,0.5,0.483,0.417,15100,158
"10233",212832,2002,1,0,"GWYNEDD MERCY COLLEGE",NA,NA,261,211,50,62,18,44,0.209,0.238,0.36,15600,215
"10234",212832,2003,1,0,"GWYNEDD MERCY COLLEGE",NA,NA,322,245,77,105,26,79,0.322,0.326,0.338,16200,281
"10235",212832,2004,1,0,"GWYNEDD MERCY COLLEGE",NA,NA,280,218,62,87,23,64,0.294,0.311,0.371,16900,261
"10236",212832,2005,1,0,"Gwynedd Mercy College",NA,NA,280,210,70,21,15,6,0.029,0.075,0.214,17580,226
"10237",212832,2006,1,0,"Gwynedd Mercy College",NA,NA,272,202,70,54,19,35,0.173,0.199,0.271,18720,218
"10238",212832,2007,1,0,"Gwynedd Mercy College",NA,NA,291,208,83,58,23,35,0.168,0.199,0.277,20500,256
"10239",212832,2008,1,0,"Gwynedd Mercy College",NA,NA,339,223,116,56,23,33,0.148,0.165,0.198,22340,284
"10240",212832,2009,1,0,"Gwynedd Mercy College",NA,NA,313,214,99,47,18,29,0.136,0.15,0.182,23730,224
"10241",212832,2010,1,0,"Gwynedd Mercy College",NA,NA,284,190,94,38,13,25,0.132,0.134,0.138,25160,218
"10242",212911,1991,1,0,"HAVERFORD COLLEGE",NA,NA,295,147,148,256,124,132,0.898,0.868,0.838,16150,239
"10243",212911,1992,1,0,"HAVERFORD COLLEGE",NA,NA,301,145,156,253,132,121,0.835,0.841,0.846,17125,244
"10244",212911,1993,1,0,"HAVERFORD COLLEGE",NA,NA,292,143,149,243,122,121,0.846,0.832,0.819,18000,247
"10245",212911,1995,1,0,"HAVERFORD COLLEGE",NA,NA,306,162,144,269,126,143,0.883,0.879,0.875,20075,267
"10246",212911,1996,1,0,"HAVERFORD COLLEGE",NA,NA,313,172,141,267,116,151,0.878,0.853,0.823,20890,253
"10247",212911,1997,1,0,"HAVERFORD COLLEGE",NA,NA,298,150,148,264,127,137,0.913,0.886,0.858,21740,229
"10248",212911,1998,1,0,"HAVERFORD COLLEGE",NA,NA,322,170,152,277,130,147,0.865,0.86,0.855,22860,267
"10249",212911,1999,1,0,"HAVERFORD COLLEGE",NA,NA,301,160,141,244,113,131,0.819,0.811,0.801,23556,222
"10250",212911,2000,1,0,"HAVERFORD COLLEGE",NA,NA,334,181,153,305,140,165,0.912,0.913,0.915,24706,237
"10251",212911,2001,1,0,"HAVERFORD COLLEGE",NA,NA,296,154,142,256,120,136,0.883,0.865,0.845,25826,199
"10252",212911,2002,1,0,"HAVERFORD COLLEGE",NA,NA,312,168,144,283,128,155,0.923,0.907,0.889,27006,221
"10253",212911,2003,1,0,"HAVERFORD COLLEGE",NA,NA,313,164,149,275,132,143,0.872,0.879,0.886,28612,236
"10254",212911,2004,1,0,"HAVERFORD COLLEGE",NA,NA,330,179,151,291,130,161,0.899,0.882,0.861,29990,226
"10255",212911,2005,1,0,"Haverford College",NA,NA,316,168,148,287,131,156,0.929,0.908,0.885,31466,225
"10256",212911,2006,1,0,"Haverford College",NA,NA,314,174,140,281,123,158,0.908,0.895,0.879,33394,214
"10257",212911,2007,1,0,"Haverford College",NA,NA,315,169,146,287,131,156,0.923,0.911,0.897,35058,215
"10258",212911,2008,1,0,"Haverford College",NA,NA,327,182,145,287,124,163,0.896,0.878,0.855,37175,234
"10259",212911,2009,1,0,"Haverford College",NA,NA,323,186,137,275,121,154,0.828,0.851,0.883,38735,232
"10260",212911,2010,1,0,"Haverford College",NA,NA,325,166,159,281,138,143,0.861,0.865,0.868,40260,215
"10261",213020,1991,1,0,"INDIANA UNIVERSITY OF PENNSYLVANIA",NA,NA,2516,1452,1064,604,180,424,0.292,0.24,0.169,2980,2181
"10262",213020,1992,1,0,"INDIANA UNIVERSITY OF PENNSYLVANIA",NA,NA,2423,1423,1000,665,197,468,0.329,0.274,0.197,3157,2123
"10263",213020,1993,1,0,"INDIANA UNIVERSITY OF PENNSYLVANIA",NA,NA,2366,1365,1001,495,154,341,0.25,0.209,0.154,3539,2131
"10264",213020,1995,1,0,"INDIANA UNIVERSITY OF PENNSYLVANIA",NA,NA,2661,1552,1109,652,187,465,0.3,0.245,0.169,3891,2470
"10265",213020,1996,1,0,"INDIANA UNIVERSITY OF PENNSYLVANIA",NA,NA,2617,1493,1124,613,163,450,0.301,0.234,0.145,4064,2431
"10266",213020,1997,1,0,"INDIANA UNIVERSITY OF PENNSYLVANIA",NA,NA,2620,1479,1141,618,176,442,0.299,0.236,0.154,4204,2399
"10267",213020,1998,1,0,"INDIANA UNIVERSITY OF PENNSYLVANIA",NA,NA,2757,1643,1114,661,161,500,0.304,0.24,0.145,4244,2484
"10268",213020,1999,1,0,"INDIANA UNIVERSITY OF PENNSYLVANIA-MAIN CAMPUS",NA,NA,2552,1468,1084,561,165,396,0.27,0.22,0.152,3618,2203
"10269",213020,2000,1,0,"INDIANA UNIVERSITY OF PENNSYLVANIA-MAIN CAMPUS",NA,NA,2776,1607,1169,605,167,438,0.273,0.218,0.143,3792,2473
"10270",213020,2001,1,0,"INDIANA UNIVERSITY OF PENNSYLVANIA-MAIN CAMPUS",NA,NA,2557,1460,1097,624,190,434,0.297,0.244,0.173,4016,2261
"10271",213020,2002,1,0,"INDIANA UNIVERSITY OF PENNSYLVANIA-MAIN CAMPUS",NA,NA,2666,1536,1130,697,207,490,0.319,0.261,0.183,4378,2338
"10272",213020,2003,1,0,"INDIANA UNIVERSITY OF PENNSYLVANIA-MAIN CAMPUS",NA,NA,2847,1669,1178,822,242,580,0.348,0.289,0.205,4598,2380
"10273",213020,2004,1,0,"INDIANA UNIVERSITY OF PENNSYLVANIA-MAIN CAMPUS",NA,NA,2645,1567,1078,768,234,534,0.341,0.29,0.217,4810,2109
"10274",213020,2005,1,0,"Indiana University of Pennsylvania-Main Campus",NA,NA,2462,1335,1127,713,245,468,0.351,0.29,0.217,4906,1888
"10275",213020,2006,1,0,"Indiana University of Pennsylvania-Main Campus",NA,NA,2538,1400,1138,726,225,501,0.358,0.286,0.198,5038,2030
"10276",213020,2007,1,0,"Indiana University of Pennsylvania-Main Campus",NA,NA,2524,1450,1074,786,257,529,0.365,0.311,0.239,5178,1886
"10277",213020,2008,1,0,"Indiana University of Pennsylvania-Main Campus",NA,NA,3065,1790,1275,1041,323,718,0.401,0.34,0.253,5358,2445
"10278",213020,2009,1,0,"Indiana University of Pennsylvania-Main Campus",NA,NA,2993,1774,1219,1068,329,739,0.417,0.357,0.27,5554,2497
"10279",213020,2010,1,0,"Indiana University of Pennsylvania-Main Campus",NA,NA,2984,1751,1233,1087,333,754,0.431,0.364,0.27,5804,2375
"10280",213251,1991,1,0,"JUNIATA COLLEGE",NA,NA,261,129,132,164,78,86,0.667,0.628,0.591,12570,254
"10281",213251,1992,1,0,"JUNIATA COLLEGE",NA,NA,258,132,126,161,68,93,0.705,0.624,0.54,13350,251
"10282",213251,1993,1,0,"JUNIATA COLLEGE",NA,NA,301,166,135,198,87,111,0.669,0.658,0.644,14250,266
"10283",213251,1995,1,0,"JUNIATA COLLEGE",NA,NA,282,175,107,196,73,123,0.703,0.695,0.682,16010,252
"10284",213251,1996,1,0,"JUNIATA COLLEGE",NA,NA,349,182,167,237,100,137,0.753,0.679,0.599,16750,314
"10285",213251,1997,1,0,"JUNIATA COLLEGE",NA,NA,342,186,156,232,89,143,0.769,0.678,0.571,17300,321
"10286",213251,1998,1,0,"JUNIATA COLLEGE",NA,NA,337,192,145,227,88,139,0.724,0.674,0.607,17820,315
"10287",213251,1999,1,0,"JUNIATA COLLEGE",NA,NA,324,184,140,217,81,136,0.739,0.67,0.579,18030,302
"10288",213251,2000,1,0,"JUNIATA COLLEGE",NA,NA,359,207,152,265,105,160,0.773,0.738,0.691,18940,342
"10289",213251,2001,1,0,"JUNIATA COLLEGE",NA,NA,340,205,135,242,87,155,0.756,0.712,0.644,20170,327
"10290",213251,2002,1,0,"JUNIATA COLLEGE",NA,NA,375,215,160,285,119,166,0.772,0.76,0.744,21160,354
"10291",213251,2003,1,0,"JUNIATA COLLEGE",NA,NA,381,200,181,284,135,149,0.745,0.745,0.746,22240,357
"10292",213251,2004,1,0,"JUNIATA COLLEGE",NA,NA,390,213,177,273,129,144,0.676,0.7,0.729,23720,362
"10293",213251,2005,1,0,"Juniata College",NA,NA,387,212,175,279,120,159,0.75,0.721,0.686,25260,358
"10294",213251,2006,1,0,"Juniata College",NA,NA,362,195,167,257,111,146,0.749,0.71,0.665,26900,338
"10295",213251,2007,1,0,"Juniata College",NA,NA,377,220,157,271,104,167,0.759,0.719,0.662,28250,336
"10296",213251,2008,1,0,"Juniata College",NA,NA,461,260,201,332,134,198,0.762,0.72,0.667,29610,402
"10297",213251,2009,1,0,"Juniata College",NA,NA,366,207,159,246,98,148,0.715,0.672,0.616,30880,315
"10298",213251,2010,1,0,"Juniata College",NA,NA,421,227,194,303,130,173,0.762,0.72,0.67,32120,345
"10299",213321,1991,1,0,"KING'S COLLEGE",NA,NA,359,164,195,232,115,117,0.713,0.646,0.59,8740,343
"10300",213321,1992,1,0,"KING'S COLLEGE",NA,NA,467,213,254,310,159,151,0.709,0.664,0.626,9770,438
"10301",213321,1993,1,0,"KING'S COLLEGE",NA,NA,380,166,214,241,127,114,0.687,0.634,0.593,10600,364
"10302",213321,1995,1,0,"KING'S COLLEGE",NA,NA,426,180,246,247,126,121,0.672,0.58,0.512,12260,400
"10303",213321,1996,1,0,"KING'S COLLEGE",NA,NA,432,236,196,284,116,168,0.712,0.657,0.592,12980,398
"10304",213321,1997,1,0,"KINGS COLLEGE",NA,NA,435,195,240,260,121,139,0.713,0.598,0.504,14000,403
"10305",213321,1998,1,0,"KINGS COLLEGE",NA,NA,396,189,207,240,113,127,0.672,0.606,0.546,14970,371
"10306",213321,1999,1,0,"KINGS COLLEGE",NA,NA,420,218,202,268,112,156,0.716,0.638,0.554,15240,374
"10307",213321,2000,1,0,"KINGS COLLEGE",NA,NA,457,199,258,285,133,152,0.764,0.624,0.516,16000,407
"10308",213321,2001,1,0,"KINGS COLLEGE",NA,NA,441,217,224,286,121,165,0.76,0.649,0.54,16720,372
"10309",213321,2002,1,0,"KINGS COLLEGE",NA,NA,409,195,214,263,125,138,0.708,0.643,0.584,17390,357
"10310",213321,2003,1,0,"KINGS COLLEGE",NA,NA,448,166,282,284,164,120,0.723,0.634,0.582,18260,371
"10311",213321,2004,1,0,"KINGS COLLEGE",NA,NA,449,178,271,268,139,129,0.725,0.597,0.513,19260,377
"10312",213321,2005,1,0,"King's College",NA,NA,479,198,281,282,149,133,0.672,0.589,0.53,20320,397
"10313",213321,2006,1,0,"King's College",NA,NA,478,202,276,295,153,142,0.703,0.617,0.554,22280,414
"10314",213321,2007,1,0,"King's College",NA,NA,555,268,287,338,173,165,0.616,0.609,0.603,23450,467
"10315",213321,2008,1,0,"King's College",NA,NA,559,295,264,315,134,181,0.614,0.564,0.508,24680,441
"10316",213321,2009,1,0,"King's College",NA,NA,499,233,266,303,142,161,0.691,0.607,0.534,25644,372
"10317",213321,2010,1,0,"King's College",NA,NA,528,240,288,310,150,160,0.667,0.587,0.521,26644,431
"10318",213349,1991,1,0,"KUTZTOWN UNIVERSITY OF PENNSYLVANIA",NA,NA,1427,813,614,295,59,236,0.29,0.207,0.096,3022,1272
"10319",213349,1992,1,0,"KUTZTOWN UNIVERSITY OF PENNSYLVANIA",NA,NA,1131,632,499,188,40,148,0.234,0.166,0.08,3160,982
"10320",213349,1993,1,0,"KUTZTOWN UNIVERSITY OF PENNSYLVANIA",NA,NA,1309,771,538,236,57,179,0.232,0.18,0.106,3558,1207
"10321",213349,1995,1,0,"KUTZTOWN UNIVERSITY OF PENNSYLVANIA",NA,NA,1229,715,514,192,52,140,0.196,0.156,0.101,3940,1105
"10322",213349,1996,1,0,"KUTZTOWN UNIVERSITY OF PENNSYLVANIA",NA,NA,1440,883,557,245,56,189,0.214,0.17,0.101,4098,1341
"10323",213349,1997,1,0,"KUTZTOWN UNIVERSITY OF PENNSYLVANIA",NA,NA,1497,837,660,252,72,180,0.215,0.168,0.109,4219,1380
"10324",213349,1998,1,0,"KUTZTOWN UNIVERSITY OF PENNSYLVANIA",NA,NA,1417,840,577,282,70,212,0.252,0.199,0.121,4251,1320
"10325",213349,1999,1,0,"KUTZTOWN UNIVERSITY OF PENNSYLVANIA",NA,NA,1550,922,628,374,89,285,0.309,0.241,0.142,3618,1464
"10326",213349,2000,1,0,"KUTZTOWN UNIVERSITY OF PENNSYLVANIA",NA,NA,1528,925,603,422,100,322,0.348,0.276,0.166,3792,1448
"10327",213349,2001,1,0,"KUTZTOWN UNIVERSITY OF PENNSYLVANIA",NA,NA,1630,957,673,474,111,363,0.379,0.291,0.165,4016,1454
"10328",213349,2002,1,0,"KUTZTOWN UNIVERSITY OF PENNSYLVANIA",NA,NA,1726,1027,699,498,141,357,0.348,0.289,0.202,4378,1437
"10329",213349,2003,1,0,"KUTZTOWN UNIVERSITY OF PENNSYLVANIA",NA,NA,1825,1035,790,549,158,391,0.378,0.301,0.2,4598,1503
"10330",213349,2004,1,0,"KUTZTOWN UNIVERSITY OF PENNSYLVANIA",NA,NA,2049,1217,832,680,191,489,0.402,0.332,0.23,4810,1698
"10331",213349,2005,1,0,"Kutztown University of Pennsylvania",NA,NA,1905,1105,800,621,190,431,0.39,0.326,0.238,4906,1596
"10332",213349,2006,1,0,"Kutztown University of Pennsylvania",NA,NA,1930,1177,753,612,163,449,0.382,0.317,0.216,5038,1644
"10333",213349,2007,1,0,"Kutztown University of Pennsylvania",NA,NA,1888,1111,777,645,182,463,0.417,0.342,0.234,5177,1577
"10334",213349,2008,1,0,"Kutztown University of Pennsylvania",NA,NA,1812,1034,778,680,206,474,0.458,0.375,0.265,5358,1562
"10335",213349,2009,1,0,"Kutztown University of Pennsylvania",NA,NA,1985,1132,853,689,221,468,0.413,0.347,0.259,5554,1688
"10336",213349,2010,1,0,"Kutztown University of Pennsylvania",NA,NA,2009,1175,834,677,217,460,0.392,0.337,0.26,5804,1663
"10337",213358,1991,1,0,"LA ROCHE COLLEGE",NA,NA,120,76,44,34,10,24,0.316,0.283,0.227,7138,106
"10338",213358,1992,1,0,"LA ROCHE COLLEGE",NA,NA,118,84,34,33,6,27,0.321,0.28,0.176,7780,113
"10339",213358,1993,1,0,"LA ROCHE COLLEGE",NA,NA,181,85,96,61,31,30,0.353,0.337,0.323,8468,124
"10340",213358,1995,1,0,"LA ROCHE COLLEGE",NA,NA,147,85,62,37,9,28,0.329,0.252,0.145,9426,132
"10341",213358,1996,1,0,"LA ROCHE COLLEGE",NA,NA,152,106,46,57,19,38,0.359,0.375,0.413,9912,137
"10342",213358,1997,1,0,"LA ROCHE COLLEGE",NA,NA,184,101,83,91,44,47,0.465,0.495,0.53,10360,148
"10343",213358,1998,1,0,"LA ROCHE COLLEGE",NA,NA,204,127,77,82,30,52,0.409,0.402,0.39,10780,178
"10344",213358,1999,1,0,"LA ROCHE COLLEGE",NA,NA,306,170,136,133,58,75,0.441,0.435,0.426,11100,202
"10345",213358,2000,1,0,"LA ROCHE COLLEGE",NA,NA,351,199,152,200,98,102,0.513,0.57,0.645,11600,211
"10346",213358,2001,1,0,"LA ROCHE COLLEGE",NA,NA,214,133,81,91,34,57,0.429,0.425,0.42,12180,178
"10347",213358,2002,1,0,"LA ROCHE COLLEGE",NA,NA,295,175,120,117,43,74,0.423,0.397,0.358,12790,217
"10348",213358,2003,1,0,"LA ROCHE COLLEGE",NA,NA,174,124,50,58,13,45,0.363,0.333,0.26,15220,159
"10349",213358,2004,1,0,"LA ROCHE COLLEGE",NA,NA,214,141,73,46,10,36,0.255,0.215,0.137,15982,182
"10350",213358,2005,1,0,"La Roche College",NA,NA,302,203,99,103,32,71,0.35,0.341,0.323,16780,212
"10351",213358,2006,1,0,"La Roche College",NA,NA,259,164,95,92,32,60,0.366,0.355,0.337,17620,158
"10352",213358,2007,1,0,"La Roche College",NA,NA,294,192,102,93,29,64,0.333,0.316,0.284,18600,177
"10353",213358,2008,1,0,"La Roche College",NA,NA,227,148,79,60,15,45,0.304,0.264,0.19,19660,130
"10354",213358,2009,1,0,"La Roche College",NA,NA,190,121,69,46,15,31,0.256,0.242,0.217,20740,112
"10355",213358,2010,1,0,"La Roche College",NA,NA,269,151,118,93,48,45,0.298,0.346,0.407,21570,183
"10356",213367,1991,1,0,"LA SALLE UNIVERSITY",NA,NA,594,293,301,331,152,179,0.611,0.557,0.505,10300,512
"10357",213367,1992,1,0,"LA SALLE UNIVERSITY",NA,NA,564,293,271,358,159,199,0.679,0.635,0.587,10970,485
"10358",213367,1993,1,0,"LA SALLE UNIVERSITY",NA,NA,597,327,270,321,125,196,0.599,0.538,0.463,11560,509
"10359",213367,1995,1,0,"LA SALLE UNIVERSITY",NA,NA,741,438,303,404,140,264,0.603,0.545,0.462,13070,649
"10360",213367,1996,1,0,"LA SALLE UNIVERSITY",NA,NA,648,355,293,362,146,216,0.609,0.559,0.498,14090,550
"10361",213367,1997,1,0,"LA SALLE UNIVERSITY",NA,NA,834,479,355,476,184,292,0.61,0.571,0.518,14850,714
"10362",213367,1998,1,0,"LA SALLE UNIVERSITY",NA,NA,663,321,342,361,161,200,0.623,0.544,0.471,15860,552
"10363",213367,1999,1,0,"LA SALLE UNIVERSITY",NA,NA,801,426,375,446,188,258,0.606,0.557,0.501,16880,681
"10364",213367,2000,1,0,"LA SALLE UNIVERSITY",NA,NA,774,404,370,455,203,252,0.624,0.588,0.549,18020,641
"10365",213367,2001,1,0,"LA SALLE UNIVERSITY",NA,NA,849,476,373,514,190,324,0.681,0.605,0.509,19740,696
"10366",213367,2002,1,0,"LA SALLE UNIVERSITY",NA,NA,837,456,381,445,173,272,0.597,0.532,0.454,21270,692
"10367",213367,2003,1,0,"LA SALLE UNIVERSITY",NA,NA,809,423,386,461,204,257,0.608,0.57,0.528,22760,584
"10368",213367,2004,1,0,"LA SALLE UNIVERSITY",NA,NA,829,419,410,441,195,246,0.587,0.532,0.476,24410,627
"10369",213367,2005,1,0,"La Salle University",NA,NA,803,440,363,400,160,240,0.545,0.498,0.441,25880,543
"10370",213367,2006,1,0,"La Salle University",NA,NA,884,512,372,467,180,287,0.56,0.528,0.484,27500,609
"10371",213367,2007,1,0,"La Salle University",NA,NA,804,472,332,424,136,288,0.61,0.527,0.41,29200,538
"10372",213367,2008,1,0,"La Salle University",NA,NA,902,519,383,471,190,281,0.541,0.522,0.496,31000,548
"10373",213367,2009,1,0,"La Salle University",NA,NA,1005,580,425,522,209,313,0.54,0.519,0.492,32500,618
"10374",213367,2010,1,0,"La Salle University",NA,NA,982,605,377,524,182,342,0.565,0.534,0.483,33500,602
"10375",213385,1991,1,0,"LAFAYETTE COLLEGE",NA,NA,519,243,276,426,212,214,0.881,0.821,0.768,15475,434
"10376",213385,1992,1,0,"LAFAYETTE COLLEGE",NA,NA,575,263,312,455,231,224,0.852,0.791,0.74,16795,506
"10377",213385,1993,1,0,"LAFAYETTE COLLEGE",NA,NA,570,252,318,443,226,217,0.861,0.777,0.711,17880,481
"10378",213385,1995,1,0,"LAFAYETTE COLLEGE",NA,NA,525,241,284,415,208,207,0.859,0.79,0.732,19621,457
"10379",213385,1996,1,0,"LAFAYETTE COLLEGE",NA,NA,572,281,291,460,215,245,0.872,0.804,0.739,20390,522
"10380",213385,1997,1,0,"LAFAYETTE COLLEGE",NA,NA,568,263,305,456,230,226,0.859,0.803,0.754,21202,498
"10381",213385,1998,1,0,"LAFAYETTE COLLEGE",NA,NA,597,281,316,480,241,239,0.851,0.804,0.763,22049,517
"10382",213385,1999,1,0,"LAFAYETTE COLLEGE",NA,NA,583,316,267,505,218,287,0.908,0.866,0.816,22844,506
"10383",213385,2000,1,0,"LAFAYETTE COLLEGE",NA,NA,558,280,278,490,238,252,0.9,0.878,0.856,23758,482
"10384",213385,2001,1,0,"LAFAYETTE COLLEGE",NA,NA,575,287,288,487,238,249,0.868,0.847,0.826,24828,508
"10385",213385,2002,1,0,"LAFAYETTE COLLEGE",NA,NA,580,267,313,498,263,235,0.88,0.859,0.84,25946,486
"10386",213385,2003,1,0,"LAFAYETTE COLLEGE",NA,NA,584,268,316,502,267,235,0.877,0.86,0.845,27178,475
"10387",213385,2004,1,0,"LAFAYETTE COLLEGE",NA,NA,609,315,294,529,249,280,0.889,0.869,0.847,28470,516
"10388",213385,2005,1,0,"Lafayette College",NA,NA,596,275,321,508,268,240,0.873,0.852,0.835,29822,438
"10389",213385,2006,1,0,"Lafayette College",NA,NA,629,290,339,561,299,262,0.903,0.892,0.882,31501,445
"10390",213385,2007,1,0,"Lafayette College",NA,NA,591,277,314,500,253,247,0.892,0.846,0.806,33634,434
"10391",213385,2008,1,0,"Lafayette College",NA,NA,600,270,330,530,280,250,0.926,0.883,0.848,35904,396
"10392",213385,2009,1,0,"Lafayette College",NA,NA,616,298,318,533,263,270,0.906,0.865,0.827,37520,348
"10393",213385,2010,1,0,"Lafayette College",NA,NA,648,294,354,553,279,274,0.932,0.853,0.788,38810,443
"10394",213507,1991,1,0,"LEBANON VALLEY COLLEGE",NA,NA,180,77,103,98,50,48,0.623,0.544,0.485,11750,166
"10395",213507,1992,1,0,"LEBANON VALLEY COLLEGE",NA,NA,280,123,157,161,84,77,0.626,0.575,0.535,12875,263
"10396",213507,1993,1,0,"LEBANON VALLEY COLLEGE",NA,NA,314,170,144,191,77,114,0.671,0.608,0.535,13700,297
"10397",213507,1995,1,0,"LEBANON VALLEY COLLEGE",NA,NA,297,155,142,183,79,104,0.671,0.616,0.556,14785,284
"10398",213507,1996,1,0,"LEBANON VALLEY COLLEGE",NA,NA,287,172,115,165,53,112,0.651,0.575,0.461,15360,269
"10399",213507,1997,1,0,"LEBANON VALLEY COLLEGE",NA,NA,303,174,129,185,71,114,0.655,0.611,0.55,15980,276
"10400",213507,1998,1,0,"LEBANON VALLEY COLLEGE",NA,NA,422,208,214,247,110,137,0.659,0.585,0.514,16610,389
"10401",213507,1999,1,0,"LEBANON VALLEY COLLEGE",NA,NA,407,238,169,279,102,177,0.744,0.686,0.604,16730,383
"10402",213507,2000,1,0,"LEBANON VALLEY COLLEGE",NA,NA,388,225,163,242,85,157,0.698,0.624,0.521,17870,358
"10403",213507,2001,1,0,"LEBANON VALLEY COLLEGE",NA,NA,416,229,187,266,105,161,0.703,0.639,0.561,19210,389
"10404",213507,2002,1,0,"LEBANON VALLEY COLLEGE",NA,NA,422,234,188,266,99,167,0.714,0.63,0.527,20600,390
"10405",213507,2003,1,0,"LEBANON VALLEY COLLEGE",NA,NA,429,231,198,292,119,173,0.749,0.681,0.601,21860,387
"10406",213507,2004,1,0,"LEBANON VALLEY COLLEGE",NA,NA,416,221,195,287,121,166,0.751,0.69,0.621,22950,367
"10407",213507,2005,1,0,"Lebanon Valley College",NA,NA,454,223,231,304,138,166,0.744,0.67,0.597,24210,391
"10408",213507,2006,1,0,"Lebanon Valley College",NA,NA,447,241,206,300,114,186,0.772,0.671,0.553,25710,403
"10409",213507,2007,1,0,"Lebanon Valley College",NA,NA,450,261,189,308,109,199,0.763,0.684,0.577,27125,392
"10410",213507,2008,1,0,"Lebanon Valley College",NA,NA,395,217,178,276,110,166,0.765,0.699,0.618,28650,353
"10411",213507,2009,1,0,"Lebanon Valley College",NA,NA,378,205,173,258,92,166,0.81,0.683,0.532,29780,339
"10412",213507,2010,1,0,"Lebanon Valley College",NA,NA,460,245,215,331,152,179,0.731,0.72,0.707,30910,405
"10413",213543,1991,1,0,"LEHIGH UNIVERSITY",NA,NA,1117,411,706,749,435,314,0.764,0.671,0.616,15650,980
"10414",213543,1992,1,0,"LEHIGH UNIVERSITY",NA,NA,1089,385,704,720,430,290,0.753,0.661,0.611,16700,958
"10415",213543,1993,1,0,"LEHIGH UNIVERSITY",NA,NA,1095,394,701,706,404,302,0.767,0.645,0.576,17750,941
"10416",213543,1995,1,0,"LEHIGH UNIVERSITY",NA,NA,1045,412,633,734,404,330,0.801,0.702,0.638,19650,828
"10417",213543,1996,1,0,"LEHIGH UNIVERSITY",NA,NA,1101,409,692,768,433,335,0.819,0.698,0.626,20500,847
"10418",213543,1997,1,0,"LEHIGH UNIVERSITY",NA,NA,1097,442,655,803,444,359,0.812,0.732,0.678,21350,878
"10419",213543,1998,1,0,"LEHIGH UNIVERSITY",NA,NA,1112,478,634,789,397,392,0.82,0.71,0.626,22300,857
"10420",213543,1999,1,0,"LEHIGH UNIVERSITY",NA,NA,1077,455,622,799,437,362,0.796,0.742,0.703,23150,790
"10421",213543,2000,1,0,"LEHIGH UNIVERSITY",NA,NA,1127,464,663,845,473,372,0.802,0.75,0.713,24000,843
"10422",213543,2001,1,0,"LEHIGH UNIVERSITY",NA,NA,1109,435,674,798,436,362,0.832,0.72,0.647,24940,838
"10423",213543,2002,1,0,"LEHIGH UNIVERSITY",NA,NA,1143,442,701,822,461,361,0.817,0.719,0.658,25980,938
"10424",213543,2003,1,0,"LEHIGH UNIVERSITY",NA,NA,1124,448,676,854,487,367,0.819,0.76,0.72,27230,873
"10425",213543,2004,1,0,"LEHIGH UNIVERSITY",NA,NA,1054,463,591,814,417,397,0.858,0.772,0.706,29140,847
"10426",213543,2005,1,0,"Lehigh University",NA,NA,1223,512,711,956,521,435,0.85,0.782,0.733,31180,1036
"10427",213543,2006,1,0,"Lehigh University",NA,NA,1217,511,706,950,523,427,0.836,0.781,0.741,33470,874
"10428",213543,2007,1,0,"Lehigh University",NA,NA,1165,450,715,851,485,366,0.813,0.73,0.678,35310,850
"10429",213543,2008,1,0,"Lehigh University",NA,NA,1205,516,689,910,484,426,0.826,0.755,0.702,37250,803
"10430",213543,2009,1,0,"Lehigh University",NA,NA,1189,489,700,878,469,409,0.836,0.738,0.67,38330,839
"10431",213543,2010,1,0,"Lehigh University",NA,NA,1208,516,692,932,495,437,0.847,0.772,0.715,39480,885
"10432",213613,1991,1,0,"LOCK HAVEN UNIVERSITY",NA,NA,737,447,290,187,52,135,0.302,0.254,0.179,3020,700
"10433",213613,1992,1,0,"LOCK HAVEN UNIVERSITY",NA,NA,906,514,392,210,61,149,0.29,0.232,0.156,3261,872
"10434",213613,1993,1,0,"LOCK HAVEN UNIVERSITY",NA,NA,758,402,356,157,43,114,0.284,0.207,0.121,3509,720
"10435",213613,1995,1,0,"LOCK HAVEN UNIVERISTY OF PENNSYLVANIA",NA,NA,693,359,334,133,43,90,0.251,0.192,0.129,3822,635
"10436",213613,1996,1,0,"LOCK HAVEN UNIVERISTY OF PENNSYLVANIA",NA,NA,780,419,361,179,62,117,0.279,0.229,0.172,3988,723
"10437",213613,1997,1,0,"LOCK HAVEN UNIVERSITY OF PENNSYLVANIA",NA,NA,822,430,392,188,67,121,0.281,0.229,0.171,4062,768
"10438",213613,1998,1,0,"LOCK HAVEN UNIVERSITY OF PENNSYLVANIA",NA,NA,813,463,350,159,50,109,0.235,0.196,0.143,4071,754
"10439",213613,1999,1,0,"LOCK HAVEN UNIVERSITY OF PENNSYLVANIA",NA,NA,887,502,385,212,65,147,0.293,0.239,0.169,3618,839
"10440",213613,2000,1,0,"LOCK HAVEN UNIVERSITY OF PENNSYLVANIA",NA,NA,890,522,368,250,68,182,0.349,0.281,0.185,3792,824
"10441",213613,2001,1,0,"LOCK HAVEN UNIVERSITY OF PENNSYLVANIA",NA,NA,978,581,397,286,96,190,0.327,0.292,0.242,4016,917
"10442",213613,2002,1,0,"LOCK HAVEN UNIVERSITY OF PENNSYLVANIA",NA,NA,1038,646,392,305,89,216,0.334,0.294,0.227,4378,941
"10443",213613,2003,1,0,"LOCK HAVEN UNIVERSITY OF PENNSYLVANIA",NA,NA,1145,657,488,316,104,212,0.323,0.276,0.213,4598,1033
"10444",213613,2004,1,0,"LOCK HAVEN UNIVERSITY OF PENNSYLVANIA",NA,NA,1191,702,489,348,129,219,0.312,0.292,0.264,4810,1051
"10445",213613,2005,1,0,"Lock Haven University of Pennsylvania",NA,NA,1215,695,520,314,110,204,0.294,0.258,0.212,4906,990
"10446",213613,2006,1,0,"Lock Haven University of Pennsylvania",NA,NA,1079,608,471,266,106,160,0.263,0.247,0.225,5038,900
"10447",213613,2007,1,0,"Lock Haven University of Pennsylvania",NA,NA,1217,656,561,321,144,177,0.27,0.264,0.257,5178,1035
"10448",213613,2008,1,0,"Lock Haven University",NA,NA,1269,731,538,340,119,221,0.302,0.268,0.221,5358,1093
"10449",213613,2009,1,0,"Lock Haven University",NA,NA,1185,702,483,336,117,219,0.312,0.284,0.242,5554,1020
"10450",213613,2010,1,0,"Lock Haven University",NA,NA,1185,630,555,361,158,203,0.322,0.305,0.285,5804,1030
"10451",213668,1991,1,0,"LYCOMING COLLEGE",NA,NA,374,190,184,153,67,86,0.453,0.409,0.364,11100,357
"10452",213668,1992,1,0,"LYCOMING COLLEGE",NA,NA,359,179,180,174,72,102,0.57,0.485,0.4,12000,346
"10453",213668,1993,1,0,"LYCOMING COLLEGE",NA,NA,361,203,158,191,72,119,0.586,0.529,0.456,13000,345
"10454",213668,1995,1,0,"LYCOMING COLLEGE",NA,NA,366,210,156,237,82,155,0.738,0.648,0.526,14700,347
"10455",213668,1996,1,0,"LYCOMING COLLEGE",NA,NA,386,186,200,226,102,124,0.667,0.585,0.51,15460,372
"10456",213668,1997,1,0,"LYCOMING COLLEGE",NA,NA,379,227,152,214,65,149,0.656,0.565,0.428,16130,372
"10457",213668,1998,1,0,"LYCOMING COLLEGE",NA,NA,380,195,185,222,85,137,0.703,0.584,0.459,16810,367
"10458",213668,1999,1,0,"LYCOMING COLLEGE",NA,NA,392,209,183,242,99,143,0.684,0.617,0.541,17440,379
"10459",213668,2000,1,0,"LYCOMING COLLEGE",NA,NA,337,177,160,199,90,109,0.616,0.591,0.562,18240,332
"10460",213668,2001,1,0,"LYCOMING COLLEGE",NA,NA,407,218,189,249,100,149,0.683,0.612,0.529,19104,385
"10461",213668,2002,1,0,"LYCOMING COLLEGE",NA,NA,373,195,178,234,100,134,0.687,0.627,0.562,20032,357
"10462",213668,2003,1,0,"LYCOMING COLLEGE",NA,NA,381,226,155,254,97,157,0.695,0.667,0.626,21088,360
"10463",213668,2004,1,0,"LYCOMING COLLEGE",NA,NA,399,217,182,249,109,140,0.645,0.624,0.599,22336,376
"10464",213668,2005,1,0,"Lycoming College",NA,NA,357,219,138,216,74,142,0.648,0.605,0.536,23680,328
"10465",213668,2006,1,0,"Lycoming College",NA,NA,375,193,182,213,87,126,0.653,0.568,0.478,25120,349
"10466",213668,2007,1,0,"Lycoming College",NA,NA,399,211,188,215,84,131,0.621,0.539,0.447,26624,372
"10467",213668,2008,1,0,"Lycoming College",NA,NA,340,161,179,178,77,101,0.627,0.524,0.43,28224,319
"10468",213668,2009,1,0,"Lycoming College",NA,NA,383,194,189,220,89,131,0.675,0.574,0.471,29344,286
"10469",213668,2010,1,0,"Lycoming College",NA,NA,346,211,135,205,67,138,0.654,0.592,0.496,30240,265
"10470",213783,1991,1,0,"MANSFIELD UNIVERSITY OF PENNSYLVANIA",NA,NA,461,283,178,168,50,118,0.417,0.364,0.281,2947,428
"10471",213783,1992,1,0,"MANSFIELD UNIVERSITY OF PENNSYLVANIA",NA,NA,485,294,191,148,44,104,0.354,0.305,0.23,3168,440
"10472",213783,1993,1,0,"MANSFIELD UNIVERSITY OF PENNSYLVANIA",NA,NA,590,350,240,189,59,130,0.371,0.32,0.246,3440,539
"10473",213783,1995,1,0,"MANSFIELD UNIVERSITY OF PENNSYLVANIA",NA,NA,577,340,237,135,41,94,0.276,0.234,0.173,3804,536
"10474",213783,1996,1,0,"MANSFIELD UNIVERSITY OF PENNSYLVANIA",NA,NA,590,316,274,154,57,97,0.307,0.261,0.208,4034,533
"10475",213783,1997,1,0,"MANSFIELD UNIVERSITY OF PENNSYLVANIA",NA,NA,597,329,268,141,53,88,0.268,0.236,0.198,4354,550
"10476",213783,1998,1,0,"MANSFIELD UNIVERSITY OF PENNSYLVANIA",NA,NA,619,346,273,143,64,79,0.228,0.231,0.234,4410,548
"10477",213783,1999,1,0,"MANSFIELD UNIVERSITY OF PENNSYLVANIA",NA,NA,611,364,247,178,53,125,0.343,0.291,0.215,3618,569
"10478",213783,2000,1,0,"MANSFIELD UNIVERSITY OF PENNSYLVANIA",NA,NA,639,363,276,183,79,104,0.286,0.286,0.286,3792,589
"10479",213783,2001,1,0,"MANSFIELD UNIVERSITY OF PENNSYLVANIA",NA,NA,640,362,278,200,77,123,0.34,0.312,0.277,4016,592
"10480",213783,2002,1,0,"MANSFIELD UNIVERSITY OF PENNSYLVANIA",NA,NA,654,381,273,171,48,123,0.323,0.261,0.176,4378,589
"10481",213783,2003,1,0,"MANSFIELD UNIVERSITY OF PENNSYLVANIA",NA,NA,690,403,287,179,74,105,0.26,0.259,0.258,4598,595
"10482",213783,2004,1,0,"MANSFIELD UNIVERSITY OF PENNSYLVANIA",NA,NA,689,402,287,168,54,114,0.284,0.244,0.188,4810,571
"10483",213783,2005,1,0,"Mansfield University of Pennsylvania",NA,NA,662,406,256,216,62,154,0.379,0.326,0.242,4906,534
"10484",213783,2006,1,0,"Mansfield University of Pennsylvania",NA,NA,603,356,247,172,53,119,0.334,0.285,0.215,5038,503
"10485",213783,2007,1,0,"Mansfield University of Pennsylvania",NA,NA,661,397,264,198,63,135,0.34,0.3,0.239,5177,526
"10486",213783,2008,1,0,"Mansfield University of Pennsylvania",NA,NA,665,410,255,203,67,136,0.332,0.305,0.263,5358,516
"10487",213783,2009,1,0,"Mansfield University of Pennsylvania",NA,NA,704,397,307,189,71,118,0.297,0.268,0.231,5554,532
"10488",213783,2010,1,0,"Mansfield University of Pennsylvania",NA,NA,631,346,285,162,70,92,0.266,0.257,0.246,5804,503
"10489",213826,1991,1,0,"MARYWOOD COLLEGE",NA,NA,281,237,44,95,12,83,0.35,0.338,0.273,8500,265
"10490",213826,1992,1,0,"MARYWOOD COLLEGE",NA,NA,239,193,46,81,5,76,0.394,0.339,0.109,9350,233
"10491",213826,1993,1,0,"MARYWOOD COLLEGE",NA,NA,292,228,64,101,17,84,0.368,0.346,0.266,9950,274
"10492",213826,1995,1,0,"MARYWOOD COLLEGE",NA,NA,245,193,52,99,13,86,0.446,0.404,0.25,11500,227
"10493",213826,1996,1,0,"MARYWOOD COLLEGE",NA,NA,251,191,60,103,18,85,0.445,0.41,0.3,12395,230
"10494",213826,1997,1,0,"MARYWOOD UNIVERSITY",NA,NA,276,209,67,103,18,85,0.407,0.373,0.269,13165,248
"10495",213826,1998,1,0,"MARYWOOD UNIVERSITY",NA,NA,241,186,55,102,16,86,0.462,0.423,0.291,14020,220
"10496",213826,1999,1,0,"MARYWOOD UNIVERSITY",NA,NA,282,207,75,118,25,93,0.449,0.418,0.333,14070,257
"10497",213826,2000,1,0,"MARYWOOD UNIVERSITY",NA,NA,257,188,69,100,29,71,0.378,0.389,0.42,14850,242
"10498",213826,2001,1,0,"MARYWOOD UNIVERSITY",NA,NA,287,215,72,114,23,91,0.423,0.397,0.319,15600,271
"10499",213826,2002,1,0,"MARYWOOD UNIVERSITY",NA,NA,310,238,72,164,29,135,0.567,0.529,0.403,17600,276
"10500",213826,2003,1,0,"MARYWOOD UNIVERSITY",NA,NA,277,199,78,152,34,118,0.593,0.549,0.436,18560,252
"10501",213826,2004,1,0,"MARYWOOD UNIVERSITY",NA,NA,332,262,70,149,24,125,0.477,0.449,0.343,19600,292
"10502",213826,2005,1,0,"Marywood University",NA,NA,301,230,71,153,30,123,0.535,0.508,0.423,20700,254
"10503",213826,2006,1,0,"Marywood University",NA,NA,383,278,105,197,42,155,0.558,0.514,0.4,21840,321
"10504",213826,2007,1,0,"Marywood University",NA,NA,407,297,110,218,46,172,0.579,0.536,0.418,23040,360
"10505",213826,2008,1,0,"Marywood University",NA,NA,422,291,131,238,62,176,0.605,0.564,0.473,24300,380
"10506",213826,2009,1,0,"Marywood University",NA,NA,411,287,124,231,54,177,0.617,0.562,0.435,25150,365
"10507",213826,2010,1,0,"Marywood University",NA,NA,452,338,114,241,44,197,0.583,0.533,0.386,26000,386
"10508",213996,1991,1,0,"MESSIAH COLLEGE",NA,NA,560,343,217,361,136,225,0.656,0.645,0.627,8700,501
"10509",213996,1992,1,0,"MESSIAH COLLEGE",NA,NA,568,357,211,376,142,234,0.655,0.662,0.673,9110,525
"10510",213996,1993,1,0,"MESSIAH COLLEGE",NA,NA,606,376,230,400,155,245,0.652,0.66,0.674,9804,569
"10511",213996,1995,1,0,"MESSIAH COLLEGE",NA,NA,671,416,255,428,163,265,0.637,0.638,0.639,10954,629
"10512",213996,1996,1,0,"MESSIAH COLLEGE",NA,NA,672,407,265,448,168,280,0.688,0.667,0.634,11888,620
"10513",213996,1997,1,0,"MESSIAH COLLEGE",NA,NA,689,445,244,445,165,280,0.629,0.646,0.676,12990,639
"10514",213996,1998,1,0,"MESSIAH COLLEGE",NA,NA,763,480,283,536,205,331,0.69,0.702,0.724,13880,712
"10515",213996,1999,1,0,"MESSIAH COLLEGE",NA,NA,678,413,265,468,168,300,0.726,0.69,0.634,15000,642
"10516",213996,2000,1,0,"MESSIAH COLLEGE",NA,NA,741,451,290,500,184,316,0.701,0.675,0.634,15830,675
"10517",213996,2001,1,0,"MESSIAH COLLEGE",NA,NA,702,425,277,472,166,306,0.72,0.672,0.599,16860,635
"10518",213996,2002,1,0,"MESSIAH COLLEGE",NA,NA,763,475,288,526,168,358,0.754,0.689,0.583,17730,690
"10519",213996,2003,1,0,"MESSIAH COLLEGE",NA,NA,735,463,272,529,189,340,0.734,0.72,0.695,18880,662
"10520",213996,2004,1,0,"MESSIAH COLLEGE",NA,NA,690,453,237,484,159,325,0.717,0.701,0.671,20120,620
"10521",213996,2005,1,0,"Messiah College",NA,NA,707,439,268,500,177,323,0.736,0.707,0.66,21420,629
"10522",213996,2006,1,0,"Messiah College",NA,NA,735,471,264,529,179,350,0.743,0.72,0.678,22600,605
"10523",213996,2007,1,0,"Messiah College",NA,NA,723,459,264,514,185,329,0.717,0.711,0.701,23710,624
"10524",213996,2008,1,0,"Messiah College",NA,NA,709,448,261,529,186,343,0.766,0.746,0.713,24900,585
"10525",213996,2009,1,0,"Messiah College",NA,NA,697,440,257,497,173,324,0.736,0.713,0.673,25900,610
"10526",213996,2010,1,0,"Messiah College",NA,NA,721,433,288,523,210,313,0.723,0.725,0.729,26680,604
"10527",214041,1991,1,0,"MILLERSVILLE UNIVERSITY OF PENNSYLVANIA",NA,NA,1089,672,417,429,127,302,0.449,0.394,0.305,3100,946
"10528",214041,1992,1,0,"MILLERSVILLE UNIVERSITY OF PENNSYLVANIA",NA,NA,1002,635,367,375,93,282,0.444,0.374,0.253,3488,846
"10529",214041,1993,1,0,"MILLERSVILLE UNIVERSITY OF PENNSYLVANIA",NA,NA,946,593,353,339,86,253,0.427,0.358,0.244,3750,770
"10530",214041,1995,1,0,"MILLERSVILLE UNIVERSITY OF PENNSYLVANIA",NA,NA,1157,700,457,389,132,257,0.367,0.336,0.289,4100,1018
"10531",214041,1996,1,0,"MILLERSVILLE UNIVERSITY OF PENNSYLVANIA",NA,NA,979,587,392,327,121,206,0.351,0.334,0.309,4268,848
"10532",214041,1997,1,0,"MILLERSVILLE UNIVERSITY OF PENNSYLVANIA",NA,NA,1068,627,441,409,132,277,0.442,0.383,0.299,4400,899
"10533",214041,1998,1,0,"MILLERSVILLE UNIVERSITY OF PENNSYLVANIA",NA,NA,1110,651,459,383,132,251,0.386,0.345,0.288,4429,976
"10534",214041,1999,1,0,"MILLERSVILLE UNIVERSITY OF PENNSYLVANIA",NA,NA,1239,746,493,424,134,290,0.389,0.342,0.272,3618,1093
"10535",214041,2000,1,0,"MILLERSVILLE UNIVERSITY OF PENNSYLVANIA",NA,NA,1265,768,497,463,163,300,0.391,0.366,0.328,3792,1133
"10536",214041,2001,1,0,"MILLERSVILLE UNIVERSITY OF PENNSYLVANIA",NA,NA,1245,758,487,518,162,356,0.47,0.416,0.333,4016,1118
"10537",214041,2002,1,0,"MILLERSVILLE UNIVERSITY OF PENNSYLVANIA",NA,NA,1270,748,522,463,158,305,0.408,0.365,0.303,4378,1071
"10538",214041,2003,1,0,"MILLERSVILLE UNIVERSITY OF PENNSYLVANIA",NA,NA,1334,754,580,478,159,319,0.423,0.358,0.274,4598,1062
"10539",214041,2004,1,0,"MILLERSVILLE UNIVERSITY OF PENNSYLVANIA",NA,NA,1396,791,605,512,177,335,0.424,0.367,0.293,4810,1019
"10540",214041,2005,1,0,"Millersville University of Pennsylvania",NA,NA,1306,774,532,501,172,329,0.425,0.384,0.323,4906,953
"10541",214041,2006,1,0,"Millersville University of Pennsylvania",NA,NA,1342,792,550,482,154,328,0.414,0.359,0.28,5038,1069
"10542",214041,2007,1,0,"Millersville University of Pennsylvania",NA,NA,1326,766,560,491,161,330,0.431,0.37,0.288,5177,1051
"10543",214041,2008,1,0,"Millersville University of Pennsylvania",NA,NA,1311,729,582,503,190,313,0.429,0.384,0.326,5358,1044
"10544",214041,2009,1,0,"Millersville University of Pennsylvania",NA,NA,1317,726,591,472,179,293,0.404,0.358,0.303,5554,1065
"10545",214041,2010,1,0,"Millersville University of Pennsylvania",NA,NA,1315,728,587,494,193,301,0.414,0.376,0.329,5804,1068
"10546",214069,1991,1,0,"COLLEGE MISERICORDIA",NA,NA,246,187,59,86,23,63,0.337,0.35,0.39,7885,240
"10547",214069,1992,1,0,"COLLEGE MISERICORDIA",NA,NA,292,228,64,88,20,68,0.298,0.301,0.312,9500,283
"10548",214069,1993,1,0,"COLLEGE MISERICORDIA",NA,NA,316,231,85,88,24,64,0.277,0.278,0.282,10460,308
"10549",214069,1995,1,0,"COLLEGE MISERICORDIA",NA,NA,280,204,76,88,28,60,0.294,0.314,0.368,12190,270
"10550",214069,1996,1,0,"COLLEGE MISERICORDIA",NA,NA,251,186,65,59,16,43,0.231,0.235,0.246,12880,246
"10551",214069,1997,1,0,"COLLEGE MISERICORDIA",NA,NA,240,174,66,162,32,130,0.747,0.675,0.485,13830,237
"10552",214069,1998,1,0,"COLLEGE MISERICORDIA",NA,NA,187,142,45,126,31,95,0.669,0.674,0.689,14520,182
"10553",214069,1999,1,0,"COLLEGE MISERICORDIA",NA,NA,249,173,76,165,42,123,0.711,0.663,0.553,14470,241
"10554",214069,2000,1,0,"COLLEGE MISERICORDIA",NA,NA,261,185,76,160,39,121,0.654,0.613,0.513,15190,256
"10555",214069,2001,1,0,"COLLEGE MISERICORDIA",NA,NA,260,188,72,157,39,118,0.628,0.604,0.542,15800,249
"10556",214069,2002,1,0,"COLLEGE MISERICORDIA",NA,NA,347,239,108,201,59,142,0.594,0.579,0.546,16420,329
"10557",214069,2003,1,0,"COLLEGE MISERICORDIA",NA,NA,313,233,80,206,49,157,0.674,0.658,0.613,17970,297
"10558",214069,2004,1,0,"COLLEGE MISERICORDIA",NA,NA,317,225,92,171,41,130,0.578,0.539,0.446,17850,301
"10559",214069,2005,1,0,"College Misericordia",NA,NA,324,222,102,181,52,129,0.581,0.559,0.51,18700,299
"10560",214069,2006,1,0,"College Misericordia",NA,NA,308,192,116,165,57,108,0.562,0.536,0.491,19800,287
"10561",214069,2007,1,0,"Misericordia University",NA,NA,364,273,91,234,51,183,0.67,0.643,0.56,20830,343
"10562",214069,2008,1,0,"Misericordia University",NA,NA,378,248,130,238,72,166,0.669,0.63,0.554,21990,364
"10563",214069,2009,1,0,"Misericordia University",NA,NA,371,236,135,237,78,159,0.674,0.639,0.578,22850,346
"10564",214069,2010,1,0,"Misericordia University",NA,NA,375,265,110,255,62,193,0.728,0.68,0.564,23750,356
"10565",214157,1991,1,0,"MORAVIAN COLLEGE",NA,NA,288,143,145,192,92,100,0.699,0.667,0.634,12698,270
"10566",214157,1992,1,0,"MORAVIAN COLLEGE",NA,NA,296,142,154,187,86,101,0.711,0.632,0.558,13696,281
"10567",214157,1993,1,0,"MORAVIAN COLLEGE",NA,NA,304,157,147,216,102,114,0.726,0.711,0.694,14490,289
"10568",214157,1995,1,0,"MORAVIAN COLLEGE",NA,NA,319,169,150,217,97,120,0.71,0.68,0.647,15880,304
"10569",214157,1996,1,0,"MORAVIAN COLLEGE",NA,NA,284,138,146,194,90,104,0.754,0.683,0.616,16500,275
"10570",214157,1997,1,0,"MORAVIAN COLLEGE",NA,NA,325,190,135,219,86,133,0.7,0.674,0.637,17276,305
"10571",214157,1998,1,0,"MORAVIAN COLLEGE AND THEOLOGICAL SEMINARY",NA,NA,292,172,120,183,69,114,0.663,0.627,0.575,17841,268
"10572",214157,1999,1,0,"MORAVIAN COLLEGE AND THEOLOGICAL SEMINARY",NA,NA,318,162,156,213,102,111,0.685,0.67,0.654,18245,289
"10573",214157,2000,1,0,"MORAVIAN COLLEGE AND THEOLOGICAL SEMINARY",NA,NA,378,236,142,246,80,166,0.703,0.651,0.563,19070,357
"10574",214157,2001,1,0,"MORAVIAN COLLEGE AND THEOLOGICAL SEMINARY",NA,NA,315,200,115,219,68,151,0.755,0.695,0.591,20115,295
"10575",214157,2002,1,0,"MORAVIAN COLLEGE AND THEOLOGICAL SEMINARY",NA,NA,372,214,158,264,102,162,0.757,0.71,0.646,20925,338
"10576",214157,2003,1,0,"MORAVIAN COLLEGE AND THEOLOGICAL SEMINARY",NA,NA,379,239,140,270,90,180,0.753,0.712,0.643,21663,339
"10577",214157,2004,1,0,"MORAVIAN COLLEGE AND THEOLOGICAL SEMINARY",NA,NA,382,215,167,261,103,158,0.735,0.683,0.617,23184,348
"10578",214157,2005,1,0,"Moravian College and Moravian Theological Seminary",NA,NA,382,204,178,280,123,157,0.77,0.733,0.691,24813,350
"10579",214157,2006,1,0,"Moravian College and Moravian Theological Seminary",NA,NA,375,223,152,268,108,160,0.718,0.715,0.711,26300,345
"10580",214157,2007,1,0,"Moravian College and Moravian Theological Seminary",NA,NA,401,214,187,282,130,152,0.71,0.703,0.695,27873,346
"10581",214157,2008,1,0,"Moravian College and Moravian Theological Seminary",NA,NA,387,226,161,253,94,159,0.703,0.654,0.584,29547,345
"10582",214157,2009,1,0,"Moravian College and Moravian Theological Seminary",NA,NA,379,223,156,248,97,151,0.677,0.654,0.622,30735,300
"10583",214157,2010,1,0,"Moravian College and Moravian Theological Seminary",NA,NA,373,216,157,245,96,149,0.69,0.657,0.611,31662,318
"10584",214175,1991,1,0,"MUHLENBERG COLLEGE",NA,NA,463,258,205,336,140,196,0.76,0.726,0.683,15115,427
"10585",214175,1992,1,0,"MUHLENBERG COLLEGE",NA,NA,466,244,222,334,141,193,0.791,0.717,0.635,15740,427
"10586",214175,1993,1,0,"MUHLENBERG COLLEGE",NA,NA,464,270,194,332,131,201,0.744,0.716,0.675,16385,421
"10587",214175,1995,1,0,"MUHLENBERG COLLEGE",NA,NA,486,277,209,392,161,231,0.834,0.807,0.77,17550,440
"10588",214175,1996,1,0,"MUHLENBERG COLLEGE",NA,NA,532,307,225,414,161,253,0.824,0.778,0.716,18100,489
"10589",214175,1997,1,0,"MUHLENBERG COLLEGE",NA,NA,493,293,200,352,135,217,0.741,0.714,0.675,18660,459
"10590",214175,1998,1,0,"MUHLENBERG COLLEGE",NA,NA,577,344,233,438,162,276,0.802,0.759,0.695,19300,532
"10591",214175,1999,1,0,"MUHLENBERG COLLEGE",NA,NA,551,321,230,446,179,267,0.832,0.809,0.778,19910,419
"10592",214175,2000,1,0,"MUHLENBERG COLLEGE",NA,NA,579,340,239,480,196,284,0.835,0.829,0.82,20865,546
"10593",214175,2001,1,0,"MUHLENBERG COLLEGE",NA,NA,574,330,244,456,184,272,0.824,0.794,0.754,22015,526
"10594",214175,2002,1,0,"MUHLENBERG COLLEGE",NA,NA,547,300,247,445,191,254,0.847,0.814,0.773,23250,510
"10595",214175,2003,1,0,"MUHLENBERG COLLEGE",NA,NA,589,354,235,485,179,306,0.864,0.823,0.762,24730,540
"10596",214175,2004,1,0,"MUHLENBERG COLLEGE",NA,NA,559,337,222,456,178,278,0.825,0.816,0.802,26570,510
"10597",214175,2005,1,0,"Muhlenberg College",NA,NA,576,322,254,454,180,274,0.851,0.788,0.709,28550,538
"10598",214175,2006,1,0,"Muhlenberg College",NA,NA,615,376,239,503,185,318,0.846,0.818,0.774,30490,558
"10599",214175,2007,1,0,"Muhlenberg College",NA,NA,551,304,247,445,189,256,0.842,0.808,0.765,32850,504
"10600",214175,2008,1,0,"Muhlenberg College",NA,NA,597,344,253,484,197,287,0.834,0.811,0.779,35125,542
"10601",214175,2009,1,0,"Muhlenberg College",NA,NA,576,337,239,475,187,288,0.855,0.825,0.782,36730,522
"10602",214175,2010,1,0,"Muhlenberg College",NA,NA,603,341,262,485,199,286,0.839,0.804,0.76,38110,504
"10603",214272,1991,1,0,"NEUMANN COLLEGE",NA,NA,84,58,26,30,5,25,0.431,0.357,0.192,8390,79
"10604",214272,1992,1,0,"NEUMANN COLLEGE",NA,NA,63,47,16,29,8,21,0.447,0.46,0.5,9166,59
"10605",214272,1993,1,0,"NEUMANN COLLEGE",NA,NA,84,64,20,33,7,26,0.406,0.393,0.35,10150,82
"10606",214272,1995,1,0,"NEUMANN COLLEGE",NA,NA,159,114,45,15,5,10,0.088,0.094,0.111,11090,147
"10607",214272,1996,1,0,"NEUMANN COLLEGE",NA,NA,114,82,32,41,11,30,0.366,0.36,0.344,12140,104
"10608",214272,1997,1,0,"NEUMANN COLLEGE",NA,NA,187,126,61,59,15,44,0.349,0.316,0.246,12400,121
"10609",214272,1998,1,0,"NEUMANN COLLEGE",NA,NA,314,206,108,131,42,89,0.432,0.417,0.389,13520,244
"10610",214272,1999,1,0,"NEUMANN COLLEGE",NA,NA,324,179,145,108,38,70,0.391,0.333,0.262,13350,267
"10611",214272,2000,1,0,"NEUMANN COLLEGE",NA,NA,299,164,135,87,34,53,0.323,0.291,0.252,13750,241
"10612",214272,2001,1,0,"NEUMANN COLLEGE",NA,NA,345,217,128,115,25,90,0.415,0.333,0.195,14460,265
"10613",214272,2002,1,0,"NEUMANN COLLEGE",NA,NA,363,228,135,114,25,89,0.39,0.314,0.185,15060,286
"10614",214272,2003,1,0,"NEUMANN COLLEGE",NA,NA,510,327,183,209,72,137,0.419,0.41,0.393,15820,402
"10615",214272,2004,1,0,"NEUMANN COLLEGE",NA,NA,462,304,158,135,41,94,0.309,0.292,0.259,16590,322
"10616",214272,2005,1,0,"Neumann College",NA,NA,522,334,188,163,46,117,0.35,0.312,0.245,17300,306
"10617",214272,2006,1,0,"Neumann College",NA,NA,544,325,219,160,46,114,0.351,0.294,0.21,17992,345
"10618",214272,2007,1,0,"Neumann College",NA,NA,540,336,204,157,44,113,0.336,0.291,0.216,18846,344
"10619",214272,2008,1,0,"Neumann College",NA,NA,539,348,191,185,51,134,0.385,0.343,0.267,19742,340
"10620",214272,2009,1,0,"Neumann University",NA,NA,519,323,196,189,57,132,0.409,0.364,0.291,20290,280
"10621",214272,2010,1,0,"Neumann University",NA,NA,547,350,197,166,48,118,0.337,0.303,0.244,21456,261
"10622",214777,1991,1,0,"PENNSYLVANIA STATE UNIVERSITY MAIN CAMPUS",NA,NA,3615,1712,1903,2808,1417,1391,0.812,0.777,0.745,4402,3203
"10623",214777,1992,1,0,"PENNSYLVANIA STATE UNIVERSITY MAIN CAMPUS",NA,NA,4227,1995,2232,2529,1163,1366,0.685,0.598,0.521,4618,3636
"10624",214777,1993,1,0,"PENNSYLVANIA STATE UNIVERSITY-MAIN CAMPUS",NA,NA,4265,2107,2158,1846,741,1105,0.524,0.433,0.343,4822,3769
"10625",214777,1995,1,0,"PENNSYLVANIA STATE UNIVERSITY-MAIN CAMPUS",NA,NA,5400,2712,2688,2410,947,1463,0.54,0.446,0.352,5258,4656
"10626",214777,1996,1,0,"PENNSYLVANIA STATE UNIVERSITY-MAIN CAMPUS",NA,NA,4701,2344,2357,2052,837,1215,0.518,0.437,0.355,5624,3900
"10627",214777,1997,1,0,"PENNSYLVANIA STATE UNIVERSITY-MAIN CAMPUS",NA,NA,5185,2686,2499,2497,980,1517,0.565,0.482,0.392,5832,4384
"10628",214777,1998,1,0,"PENNSYLVANIA STATE UNIVERSITY-MAIN CAMPUS",NA,NA,5117,2590,2527,2448,959,1489,0.575,0.478,0.38,6092,4273
"10629",214777,1999,1,0,"PENNSYLVANIA STATE UNIVERSITY-MAIN CAMPUS",NA,NA,5058,2535,2523,2738,1142,1596,0.63,0.541,0.453,6162,4247
"10630",214777,2000,1,0,"PENNSYLVANIA STATE UNIVERSITY-MAIN CAMPUS",NA,NA,5621,2866,2755,3127,1277,1850,0.645,0.556,0.464,6546,4666
"10631",214777,2001,1,0,"PENNSYLVANIA STATE UNIVERSITY-MAIN CAMPUS",NA,NA,6146,2983,3163,3576,1586,1990,0.667,0.582,0.501,7054,5088
"10632",214777,2002,1,0,"PENNSYLVANIA STATE UNIVERSITY-MAIN CAMPUS",NA,NA,5935,2911,3024,3558,1554,2004,0.688,0.599,0.514,8008,4883
"10633",214777,2003,1,0,"PENNSYLVANIA STATE UNIVERSITY-MAIN CAMPUS",NA,NA,6035,3058,2977,3747,1598,2149,0.703,0.621,0.537,8796,4990
"10634",214777,2004,1,0,"PENNSYLVANIA STATE UNIVERSITY-MAIN CAMPUS",NA,NA,5905,2884,3021,3681,1674,2007,0.696,0.623,0.554,10408,4962
"10635",214777,2005,1,0,"Pennsylvania State University-Main Campus",NA,NA,6499,2976,3523,4096,1969,2127,0.715,0.63,0.559,11024,5455
"10636",214777,2006,1,0,"Pennsylvania State University-Penn State Main Campus",NA,NA,8016,3790,4226,5243,2460,2783,0.734,0.654,0.582,11646,6792
"10637",214777,2007,1,0,"Pennsylvania State University-Main Campus",NA,NA,6492,3121,3371,4191,1943,2248,0.72,0.646,0.576,12284,5328
"10638",214777,2008,1,0,"Pennsylvania State University-Main Campus",NA,NA,7241,3428,3813,4746,2226,2520,0.735,0.655,0.584,13014,5833
"10639",214777,2009,1,0,"Pennsylvania State University-Main Campus",NA,NA,6574,3217,3357,4226,1910,2316,0.72,0.643,0.569,13604,4878
"10640",214777,2010,1,0,"Pennsylvania State University-Main Campus",NA,NA,7321,3542,3779,4942,2239,2703,0.763,0.675,0.592,14412,5484
"10641",215062,1991,1,0,"UNIVERSITY OF PENNSYLVANIA",NA,NA,2286,986,1300,1791,981,810,0.822,0.783,0.755,15644,1414
"10642",215062,1992,1,0,"UNIVERSITY OF PENNSYLVANIA",NA,NA,2259,977,1282,1789,972,817,0.836,0.792,0.758,16838,1374
"10643",215062,1993,1,0,"UNIVERSITY OF PENNSYLVANIA",NA,NA,2434,1086,1348,1923,1008,915,0.843,0.79,0.748,17838,1453
"10644",215062,1995,1,0,"UNIVERSITY OF PENNSYLVANIA",NA,NA,2349,1158,1191,1954,952,1002,0.865,0.832,0.799,19898,1388
"10645",215062,1996,1,0,"UNIVERSITY OF PENNSYLVANIA",NA,NA,2307,1169,1138,1976,924,1052,0.9,0.857,0.812,21130,1387
"10646",215062,1997,1,0,"UNIVERSITY OF PENNSYLVANIA",NA,NA,2324,1132,1192,1928,941,987,0.872,0.83,0.789,22250,1369
"10647",215062,1998,1,0,"UNIVERSITY OF PENNSYLVANIA",NA,NA,2301,1128,1173,1975,969,1006,0.892,0.858,0.826,23254,1198
"10648",215062,1999,1,0,"UNIVERSITY OF PENNSYLVANIA",NA,NA,2402,1155,1247,2079,1056,1023,0.886,0.866,0.847,21746,1218
"10649",215062,2000,1,0,"UNIVERSITY OF PENNSYLVANIA",NA,NA,2270,1125,1145,1986,967,1019,0.906,0.875,0.845,22682,1224
"10650",215062,2001,1,0,"UNIVERSITY OF PENNSYLVANIA",NA,NA,2316,1148,1168,2018,997,1021,0.889,0.871,0.854,23998,1163
"10651",215062,2002,1,0,"UNIVERSITY OF PENNSYLVANIA",NA,NA,2373,1183,1190,2096,1030,1066,0.901,0.883,0.866,25078,1201
"10652",215062,2003,1,0,"UNIVERSITY OF PENNSYLVANIA",NA,NA,2378,1221,1157,2082,992,1090,0.893,0.876,0.857,26282,1211
"10653",215062,2004,1,0,"UNIVERSITY OF PENNSYLVANIA",NA,NA,2359,1191,1168,2090,999,1091,0.916,0.886,0.855,27544,1090
"10654",215062,2005,1,0,"University of Pennsylvania",NA,NA,2479,1260,1219,2162,1033,1129,0.896,0.872,0.847,29030,1169
"10655",215062,2006,1,0,"University of Pennsylvania",NA,NA,2334,1193,1141,2036,952,1084,0.909,0.872,0.834,30598,1017
"10656",215062,2007,1,0,"University of Pennsylvania",NA,NA,2342,1107,1235,2058,1052,1006,0.909,0.879,0.852,32160,1050
"10657",215062,2008,1,0,"University of Pennsylvania",NA,NA,2392,1278,1114,2078,943,1135,0.888,0.869,0.846,33608,916
"10658",215062,2009,1,0,"University of Pennsylvania",NA,NA,2402,1232,1170,2091,976,1115,0.905,0.871,0.834,34868,870
"10659",215062,2010,1,0,"University of Pennsylvania",NA,NA,2363,1213,1150,1999,917,1082,0.892,0.846,0.797,36208,1158
"10660",215743,1991,1,0,"SAINT FRANCIS COLLEGE",NA,NA,279,144,135,97,38,59,0.41,0.348,0.281,9596,265
"10661",215743,1992,1,0,"SAINT FRANCIS COLLEGE",NA,NA,297,145,152,121,58,63,0.435,0.407,0.382,10384,287
"10662",215743,1993,1,0,"SAINT FRANCIS COLLEGE",NA,NA,285,136,149,115,49,66,0.485,0.404,0.329,10480,266
"10663",215743,1995,1,0,"SAINT FRANCIS COLLEGE",NA,NA,334,145,189,135,61,74,0.51,0.404,0.323,11850,320
"10664",215743,1996,1,0,"SAINT FRANCIS COLLEGE",NA,NA,346,205,141,95,24,71,0.346,0.275,0.17,12475,311
"10665",215743,1997,1,0,"SAINT FRANCIS COLLEGE",NA,NA,354,200,154,79,22,57,0.285,0.223,0.143,13120,314
"10666",215743,1998,1,0,"SAINT FRANCIS COLLEGE",NA,NA,335,182,153,90,47,43,0.236,0.269,0.307,13510,298
"10667",215743,1999,1,0,"SAINT FRANCIS COLLEGE",NA,NA,333,215,118,147,34,113,0.526,0.441,0.288,14100,285
"10668",215743,2000,1,0,"SAINT FRANCIS COLLEGE",NA,NA,355,210,145,159,58,101,0.481,0.448,0.4,15808,263
"10669",215743,2001,1,0,"SAINT FRANCIS UNIVERSITY",NA,NA,342,187,155,163,60,103,0.551,0.477,0.387,16512,272
"10670",215743,2002,1,0,"SAINT FRANCIS UNIVERSITY",NA,NA,281,154,127,122,47,75,0.487,0.434,0.37,17024,224
"10671",215743,2003,1,0,"SAINT FRANCIS UNIVERSITY",NA,NA,332,200,132,174,63,111,0.555,0.524,0.477,18292,279
"10672",215743,2004,1,0,"SAINT FRANCIS UNIVERSITY",NA,NA,321,198,123,175,48,127,0.641,0.545,0.39,19390,271
"10673",215743,2005,1,0,"Saint Francis University",NA,NA,364,220,144,190,59,131,0.596,0.522,0.41,20360,294
"10674",215743,2006,1,0,"Saint Francis University",NA,NA,384,234,150,194,66,128,0.547,0.505,0.44,21174,304
"10675",215743,2007,1,0,"Saint Francis University",NA,NA,403,258,145,230,71,159,0.616,0.571,0.49,22444,356
"10676",215743,2008,1,0,"Saint Francis University",NA,NA,412,224,188,254,99,155,0.692,0.617,0.527,23790,363
"10677",215743,2009,1,0,"Saint Francis University",NA,NA,349,207,142,15,3,12,0.058,0.043,0.021,24504,308
"10678",215743,2010,1,0,"Saint Francis University",NA,NA,429,258,171,243,82,161,0.624,0.566,0.48,25484,353
"10679",215798,1991,1,0,"SAINT VINCENT COLLEGE",NA,NA,228,118,110,129,51,78,0.661,0.566,0.464,8760,214
"10680",215798,1992,1,0,"SAINT VINCENT COLLEGE",NA,NA,267,152,115,148,50,98,0.645,0.554,0.435,9360,260
"10681",215798,1993,1,0,"SAINT VINCENT COLLEGE",NA,NA,277,122,155,144,74,70,0.574,0.52,0.477,9900,266
"10682",215798,1995,1,0,"SAINT VINCENT COLLEGE",NA,NA,260,129,131,161,72,89,0.69,0.619,0.55,11310,247
"10683",215798,1996,1,0,"SAINT VINCENT COLLEGE",NA,NA,271,136,135,168,76,92,0.677,0.62,0.563,12100,259
"10684",215798,1997,1,0,"SAINT VINCENT COLLEGE",NA,NA,272,129,143,159,77,82,0.636,0.585,0.538,13030,264
"10685",215798,1998,1,0,"SAINT VINCENT COLLEGE",NA,NA,262,135,127,153,73,80,0.593,0.584,0.575,13780,251
"10686",215798,1999,1,0,"SAINT VINCENT COLLEGE",NA,NA,272,138,134,162,74,88,0.638,0.596,0.552,14250,251
"10687",215798,2000,1,0,"SAINT VINCENT COLLEGE",NA,NA,302,141,161,192,99,93,0.66,0.636,0.615,15531,281
"10688",215798,2001,1,0,"SAINT VINCENT COLLEGE",NA,NA,262,128,134,161,69,92,0.719,0.615,0.515,16585,241
"10689",215798,2002,1,0,"SAINT VINCENT COLLEGE",NA,NA,322,159,163,209,102,107,0.673,0.649,0.626,18080,296
"10690",215798,2003,1,0,"SAINT VINCENT COLLEGE",NA,NA,362,196,166,221,91,130,0.663,0.61,0.548,19000,345
"10691",215798,2004,1,0,"SAINT VINCENT COLLEGE",NA,NA,331,186,145,226,93,133,0.715,0.683,0.641,20312,282
"10692",215798,2005,1,0,"Saint Vincent College",NA,NA,481,254,227,308,141,167,0.657,0.64,0.621,21104,430
"10693",215798,2006,1,0,"Saint Vincent College",NA,NA,437,217,220,272,133,139,0.641,0.622,0.605,22350,401
"10694",215798,2007,1,0,"Saint Vincent College",NA,NA,423,200,223,269,130,139,0.695,0.636,0.583,23459,389
"10695",215798,2008,1,0,"Saint Vincent College",NA,NA,442,195,247,302,167,135,0.692,0.683,0.676,24620,386
"10696",215798,2009,1,0,"Saint Vincent College",NA,NA,446,197,249,267,125,142,0.721,0.599,0.502,25350,388
"10697",215798,2010,1,0,"Saint Vincent College",NA,NA,422,202,220,261,113,148,0.733,0.618,0.514,26350,372
"10698",215929,1991,1,0,"UNIVERSITY OF SCRANTON",NA,NA,897,457,440,646,294,352,0.77,0.72,0.668,9530,840
"10699",215929,1992,1,0,"UNIVERSITY OF SCRANTON",NA,NA,898,495,403,605,262,343,0.693,0.674,0.65,9920,814
"10700",215929,1993,1,0,"UNIVERSITY OF SCRANTON",NA,NA,899,496,403,582,239,343,0.692,0.647,0.593,10820,812
"10701",215929,1995,1,0,"UNIVERSITY OF SCRANTON",NA,NA,907,515,392,590,261,329,0.639,0.65,0.666,12570,830
"10702",215929,1996,1,0,"UNIVERSITY OF SCRANTON",NA,NA,948,550,398,623,254,369,0.671,0.657,0.638,15000,869
"10703",215929,1997,1,0,"UNIVERSITY OF SCRANTON",NA,NA,905,538,367,644,247,397,0.738,0.712,0.673,15880,820
"10704",215929,1998,1,0,"UNIVERSITY OF SCRANTON",NA,NA,873,527,346,607,217,390,0.74,0.695,0.627,16820,804
"10705",215929,1999,1,0,"UNIVERSITY OF SCRANTON",NA,NA,958,550,408,675,268,407,0.74,0.705,0.657,17540,876
"10706",215929,2000,1,0,"UNIVERSITY OF SCRANTON",NA,NA,833,472,361,625,259,366,0.775,0.75,0.717,18460,717
"10707",215929,2001,1,0,"UNIVERSITY OF SCRANTON",NA,NA,1013,578,435,674,258,416,0.72,0.665,0.593,19330,853
"10708",215929,2002,1,0,"UNIVERSITY OF SCRANTON",NA,NA,958,569,389,702,258,444,0.78,0.733,0.663,20248,795
"10709",215929,2003,1,0,"UNIVERSITY OF SCRANTON",NA,NA,974,538,436,716,307,409,0.76,0.735,0.704,21208,832
"10710",215929,2004,1,0,"UNIVERSITY OF SCRANTON",NA,NA,965,559,406,658,248,410,0.733,0.682,0.611,22214,769
"10711",215929,2005,1,0,"University of Scranton",NA,NA,943,551,392,629,248,381,0.692,0.667,0.633,23750,768
"10712",215929,2006,1,0,"University of Scranton",NA,NA,980,585,395,740,289,451,0.771,0.755,0.732,25638,802
"10713",215929,2007,1,0,"University of Scranton",NA,NA,1025,574,451,771,307,464,0.808,0.752,0.681,28458,822
"10714",215929,2008,1,0,"University of Scranton",NA,NA,961,555,406,710,274,436,0.786,0.739,0.675,31276,828
"10715",215929,2009,1,0,"University of Scranton",NA,NA,1027,578,449,747,296,451,0.78,0.727,0.659,32824,852
"10716",215929,2010,1,0,"University of Scranton",NA,NA,950,508,442,688,291,397,0.782,0.724,0.658,34236,745
"10717",216010,1991,1,0,"SHIPPENSBURG UNIVERSITY OF PENNSYLVANIA",NA,NA,1163,631,532,474,153,321,0.509,0.408,0.288,3108,1070
"10718",216010,1992,1,0,"SHIPPENSBURG UNIVERSITY OF PENNSYLVANIA",NA,NA,1238,675,563,441,156,285,0.422,0.356,0.277,3388,1173
"10719",216010,1993,1,0,"SHIPPENSBURG UNIVERSITY OF PENNSYLVANIA",NA,NA,1114,603,511,443,162,281,0.466,0.398,0.317,3710,1039
"10720",216010,1995,1,0,"SHIPPENSBURG UNIVERSITY OF PENNSYLVANIA",NA,NA,1278,665,613,497,188,309,0.465,0.389,0.307,4010,1182
"10721",216010,1996,1,0,"SHIPPENSBURG UNIVERSITY OF PENNSYLVANIA",NA,NA,1272,674,598,455,168,287,0.426,0.358,0.281,4230,1168
"10722",216010,1997,1,0,"SHIPPENSBURG UNIVERSITY OF PENNSYLVANIA",NA,NA,1292,741,551,476,178,298,0.402,0.368,0.323,4344,1193
"10723",216010,1998,1,0,"SHIPPENSBURG UNIVERSITY OF PENNSYLVANIA",NA,NA,1211,654,557,480,181,299,0.457,0.396,0.325,4346,1095
"10724",216010,1999,1,0,"SHIPPENSBURG UNIVERSITY OF PENNSYLVANIA",NA,NA,1377,734,643,574,231,343,0.467,0.417,0.359,3618,1291
"10725",216010,2000,1,0,"SHIPPENSBURG UNIVERSITY OF PENNSYLVANIA",NA,NA,1520,831,689,679,233,446,0.537,0.447,0.338,3792,1421
"10726",216010,2001,1,0,"SHIPPENSBURG UNIVERSITY OF PENNSYLVANIA",NA,NA,1478,805,673,683,239,444,0.552,0.462,0.355,4016,1353
"10727",216010,2002,1,0,"SHIPPENSBURG UNIVERSITY OF PENNSYLVANIA",NA,NA,1507,831,676,721,270,451,0.543,0.478,0.399,4378,1336
"10728",216010,2003,1,0,"SHIPPENSBURG UNIVERSITY OF PENNSYLVANIA",NA,NA,1485,742,743,666,271,395,0.532,0.448,0.365,4598,1292
"10729",216010,2004,1,0,"SHIPPENSBURG UNIVERSITY OF PENNSYLVANIA",NA,NA,1458,748,710,629,251,378,0.505,0.431,0.354,4810,1241
"10730",216010,2005,1,0,"Shippensburg University of Pennsylvania",NA,NA,1495,775,720,622,233,389,0.502,0.416,0.324,4906,1261
"10731",216010,2006,1,0,"Shippensburg University of Pennsylvania",NA,NA,1496,778,718,601,215,386,0.496,0.402,0.299,5038,1252
"10732",216010,2007,1,0,"Shippensburg University of Pennsylvania",NA,NA,1720,927,793,639,251,388,0.419,0.372,0.317,5178,1412
"10733",216010,2008,1,0,"Shippensburg University of Pennsylvania",NA,NA,1716,871,845,638,247,391,0.449,0.372,0.292,5358,1388
"10734",216010,2009,1,0,"Shippensburg University of Pennsylvania",NA,NA,1673,873,800,669,273,396,0.454,0.4,0.341,5554,1370
"10735",216010,2010,1,0,"Shippensburg University of Pennsylvania",NA,NA,1706,888,818,693,275,418,0.471,0.406,0.336,5804,1466
"10736",216038,1991,1,0,"SLIPPERY ROCK UNIVERSITY OF PENNSYLVANIA",NA,NA,1191,690,501,232,76,156,0.226,0.195,0.152,3045,1100
"10737",216038,1992,1,0,"SLIPPERY ROCK UNIVERSITY OF PENNSYLVANIA",NA,NA,1164,658,506,242,95,147,0.223,0.208,0.188,3287,1060
"10738",216038,1993,1,0,"SLIPPERY ROCK UNIVERSITY OF PENNSYLVANIA",NA,NA,1239,739,500,247,77,170,0.23,0.199,0.154,3547,1110
"10739",216038,1995,1,0,"SLIPPERY ROCK UNIVERSITY OF PENNSYLVANIA",NA,NA,1279,715,564,254,82,172,0.241,0.199,0.145,4013,1174
"10740",216038,1996,1,0,"SLIPPERY ROCK UNIVERSITY OF PENNSYLVANIA",NA,NA,1197,677,520,247,85,162,0.239,0.206,0.163,4179,1079
"10741",216038,1997,1,0,"SLIPPERY ROCK UNIVERSITY OF PENNSYLVANIA",NA,NA,1193,684,509,248,76,172,0.252,0.208,0.149,4302,1118
"10742",216038,1998,1,0,"SLIPPERY ROCK UNIVERSITY OF PENNSYLVANIA",NA,NA,1260,713,547,297,95,202,0.283,0.236,0.174,4311,1189
"10743",216038,1999,1,0,"SLIPPERY ROCK UNIVERSITY OF PENNSYLVANIA",NA,NA,1302,742,560,334,103,231,0.311,0.257,0.184,3618,1206
"10744",216038,2000,1,0,"SLIPPERY ROCK UNIVERSITY OF PENNSYLVANIA",NA,NA,1346,794,552,372,105,267,0.336,0.276,0.19,3792,1229
"10745",216038,2001,1,0,"SLIPPERY ROCK UNIVERSITY OF PENNSYLVANIA",NA,NA,1314,751,563,378,117,261,0.348,0.288,0.208,4016,1200
"10746",216038,2002,1,0,"SLIPPERY ROCK UNIVERSITY OF PENNSYLVANIA",NA,NA,1421,796,625,416,139,277,0.348,0.293,0.222,4378,1273
"10747",216038,2003,1,0,"SLIPPERY ROCK UNIVERSITY OF PENNSYLVANIA",NA,NA,1465,803,662,455,158,297,0.37,0.311,0.239,4598,1311
"10748",216038,2004,1,0,"SLIPPERY ROCK UNIVERSITY OF PENNSYLVANIA",NA,NA,1530,890,640,551,196,355,0.399,0.36,0.306,4810,1383
"10749",216038,2005,1,0,"Slippery Rock University of Pennsylvania",NA,NA,1457,800,657,556,216,340,0.425,0.382,0.329,4906,1315
"10750",216038,2006,1,0,"Slippery Rock University of Pennsylvania",NA,NA,1416,832,584,545,185,360,0.433,0.385,0.317,5038,1228
"10751",216038,2007,1,0,"Slippery Rock University of Pennsylvania",NA,NA,1498,876,622,596,185,411,0.469,0.398,0.297,5178,1272
"10752",216038,2008,1,0,"Slippery Rock University of Pennsylvania",NA,NA,1527,887,640,749,272,477,0.538,0.491,0.425,5358,1262
"10753",216038,2009,1,0,"Slippery Rock University of Pennsylvania",NA,NA,1534,915,619,795,258,537,0.587,0.518,0.417,5554,1312
"10754",216038,2010,1,0,"Slippery Rock University of Pennsylvania",NA,NA,1562,969,593,808,265,543,0.56,0.517,0.447,5804,1378
"10755",216287,1991,1,0,"SWARTHMORE COLLEGE",NA,NA,319,148,171,266,138,128,0.865,0.834,0.807,16640,247
"10756",216287,1992,1,0,"SWARTHMORE COLLEGE",NA,NA,353,172,181,285,143,142,0.826,0.807,0.79,17646,255
"10757",216287,1993,1,0,"SWARTHMORE COLLEGE",NA,NA,413,226,187,348,149,199,0.88,0.843,0.797,18482,289
"10758",216287,1995,1,0,"SWARTHMORE COLLEGE",NA,NA,354,190,164,308,134,174,0.916,0.87,0.817,20186,266
"10759",216287,1996,1,0,"SWARTHMORE COLLEGE",NA,NA,412,217,195,354,167,187,0.862,0.859,0.856,21054,243
"10760",216287,1997,1,0,"SWARTHMORE COLLEGE",NA,NA,373,193,180,309,136,173,0.896,0.828,0.756,22000,232
"10761",216287,1998,1,0,"SWARTHMORE COLLEGE",NA,NA,361,193,168,297,132,165,0.855,0.823,0.786,23240,210
"10762",216287,1999,1,0,"SWARTHMORE COLLEGE",NA,NA,368,192,176,315,142,173,0.901,0.856,0.807,23964,222
"10763",216287,2000,1,0,"SWARTHMORE COLLEGE",NA,NA,366,195,171,316,141,175,0.897,0.863,0.825,24950,227
"10764",216287,2001,1,0,"SWARTHMORE COLLEGE",NA,NA,380,193,187,346,165,181,0.938,0.911,0.882,26098,218
"10765",216287,2002,1,0,"SWARTHMORE COLLEGE",NA,NA,371,189,182,326,155,171,0.905,0.879,0.852,27272,197
"10766",216287,2003,1,0,"SWARTHMORE COLLEGE",NA,NA,368,198,170,316,141,175,0.884,0.859,0.829,28500,173
"10767",216287,2004,1,0,"SWARTHMORE COLLEGE",NA,NA,365,189,176,324,153,171,0.905,0.888,0.869,29782,151
"10768",216287,2005,1,0,"Swarthmore College",NA,NA,389,198,191,355,171,184,0.929,0.913,0.895,31196,170
"10769",216287,2006,1,0,"Swarthmore College",NA,NA,370,193,177,318,143,175,0.907,0.859,0.808,32912,166
"10770",216287,2007,1,0,"Swarthmore College",NA,NA,365,190,175,324,152,172,0.905,0.888,0.869,34564,162
"10771",216287,2008,1,0,"Swarthmore College",NA,NA,372,184,188,330,159,171,0.929,0.887,0.846,36154,163
"10772",216287,2009,1,0,"Swarthmore College",NA,NA,394,204,190,343,159,184,0.902,0.871,0.837,37510,165
"10773",216287,2010,1,0,"Swarthmore College",NA,NA,387,195,192,339,169,170,0.872,0.876,0.88,39260,183
"10774",216339,1991,1,0,"TEMPLE UNIVERSITY",NA,NA,2084,1071,1013,287,115,172,0.161,0.138,0.114,4756,1252
"10775",216339,1992,1,0,"TEMPLE UNIVERSITY",NA,NA,2029,1068,961,337,124,213,0.199,0.166,0.129,5008,1130
"10776",216339,1993,1,0,"TEMPLE UNIVERSITY",NA,NA,2186,1209,977,355,141,214,0.177,0.162,0.144,5226,1263
"10777",216339,1995,1,0,"TEMPLE UNIVERSITY",NA,NA,2302,1366,936,440,143,297,0.217,0.191,0.153,5514,1090
"10778",216339,1996,1,0,"TEMPLE UNIVERSITY",NA,NA,2155,1284,871,442,138,304,0.237,0.205,0.158,5828,1001
"10779",216339,1997,1,0,"TEMPLE UNIVERSITY",NA,NA,2149,1233,916,503,176,327,0.265,0.234,0.192,6150,1016
"10780",216339,1998,1,0,"TEMPLE UNIVERSITY",NA,NA,2150,1279,871,521,171,350,0.274,0.242,0.196,6378,1077
"10781",216339,1999,1,0,"TEMPLE UNIVERSITY",NA,NA,2747,1628,1119,721,228,493,0.303,0.262,0.204,6332,1396
"10782",216339,2000,1,0,"TEMPLE UNIVERSITY",NA,NA,3031,1767,1264,857,318,539,0.305,0.283,0.252,6648,1536
"10783",216339,2001,1,0,"TEMPLE UNIVERSITY",NA,NA,3157,1826,1331,919,319,600,0.329,0.291,0.24,6974,1694
"10784",216339,2002,1,0,"TEMPLE UNIVERSITY",NA,NA,3467,2034,1433,1170,394,776,0.382,0.337,0.275,7602,2075
"10785",216339,2003,1,0,"TEMPLE UNIVERSITY",NA,NA,3590,2106,1484,1232,459,773,0.367,0.343,0.309,8134,2203
"10786",216339,2004,1,0,"TEMPLE UNIVERSITY",NA,NA,3788,2184,1604,1216,468,748,0.342,0.321,0.292,8622,2290
"10787",216339,2005,1,0,"Temple University",NA,NA,3841,2175,1666,1247,483,764,0.351,0.325,0.29,9140,2295
"10788",216339,2006,1,0,"Temple University",NA,NA,3848,2105,1743,1377,578,799,0.38,0.358,0.332,9680,2224
"10789",216339,2007,1,0,"Temple University",NA,NA,4385,2478,1907,1705,684,1021,0.412,0.389,0.359,10252,2607
"10790",216339,2008,1,0,"Temple University",NA,NA,4157,2260,1897,1718,663,1055,0.467,0.413,0.349,10858,2511
"10791",216339,2009,1,0,"Temple University",NA,NA,4183,2320,1863,1808,687,1121,0.483,0.432,0.369,11174,2575
"10792",216339,2010,1,0,"Temple University",NA,NA,4305,2273,2032,1920,783,1137,0.5,0.446,0.385,11834,2770
"10793",216524,1991,1,0,"URSINUS COLLEGE",NA,NA,234,124,110,155,69,86,0.694,0.662,0.627,12555,205
"10794",216524,1992,1,0,"URSINUS COLLEGE",NA,NA,403,199,204,285,131,154,0.774,0.707,0.642,13330,363
"10795",216524,1993,1,0,"URSINUS COLLEGE",NA,NA,308,159,149,226,108,118,0.742,0.734,0.725,14265,281
"10796",216524,1995,1,0,"URSINUS COLLEGE",NA,NA,315,170,145,230,106,124,0.729,0.73,0.731,15840,270
"10797",216524,1996,1,0,"URSINUS COLLEGE",NA,NA,327,180,147,244,105,139,0.772,0.746,0.714,16600,281
"10798",216524,1997,1,0,"URSINUS COLLEGE",NA,NA,314,162,152,236,117,119,0.735,0.752,0.77,17380,260
"10799",216524,1998,1,0,"URSINUS COLLEGE",NA,NA,336,189,147,249,93,156,0.825,0.741,0.633,18520,280
"10800",216524,1999,1,0,"URSINUS COLLEGE",NA,NA,337,173,164,241,106,135,0.78,0.715,0.646,19950,271
"10801",216524,2000,1,0,"URSINUS COLLEGE",NA,NA,376,214,162,287,112,175,0.818,0.763,0.691,21050,313
"10802",216524,2001,1,0,"URSINUS COLLEGE",NA,NA,387,230,157,278,114,164,0.713,0.718,0.726,24850,314
"10803",216524,2002,1,0,"URSINUS COLLEGE",NA,NA,427,212,215,301,134,167,0.788,0.705,0.623,26200,348
"10804",216524,2003,1,0,"URSINUS COLLEGE",NA,NA,453,233,220,356,163,193,0.828,0.786,0.741,27500,338
"10805",216524,2004,1,0,"URSINUS COLLEGE",NA,NA,393,200,193,303,142,161,0.805,0.771,0.736,29650,305
"10806",216524,2005,1,0,"Ursinus College",NA,NA,411,222,189,309,136,173,0.779,0.752,0.72,31450,294
"10807",216524,2006,1,0,"Ursinus College",NA,NA,405,217,188,287,126,161,0.742,0.709,0.67,33200,300
"10808",216524,2007,1,0,"Ursinus College",NA,NA,468,242,226,353,159,194,0.802,0.754,0.704,35000,354
"10809",216524,2008,1,0,"Ursinus College",NA,NA,543,304,239,428,181,247,0.812,0.788,0.757,36750,376
"10810",216524,2009,1,0,"Ursinus College",NA,NA,509,260,249,379,178,201,0.773,0.745,0.715,38500,406
"10811",216524,2010,1,0,"Ursinus College",NA,NA,441,236,205,323,144,179,0.758,0.732,0.702,39950,332
"10812",216694,1991,1,0,"WAYNESBURG COLLEGE",NA,NA,317,185,132,112,33,79,0.427,0.353,0.25,7690,294
"10813",216694,1992,1,0,"WAYNESBURG COLLEGE",NA,NA,346,178,168,158,65,93,0.522,0.457,0.387,8120,333
"10814",216694,1993,1,0,"WAYNESBURG COLLEGE",NA,NA,325,180,145,132,51,81,0.45,0.406,0.352,8580,293
"10815",216694,1995,1,0,"WAYNESBURG COLLEGE",NA,NA,295,141,154,109,46,63,0.447,0.369,0.299,9600,275
"10816",216694,1996,1,0,"WAYNESBURG COLLEGE",NA,NA,305,134,171,138,59,79,0.59,0.452,0.345,10040,287
"10817",216694,1997,1,0,"WAYNESBURG COLLEGE",NA,NA,309,123,186,132,72,60,0.488,0.427,0.387,10550,281
"10818",216694,1998,1,0,"WAYNESBURG COLLEGE",NA,NA,290,113,177,116,60,56,0.496,0.4,0.339,10970,258
"10819",216694,1999,1,0,"WAYNESBURG COLLEGE",NA,NA,277,126,151,121,64,57,0.452,0.437,0.424,11160,251
"10820",216694,2000,1,0,"WAYNESBURG COLLEGE",NA,NA,328,160,168,146,57,89,0.556,0.445,0.339,11670,314
"10821",216694,2001,1,0,"WAYNESBURG COLLEGE",NA,NA,315,159,156,141,56,85,0.535,0.448,0.359,12250,292
"10822",216694,2002,1,0,"WAYNESBURG COLLEGE",NA,NA,297,141,156,142,50,92,0.652,0.478,0.321,12870,274
"10823",216694,2003,1,0,"WAYNESBURG COLLEGE",NA,NA,327,157,170,157,70,87,0.554,0.48,0.412,13520,308
"10824",216694,2004,1,0,"WAYNESBURG COLLEGE",NA,NA,367,189,178,175,70,105,0.556,0.477,0.393,14200,330
"10825",216694,2005,1,0,"Waynesburg College",NA,NA,340,208,132,171,58,113,0.543,0.503,0.439,14810,294
"10826",216694,2006,1,0,"Waynesburg College",NA,NA,322,172,150,174,69,105,0.61,0.54,0.46,15440,287
"10827",216694,2007,1,0,"Waynesburg University",NA,NA,402,232,170,182,67,115,0.496,0.453,0.394,16080,374
"10828",216694,2008,1,0,"Waynesburg University",NA,NA,376,218,158,195,76,119,0.546,0.519,0.481,16730,351
"10829",216694,2009,1,0,"Waynesburg University",NA,NA,380,221,159,211,77,134,0.606,0.555,0.484,17400,353
"10830",216694,2010,1,0,"Waynesburg University",NA,NA,401,229,172,213,77,136,0.594,0.531,0.448,18050,371
"10831",216764,1991,1,0,"WEST CHESTER UNIVERSITY OF PENNSYLVANIA",NA,NA,1467,960,507,337,79,258,0.269,0.23,0.156,2918,1275
"10832",216764,1992,1,0,"WEST CHESTER UNIVERSITY OF PENNSYLVANIA",NA,NA,1378,883,495,357,90,267,0.302,0.259,0.182,3158,1209
"10833",216764,1993,1,0,"WEST CHESTER UNIVERSITY OF PENNSYLVANIA",NA,NA,1386,876,510,346,74,272,0.31,0.25,0.145,3504,1170
"10834",216764,1995,1,0,"WEST CHESTER UNIVERSITY OF PENNSYLVANIA",NA,NA,1384,873,511,363,85,278,0.318,0.262,0.166,3874,1180
"10835",216764,1996,1,0,"WEST CHESTER UNIVERSITY OF PENNSYLVANIA",NA,NA,1454,943,511,376,88,288,0.305,0.259,0.172,4032,1223
"10836",216764,1997,1,0,"WEST CHESTER UNIVERSITY OF PENNSYLVANIA",NA,NA,1581,1025,556,409,93,316,0.308,0.259,0.167,4162,1374
"10837",216764,1998,1,0,"WEST CHESTER UNIVERSITY OF PENNSYLVANIA",NA,NA,1629,1031,598,474,124,350,0.34,0.291,0.207,4248,1418
"10838",216764,1999,1,0,"WEST CHESTER UNIVERSITY OF PENNSYLVANIA",NA,NA,1710,1069,641,444,122,322,0.301,0.26,0.19,3618,1513
"10839",216764,2000,1,0,"WEST CHESTER UNIVERSITY OF PENNSYLVANIA",NA,NA,1715,1085,630,536,127,409,0.377,0.313,0.202,3792,1506
"10840",216764,2001,1,0,"WEST CHESTER UNIVERSITY OF PENNSYLVANIA",NA,NA,1626,1020,606,561,144,417,0.409,0.345,0.238,4016,1390
"10841",216764,2002,1,0,"WEST CHESTER UNIVERSITY OF PENNSYLVANIA",NA,NA,1766,1104,662,642,168,474,0.429,0.364,0.254,4378,1535
"10842",216764,2003,1,0,"WEST CHESTER UNIVERSITY OF PENNSYLVANIA",NA,NA,1723,1119,604,685,152,533,0.476,0.398,0.252,4598,1441
"10843",216764,2004,1,0,"WEST CHESTER UNIVERSITY OF PENNSYLVANIA",NA,NA,1870,1214,656,734,177,557,0.459,0.393,0.27,4810,1607
"10844",216764,2005,1,0,"West Chester University of Pennsylvania",NA,NA,1898,1219,679,812,216,596,0.489,0.428,0.318,4906,1616
"10845",216764,2006,1,0,"West Chester University of Pennsylvania",NA,NA,1883,1200,683,803,196,607,0.506,0.426,0.287,5038,1597
"10846",216764,2007,1,0,"West Chester University of Pennsylvania",NA,NA,1955,1215,740,857,235,622,0.512,0.438,0.318,5177,1655
"10847",216764,2008,1,0,"West Chester University of Pennsylvania",NA,NA,1992,1231,761,872,232,640,0.52,0.438,0.305,5358,1644
"10848",216764,2009,1,0,"West Chester University of Pennsylvania",NA,NA,2241,1353,888,954,277,677,0.5,0.426,0.312,5554,1908
"10849",216764,2010,1,0,"West Chester University of Pennsylvania",NA,NA,2060,1295,765,946,263,683,0.527,0.459,0.344,5804,1643
"10850",216807,1991,1,0,"WESTMINSTER COLLEGE",NA,NA,319,175,144,223,99,124,0.709,0.699,0.688,10580,312
"10851",216807,1992,1,0,"WESTMINSTER COLLEGE",NA,NA,362,213,149,227,89,138,0.648,0.627,0.597,11210,350
"10852",216807,1993,1,0,"WESTMINSTER COLLEGE",NA,NA,375,216,159,250,93,157,0.727,0.667,0.585,11770,362
"10853",216807,1995,1,0,"WESTMINSTER COLLEGE",NA,NA,376,230,146,250,86,164,0.713,0.665,0.589,13950,364
"10854",216807,1996,1,0,"WESTMINSTER COLLEGE",NA,NA,304,176,128,208,78,130,0.739,0.684,0.609,14535,293
"10855",216807,1997,1,0,"WESTMINSTER COLLEGE",NA,NA,394,239,155,259,93,166,0.695,0.657,0.6,14650,383
"10856",216807,1998,1,0,"WESTMINSTER COLLEGE",NA,NA,372,236,136,252,79,173,0.733,0.677,0.581,15510,365
"10857",216807,1999,1,0,"WESTMINSTER COLLEGE",NA,NA,351,224,127,228,69,159,0.71,0.65,0.543,15485,347
"10858",216807,2000,1,0,"WESTMINSTER COLLEGE",NA,NA,340,199,141,230,87,143,0.719,0.676,0.617,16180,285
"10859",216807,2001,1,0,"WESTMINSTER COLLEGE",NA,NA,375,219,156,224,76,148,0.676,0.597,0.487,16920,286
"10860",216807,2002,1,0,"WESTMINSTER COLLEGE",NA,NA,350,235,115,208,56,152,0.647,0.594,0.487,18100,272
"10861",216807,2003,1,0,"WESTMINSTER COLLEGE",NA,NA,337,206,131,200,61,139,0.675,0.593,0.466,19370,242
"10862",216807,2004,1,0,"WESTMINSTER COLLEGE",NA,NA,378,235,143,225,72,153,0.651,0.595,0.503,20530,269
"10863",216807,2005,1,0,"Westminster College",NA,NA,360,231,129,223,75,148,0.641,0.619,0.581,21700,301
"10864",216807,2006,1,0,"Westminster College",NA,NA,311,180,131,225,87,138,0.767,0.723,0.664,23220,265
"10865",216807,2007,1,0,"Westminster College",NA,NA,311,179,132,195,76,119,0.665,0.627,0.576,24430,258
"10866",216807,2008,1,0,"Westminster College",NA,NA,441,246,195,313,128,185,0.752,0.71,0.656,25900,381
"10867",216807,2009,1,0,"Westminster College",NA,NA,451,277,174,313,117,196,0.708,0.694,0.672,26940,377
"10868",216807,2010,1,0,"Westminster College",NA,NA,402,248,154,274,99,175,0.706,0.682,0.643,28020,341
"10869",216852,1991,1,0,"WIDENER UNIVERSITY PENNSYLVANIA CAMPUS",NA,NA,464,206,258,172,81,91,0.442,0.371,0.314,10500,390
"10870",216852,1992,1,0,"WIDENER UNIVERSITY PENNSYLVANIA CAMPUS",NA,NA,436,169,267,140,66,74,0.438,0.321,0.247,11120,369
"10871",216852,1993,1,0,"WIDENER UNIVERSITY-MAIN CAMPUS",NA,NA,473,215,258,182,79,103,0.479,0.385,0.306,11740,375
"10872",216852,1995,1,0,"WIDENER UNIVERSITY-MAIN CAMPUS",NA,NA,421,175,246,141,64,77,0.44,0.335,0.26,12950,361
"10873",216852,1996,1,0,"WIDENER UNIVERSITY-MAIN CAMPUS",NA,NA,462,217,245,172,73,99,0.456,0.372,0.298,13560,365
"10874",216852,1997,1,0,"WIDENER UNIVERSITY-MAIN CAMPUS",NA,NA,391,174,217,145,65,80,0.46,0.371,0.3,14380,318
"10875",216852,1998,1,0,"WIDENER UNIVERSITY-MAIN CAMPUS",NA,NA,490,207,283,204,111,93,0.449,0.416,0.392,15750,427
"10876",216852,1999,1,0,"WIDENER UNIVERSITY-MAIN CAMPUS",NA,NA,548,250,298,213,100,113,0.452,0.389,0.336,16750,460
"10877",216852,2000,1,0,"WIDENER UNIVERSITY-MAIN CAMPUS",NA,NA,534,231,303,218,96,122,0.528,0.408,0.317,17950,466
"10878",216852,2001,1,0,"WIDENER UNIVERSITY-MAIN CAMPUS",NA,NA,550,227,323,188,78,110,0.485,0.342,0.241,19300,410
"10879",216852,2002,1,0,"WIDENER UNIVERSITY-MAIN CAMPUS",NA,NA,716,327,389,284,119,165,0.505,0.397,0.306,20450,538
"10880",216852,2003,1,0,"WIDENER UNIVERSITY-MAIN CAMPUS",NA,NA,578,286,292,237,90,147,0.514,0.41,0.308,21400,445
"10881",216852,2004,1,0,"WIDENER UNIVERSITY-MAIN CAMPUS",NA,NA,736,342,394,247,97,150,0.439,0.336,0.246,22800,527
"10882",216852,2005,1,0,"Widener University-Main Campus",NA,NA,646,332,314,258,98,160,0.482,0.399,0.312,24620,449
"10883",216852,2006,1,0,"Widener University-Main Campus",NA,NA,740,354,386,317,135,182,0.514,0.428,0.35,26350,466
"10884",216852,2007,1,0,"Widener University-Main Campus",NA,NA,782,382,400,312,133,179,0.469,0.399,0.332,28180,575
"10885",216852,2008,1,0,"Widener University-Main Campus",NA,NA,718,337,381,266,121,145,0.43,0.37,0.318,29990,547
"10886",216852,2009,1,0,"Widener University-Main Campus",NA,NA,710,372,338,304,127,177,0.476,0.428,0.376,31340,505
"10887",216852,2010,1,0,"Widener University-Main Campus",NA,NA,718,371,347,298,116,182,0.491,0.415,0.334,32750,512
"10888",216931,1991,1,0,"WILKES UNIVERSITY",NA,NA,395,170,225,154,71,83,0.488,0.39,0.316,9275,378
"10889",216931,1992,1,0,"WILKES UNIVERSITY",NA,NA,404,164,240,153,73,80,0.488,0.379,0.304,9868,383
"10890",216931,1993,1,0,"WILKES UNIVERSITY",NA,NA,434,198,236,177,85,92,0.465,0.408,0.36,10898,412
"10891",216931,1995,1,0,"WILKES UNIVERSITY",NA,NA,369,167,202,118,60,58,0.347,0.32,0.297,12473,352
"10892",216931,1996,1,0,"WILKES UNIVERSITY",NA,NA,448,181,267,154,83,71,0.392,0.344,0.311,13147,415
"10893",216931,1997,1,0,"WILKES UNIVERSITY",NA,NA,355,168,187,161,72,89,0.53,0.454,0.385,15091,331
"10894",216931,1998,1,0,"WILKES UNIVERSITY",NA,NA,376,160,216,148,70,78,0.488,0.394,0.324,15702,353
"10895",216931,1999,1,0,"WILKES UNIVERSITY",NA,NA,377,161,216,166,88,78,0.485,0.44,0.407,15652,364
"10896",216931,2000,1,0,"WILKES UNIVERSITY",NA,NA,460,196,264,194,93,101,0.515,0.422,0.352,16388,439
"10897",216931,2001,1,0,"WILKES UNIVERSITY",NA,NA,407,198,209,198,99,99,0.5,0.486,0.474,17142,381
"10898",216931,2002,1,0,"WILKES UNIVERSITY",NA,NA,471,239,232,224,101,123,0.515,0.476,0.435,17956,444
"10899",216931,2003,1,0,"WILKES UNIVERSITY",NA,NA,509,235,274,254,107,147,0.625,0.499,0.391,18680,481
"10900",216931,2004,1,0,"WILKES UNIVERSITY",NA,NA,550,296,254,287,128,159,0.537,0.522,0.504,19428,507
"10901",216931,2005,1,0,"Wilkes University",NA,NA,562,297,265,270,114,156,0.525,0.48,0.43,20592,501
"10902",216931,2006,1,0,"Wilkes University",NA,NA,570,285,285,279,133,146,0.512,0.489,0.467,21830,510
"10903",216931,2007,1,0,"Wilkes University",NA,NA,620,299,321,291,146,145,0.485,0.469,0.455,22820,530
"10904",216931,2008,1,0,"Wilkes University",NA,NA,559,290,269,249,114,135,0.465,0.445,0.424,23850,443
"10905",216931,2009,1,0,"Wilkes University",NA,NA,527,243,284,250,121,129,0.531,0.474,0.426,24690,437
"10906",216931,2010,1,0,"Wilkes University",NA,NA,499,249,250,240,106,134,0.538,0.481,0.424,25802,337
"10907",217059,1991,1,0,"YORK COLLEGE PENNSYLVANIA",NA,NA,697,396,301,265,88,177,0.447,0.38,0.292,4380,676
"10908",217059,1992,1,0,"YORK COLLEGE PENNSYLVANIA",NA,NA,691,414,277,263,87,176,0.425,0.381,0.314,4645,662
"10909",217059,1993,1,0,"YORK COLLEGE PENNSYLVANIA",NA,NA,691,397,294,274,102,172,0.433,0.397,0.347,4995,656
"10910",217059,1995,1,0,"YORK COLLEGE PENNSYLVANIA",NA,NA,851,483,368,350,121,229,0.474,0.411,0.329,5730,819
"10911",217059,1996,1,0,"YORK COLLEGE PENNSYLVANIA",NA,NA,805,443,362,319,122,197,0.445,0.396,0.337,5790,774
"10912",217059,1997,1,0,"YORK COLLEGE PENNSYLVANIA",NA,NA,842,496,346,348,128,220,0.444,0.413,0.37,6100,812
"10913",217059,1998,1,0,"YORK COLLEGE PENNSYLVANIA",NA,NA,853,462,391,370,145,225,0.487,0.434,0.371,6310,809
"10914",217059,1999,1,0,"YORK COLLEGE PENNSYLVANIA",NA,NA,909,511,398,372,122,250,0.489,0.409,0.307,6280,880
"10915",217059,2000,1,0,"YORK COLLEGE PENNSYLVANIA",NA,NA,900,510,390,366,129,237,0.465,0.407,0.331,6600,864
"10916",217059,2001,1,0,"YORK COLLEGE PENNSYLVANIA",NA,NA,968,540,428,383,137,246,0.456,0.396,0.32,7000,925
"10917",217059,2002,1,0,"YORK COLLEGE PENNSYLVANIA",NA,NA,921,521,400,373,138,235,0.451,0.405,0.345,7500,878
"10918",217059,2003,1,0,"YORK COLLEGE PENNSYLVANIA",NA,NA,1013,541,472,425,171,254,0.47,0.42,0.362,8000,926
"10919",217059,2004,1,0,"YORK COLLEGE PENNSYLVANIA",NA,NA,1037,612,425,423,151,272,0.444,0.408,0.355,8600,949
"10920",217059,2005,1,0,"York College Pennsylvania",NA,NA,1078,591,487,442,175,267,0.452,0.41,0.359,9350,970
"10921",217059,2006,1,0,"York College Pennsylvania",NA,NA,1092,536,556,452,207,245,0.457,0.414,0.372,10160,945
"10922",217059,2007,1,0,"York College Pennsylvania",NA,NA,1177,597,580,437,189,248,0.415,0.371,0.326,11500,1014
"10923",217059,2008,1,0,"York College Pennsylvania",NA,NA,1097,580,517,427,185,242,0.417,0.389,0.358,12320,974
"10924",217059,2009,1,0,"York College Pennsylvania",NA,NA,1092,595,497,431,144,287,0.482,0.395,0.29,13000,911
"10925",217059,2010,1,0,"York College Pennsylvania",NA,NA,1231,657,574,481,182,299,0.455,0.391,0.317,13640,1053
"10926",217156,1991,1,0,"BROWN UNIVERSITY",NA,NA,1358,658,700,1048,543,505,0.768,0.772,0.776,17224,879
"10927",217156,1992,1,0,"BROWN UNIVERSITY",NA,NA,1406,711,695,1121,553,568,0.799,0.797,0.796,18392,889
"10928",217156,1993,1,0,"BROWN UNIVERSITY",NA,NA,1424,770,654,1109,494,615,0.799,0.779,0.755,19556,961
"10929",217156,1995,1,0,"BROWN UNIVERSITY",NA,NA,1370,739,631,1106,492,614,0.831,0.807,0.78,21727,885
"10930",217156,1996,1,0,"BROWN UNIVERSITY",NA,NA,1469,810,659,1220,536,684,0.844,0.83,0.813,22719,960
"10931",217156,1997,1,0,"BROWN UNIVERSITY",NA,NA,1368,722,646,1136,527,609,0.843,0.83,0.816,23287,866
"10932",217156,1998,1,0,"BROWN UNIVERSITY",NA,NA,1417,772,645,1180,520,660,0.855,0.833,0.806,23616,897
"10933",217156,1999,1,0,"BROWN UNIVERSITY",NA,NA,1376,729,647,1146,539,607,0.833,0.833,0.833,24624,685
"10934",217156,2000,1,0,"BROWN UNIVERSITY",NA,NA,1415,767,648,1177,530,647,0.843,0.832,0.818,25600,667
"10935",217156,2001,1,0,"BROWN UNIVERSITY",NA,NA,1375,760,615,1154,506,648,0.853,0.839,0.823,26568,655
"10936",217156,2002,1,0,"BROWN UNIVERSITY",NA,NA,1451,817,634,1213,505,708,0.867,0.836,0.797,27856,777
"10937",217156,2003,1,0,"BROWN UNIVERSITY",NA,NA,1392,736,656,1192,539,653,0.887,0.856,0.822,29200,719
"10938",217156,2004,1,0,"BROWN UNIVERSITY",NA,NA,1429,744,685,1224,580,644,0.866,0.857,0.847,30672,785
"10939",217156,2005,1,0,"Brown University",NA,NA,1439,735,704,1197,577,620,0.843,0.832,0.82,32264,742
"10940",217156,2006,1,0,"Brown University",NA,NA,1464,740,724,1215,590,625,0.845,0.83,0.815,33888,717
"10941",217156,2007,1,0,"Brown University",NA,NA,1477,814,663,1246,548,698,0.858,0.844,0.827,35584,687
"10942",217156,2008,1,0,"Brown University",NA,NA,1546,813,733,1307,612,695,0.855,0.845,0.835,36928,694
"10943",217156,2009,1,0,"Brown University",NA,NA,1490,770,720,1238,598,640,0.831,0.831,0.831,38048,728
"10944",217156,2010,1,0,"Brown University",NA,NA,1495,784,711,1251,599,652,0.832,0.837,0.842,39928,683
"10945",217402,1991,1,0,"PROVIDENCE COLLEGE",NA,NA,963,529,434,764,330,434,0.82,0.793,0.76,11840,884
"10946",217402,1992,1,0,"PROVIDENCE COLLEGE",NA,NA,931,523,408,734,322,412,0.788,0.788,0.789,12700,837
"10947",217402,1993,1,0,"PROVIDENCE COLLEGE",NA,NA,968,503,465,775,368,407,0.809,0.801,0.791,13625,867
"10948",217402,1995,1,0,"PROVIDENCE COLLEGE",NA,NA,954,589,365,795,297,498,0.846,0.833,0.814,15380,851
"10949",217402,1996,1,0,"PROVIDENCE COLLEGE",NA,NA,938,556,382,786,310,476,0.856,0.838,0.812,15930,826
"10950",217402,1997,1,0,"PROVIDENCE COLLEGE",NA,NA,974,563,411,801,326,475,0.844,0.822,0.793,16480,869
"10951",217402,1998,1,0,"PROVIDENCE COLLEGE",NA,NA,994,599,395,813,323,490,0.818,0.818,0.818,17285,895
"10952",217402,1999,1,0,"PROVIDENCE COLLEGE",NA,NA,973,556,417,838,351,487,0.876,0.861,0.842,17640,860
"10953",217402,2000,1,0,"PROVIDENCE COLLEGE",NA,NA,930,527,403,775,328,447,0.848,0.833,0.814,18440,816
"10954",217402,2001,1,0,"PROVIDENCE COLLEGE",NA,NA,933,531,402,795,334,461,0.868,0.852,0.831,19375,809
"10955",217402,2002,1,0,"PROVIDENCE COLLEGE",NA,NA,877,540,337,734,274,460,0.852,0.837,0.813,20440,711
"10956",217402,2003,1,0,"PROVIDENCE COLLEGE",NA,NA,975,561,414,823,339,484,0.863,0.844,0.819,21665,821
"10957",217402,2004,1,0,"PROVIDENCE COLLEGE",NA,NA,1036,549,487,859,406,453,0.825,0.829,0.834,23180,865
"10958",217402,2005,1,0,"Providence College",NA,NA,1064,593,471,857,367,490,0.826,0.805,0.779,24800,895
"10959",217402,2006,1,0,"Providence College",NA,NA,1023,585,438,860,351,509,0.87,0.841,0.801,26780,848
"10960",217402,2007,1,0,"Providence College",NA,NA,989,559,430,820,361,459,0.821,0.829,0.84,28920,788
"10961",217402,2008,1,0,"Providence College",NA,NA,987,575,412,821,336,485,0.843,0.832,0.816,30800,709
"10962",217402,2009,1,0,"Providence College",NA,NA,952,549,403,772,324,448,0.816,0.811,0.804,32320,649
"10963",217402,2010,1,0,"Providence College",NA,NA,1102,633,469,888,383,505,0.798,0.806,0.817,38610,839
"10964",217536,1991,1,0,"SALVE REGINA UNIVERSITY",NA,NA,400,281,119,196,49,147,0.523,0.49,0.412,11930,379
"10965",217536,1992,1,0,"SALVE REGINA UNIVERSITY",NA,NA,381,264,117,208,58,150,0.568,0.546,0.496,13000,360
"10966",217536,1993,1,0,"SALVE REGINA UNIVERSITY",NA,NA,345,235,110,181,57,124,0.528,0.525,0.518,14200,328
"10967",217536,1995,1,0,"SALVE REGINA UNIVERSITY",NA,NA,354,258,96,190,49,141,0.546,0.537,0.51,14650,286
"10968",217536,1996,1,0,"SALVE REGINA UNIVERSITY",NA,NA,393,271,122,209,61,148,0.546,0.532,0.5,15190,372
"10969",217536,1997,1,0,"SALVE REGINA UNIVERSITY",NA,NA,479,318,161,219,55,164,0.516,0.457,0.342,15650,442
"10970",217536,1998,1,0,"SALVE REGINA UNIVERSITY",NA,NA,443,296,147,241,69,172,0.581,0.544,0.469,16300,411
"10971",217536,1999,1,0,"SALVE REGINA UNIVERSITY",NA,NA,528,352,176,277,69,208,0.591,0.525,0.392,16500,487
"10972",217536,2000,1,0,"SALVE REGINA UNIVERSITY",NA,NA,510,383,127,273,63,210,0.548,0.535,0.496,17200,474
"10973",217536,2001,1,0,"SALVE REGINA UNIVERSITY",NA,NA,551,396,155,321,78,243,0.614,0.583,0.503,17950,498
"10974",217536,2002,1,0,"SALVE REGINA UNIVERSITY",NA,NA,523,378,145,334,93,241,0.638,0.639,0.641,19000,470
"10975",217536,2003,1,0,"SALVE REGINA UNIVERSITY",NA,NA,571,401,170,361,91,270,0.673,0.632,0.535,20100,492
"10976",217536,2004,1,0,"SALVE REGINA UNIVERSITY",NA,NA,558,397,161,358,99,259,0.652,0.642,0.615,21750,472
"10977",217536,2005,1,0,"Salve Regina University",NA,NA,562,418,144,382,82,300,0.718,0.68,0.569,23500,468
"10978",217536,2006,1,0,"Salve Regina University",NA,NA,568,394,174,390,113,277,0.703,0.687,0.649,24975,475
"10979",217536,2007,1,0,"Salve Regina University",NA,NA,556,353,203,338,117,221,0.626,0.608,0.576,26750,461
"10980",217536,2008,1,0,"Salve Regina University",NA,NA,556,382,174,355,94,261,0.683,0.638,0.54,28950,423
"10981",217536,2009,1,0,"Salve Regina University",NA,NA,501,346,155,343,98,245,0.708,0.685,0.632,29800,375
"10982",217536,2010,1,0,"Salve Regina University",NA,NA,592,423,169,380,96,284,0.671,0.642,0.568,31250,473
"10983",217776,1991,1,0,"CENTRAL WESLEYAN COLLEGE",NA,NA,78,41,37,16,6,10,0.244,0.205,0.162,7090,70
"10984",217776,1992,1,0,"CENTRAL WESLEYAN COLLEGE",NA,NA,88,54,34,26,6,20,0.37,0.295,0.176,7500,80
"10985",217776,1993,1,0,"CENTRAL WESLEYAN COLLEGE",NA,NA,90,48,42,23,8,15,0.312,0.256,0.19,8100,79
"10986",217776,1995,1,0,"SOUTHERN WESLEYAN UNIVERSITY",NA,NA,69,32,37,11,3,8,0.25,0.159,0.081,9081,58
"10987",217776,1996,1,0,"SOUTHERN WESLEYAN UNIVERSITY",NA,NA,73,36,37,19,8,11,0.306,0.26,0.216,9616,64
"10988",217776,1997,1,0,"SOUTHERN WESLEYAN UNIVERSITY",NA,NA,101,51,50,27,9,18,0.353,0.267,0.18,10180,86
"10989",217776,1998,1,0,"SOUTHERN WESLEYAN UNIVERSITY",NA,NA,91,51,40,25,11,14,0.274,0.275,0.275,10840,84
"10990",217776,1999,1,0,"SOUTHERN WESLEYAN UNIVERSITY",NA,NA,99,47,52,35,12,23,0.489,0.354,0.231,11148,91
"10991",217776,2000,1,0,"SOUTHERN WESLEYAN UNIVERSITY",NA,NA,92,51,41,33,12,21,0.412,0.359,0.293,11704,81
"10992",217776,2001,1,0,"SOUTHERN WESLEYAN UNIVERSITY",NA,NA,139,78,61,46,18,28,0.359,0.331,0.295,12400,103
"10993",217776,2002,1,0,"SOUTHERN WESLEYAN UNIVERSITY",NA,NA,141,76,65,36,11,25,0.329,0.255,0.169,13000,105
"10994",217776,2003,1,0,"SOUTHERN WESLEYAN UNIVERSITY",NA,NA,160,100,60,41,17,24,0.24,0.256,0.283,13650,129
"10995",217776,2004,1,0,"SOUTHERN WESLEYAN UNIVERSITY",NA,NA,161,98,63,40,15,25,0.255,0.248,0.238,14300,122
"10996",217776,2005,1,0,"Southern Wesleyan University",NA,NA,176,110,66,46,18,28,0.254,0.261,0.273,15000,127
"10997",217776,2006,1,0,"Southern Wesleyan University",NA,NA,150,86,64,61,28,33,0.384,0.407,0.438,15700,123
"10998",217776,2007,1,0,"Southern Wesleyan University",NA,NA,183,114,69,49,20,29,0.254,0.268,0.29,16700,135
"10999",217776,2008,1,0,"Southern Wesleyan University",NA,NA,142,84,58,52,13,39,0.464,0.366,0.224,17500,114
"11000",217776,2009,1,0,"Southern Wesleyan University",NA,NA,168,100,68,67,26,41,0.41,0.399,0.382,18200,133
"11001",217776,2010,1,0,"Southern Wesleyan University",NA,NA,153,80,73,77,40,37,0.462,0.503,0.548,19000,119
"11002",217819,1991,1,0,"COLLEGE OF CHARLESTON",NA,NA,1434,943,491,483,104,379,0.402,0.337,0.212,2400,1277
"11003",217819,1992,1,0,"COLLEGE OF CHARLESTON",NA,NA,1296,853,443,426,100,326,0.382,0.329,0.226,2650,1171
"11004",217819,1993,1,0,"COLLEGE OF CHARLESTON",NA,NA,1519,1004,515,485,123,362,0.361,0.319,0.239,2950,1353
"11005",217819,1995,1,0,"COLLEGE OF CHARLESTON",NA,NA,1748,1190,558,596,136,460,0.387,0.341,0.244,3090,1542
"11006",217819,1996,1,0,"COLLEGE OF CHARLESTON",NA,NA,1867,1236,631,624,149,475,0.384,0.334,0.236,3190,1641
"11007",217819,1997,1,0,"COLLEGE OF CHARLESTON",NA,NA,1568,1031,537,565,130,435,0.422,0.36,0.242,3290,1385
"11008",217819,1998,1,0,"COLLEGE OF CHARLESTON",NA,NA,1937,1248,689,712,179,533,0.427,0.368,0.26,3390,1699
"11009",217819,1999,1,0,"COLLEGE OF CHARLESTON",NA,NA,2067,1399,668,850,206,644,0.46,0.411,0.308,206,1784
"11010",217819,2000,1,0,"COLLEGE OF CHARLESTON",NA,NA,1985,1337,648,835,215,620,0.464,0.421,0.332,276,1704
"11011",217819,2001,1,0,"COLLEGE OF CHARLESTON",NA,NA,1967,1295,672,868,248,620,0.479,0.441,0.369,276,1631
"11012",217819,2002,1,0,"COLLEGE OF CHARLESTON",NA,NA,1991,1333,658,941,253,688,0.516,0.473,0.384,386,1693
"11013",217819,2003,1,0,"COLLEGE OF CHARLESTON",NA,NA,1868,1229,639,896,251,645,0.525,0.48,0.393,386,1602
"11014",217819,2004,1,0,"COLLEGE OF CHARLESTON",NA,NA,1940,1323,617,1039,268,771,0.583,0.536,0.434,456,1664
"11015",217819,2005,1,0,"College of Charleston",NA,NA,1984,1342,642,1031,291,740,0.551,0.52,0.453,70,1650
"11016",217819,2006,1,0,"College of Charleston",NA,NA,1959,1332,627,1132,315,817,0.613,0.578,0.502,70,1671
"11017",217819,2007,1,0,"College of Charleston",NA,NA,2061,1352,709,1071,302,769,0.569,0.52,0.426,70,1722
"11018",217819,2008,1,0,"College of Charleston",NA,NA,1949,1296,653,1070,318,752,0.58,0.549,0.487,70,1663
"11019",217819,2009,1,0,"College of Charleston",NA,NA,2136,1497,639,1203,320,883,0.59,0.563,0.501,70,1769
"11020",217819,2010,1,0,"College of Charleston",NA,NA,2001,1329,672,1162,325,837,0.63,0.581,0.484,70,1699
"11021",217882,1991,1,0,"CLEMSON UNIVERSITY",NA,NA,2474,1120,1354,871,321,550,0.491,0.352,0.237,2630,2151
"11022",217882,1992,1,0,"CLEMSON UNIVERSITY",NA,NA,2484,1179,1305,910,330,580,0.492,0.366,0.253,2762,2186
"11023",217882,1993,1,0,"CLEMSON UNIVERSITY",NA,NA,2300,1053,1247,872,323,549,0.521,0.379,0.259,2954,2015
"11024",217882,1995,1,0,"CLEMSON UNIVERSITY",NA,NA,2556,1255,1301,905,319,586,0.467,0.354,0.245,3112,2259
"11025",217882,1996,1,0,"CLEMSON UNIVERSITY",NA,NA,2538,1234,1304,945,327,618,0.501,0.372,0.251,3112,2288
"11026",217882,1997,1,0,"CLEMSON UNIVERSITY",NA,NA,2579,1265,1314,997,341,656,0.519,0.387,0.26,3252,2285
"11027",217882,1998,1,0,"CLEMSON UNIVERSITY",NA,NA,2699,1273,1426,1091,396,695,0.546,0.404,0.278,3344,2408
"11028",217882,1999,1,0,"CLEMSON UNIVERSITY",NA,NA,2886,1354,1532,1267,490,777,0.574,0.439,0.32,2835,2566
"11029",217882,2000,1,0,"CLEMSON UNIVERSITY",NA,NA,3028,1451,1577,1333,496,837,0.577,0.44,0.315,3590,2690
"11030",217882,2001,1,0,"CLEMSON UNIVERSITY",NA,NA,2530,1184,1346,1166,443,723,0.611,0.461,0.329,5090,2069
"11031",217882,2002,1,0,"CLEMSON UNIVERSITY",NA,NA,2463,1214,1249,1231,462,769,0.633,0.5,0.37,5834,2072
"11032",217882,2003,1,0,"CLEMSON UNIVERSITY",NA,NA,2748,1293,1455,1379,535,844,0.653,0.502,0.368,6934,2205
"11033",217882,2004,1,0,"CLEMSON UNIVERSITY",NA,NA,2994,1369,1625,1488,597,891,0.651,0.497,0.367,7840,2461
"11034",217882,2005,1,0,"Clemson University",NA,NA,2893,1426,1467,1565,611,954,0.669,0.541,0.416,8816,2420
"11035",217882,2006,1,0,"Clemson University",NA,NA,2755,1363,1392,1575,604,971,0.712,0.572,0.434,9056,2269
"11036",217882,2007,1,0,"Clemson University",NA,NA,2702,1304,1398,1598,677,921,0.706,0.591,0.484,9344,2232
"11037",217882,2008,1,0,"Clemson University",NA,NA,2866,1412,1454,1747,737,1010,0.715,0.61,0.507,9886,2356
"11038",217882,2009,1,0,"Clemson University",NA,NA,3336,1564,1772,1926,853,1073,0.686,0.577,0.481,10298,2847
"11039",217882,2010,1,0,"Clemson University",NA,NA,2977,1498,1479,1755,707,1048,0.7,0.59,0.478,11128,2570
"11040",217998,1991,1,0,"ERSKINE COLLEGE AND SEMINARY",NA,NA,101,64,37,66,21,45,0.703,0.653,0.568,9565,97
"11041",217998,1992,1,0,"ERSKINE COLLEGE AND SEMINARY",NA,NA,185,98,87,110,52,58,0.592,0.595,0.598,10125,173
"11042",217998,1993,1,0,"ERSKINE COLLEGE AND SEMINARY",NA,NA,177,108,69,113,36,77,0.713,0.638,0.522,10630,170
"11043",217998,1995,1,0,"ERSKINE COLLEGE AND SEMINARY",NA,NA,143,77,66,93,42,51,0.662,0.65,0.636,11823,140
"11044",217998,1996,1,0,"ERSKINE COLLEGE AND SEMINARY",NA,NA,134,82,52,89,34,55,0.671,0.664,0.654,13087,128
"11045",217998,1997,1,0,"ERSKINE COLLEGE AND SEMINARY",NA,NA,132,78,54,85,31,54,0.692,0.644,0.574,13902,118
"11046",217998,1998,1,0,"ERSKINE COLLEGE AND SEMINARY",NA,NA,136,84,52,89,28,61,0.726,0.654,0.538,14893,122
"11047",217998,1999,1,0,"ERSKINE COLLEGE AND SEMINARY",NA,NA,156,91,65,100,33,67,0.736,0.641,0.508,14269,144
"11048",217998,2000,1,0,"ERSKINE COLLEGE AND SEMINARY",NA,NA,138,79,59,89,31,58,0.734,0.645,0.525,14697,122
"11049",217998,2001,1,0,"ERSKINE COLLEGE AND SEMINARY",NA,NA,217,127,90,125,44,81,0.638,0.576,0.489,15138,197
"11050",217998,2002,1,0,"ERSKINE COLLEGE AND SEMINARY",NA,NA,165,100,65,87,25,62,0.62,0.527,0.385,15700,152
"11051",217998,2003,1,0,"ERSKINE COLLEGE AND SEMINARY",NA,NA,176,102,74,111,43,68,0.667,0.631,0.581,16312,154
"11052",217998,2004,1,0,"ERSKINE COLLEGE AND SEMINARY",NA,NA,179,106,73,97,39,58,0.547,0.542,0.534,16948,160
"11053",217998,2005,1,0,"Erskine College and Seminary",NA,NA,181,90,91,82,33,49,0.544,0.453,0.363,17700,160
"11054",217998,2006,1,0,"Erskine College and Seminary",NA,NA,178,100,78,101,34,67,0.67,0.567,0.436,18840,150
"11055",217998,2007,1,0,"Erskine College and Seminary",NA,NA,163,94,69,84,30,54,0.575,0.515,0.435,20185,145
"11056",217998,2008,1,0,"Erskine College and Seminary",NA,NA,163,83,80,72,32,40,0.482,0.442,0.4,21590,106
"11057",217998,2009,1,0,"Erskine College and Seminary",NA,NA,182,99,83,102,45,57,0.576,0.56,0.542,23000,152
"11058",217998,2010,1,0,"Erskine College and Seminary",NA,NA,144,81,63,85,34,51,0.63,0.59,0.54,24750,117
"11059",218061,1991,1,0,"FRANCIS MARION COLLEGE",NA,NA,735,388,347,79,23,56,0.144,0.107,0.066,2140,587
"11060",218061,1992,1,0,"FRANCIS MARION UNIVERSITY",NA,NA,875,487,388,110,42,68,0.14,0.126,0.108,2440,666
"11061",218061,1993,1,0,"FRANCIS MARION UNIVERSITY",NA,NA,807,435,372,130,40,90,0.207,0.161,0.108,2800,583
"11062",218061,1995,1,0,"FRANCIS MARION UNIVERSITY",NA,NA,757,405,352,140,43,97,0.24,0.185,0.122,3010,550
"11063",218061,1996,1,0,"FRANCIS MARION UNIVERSITY",NA,NA,636,365,271,119,39,80,0.219,0.187,0.144,3100,442
"11064",218061,1997,1,0,"FRANCIS MARION UNIVERSITY",NA,NA,582,336,246,99,34,65,0.194,0.17,0.138,3390,425
"11065",218061,1998,1,0,"FRANCIS MARION UNIVERSITY",NA,NA,649,372,277,188,57,131,0.352,0.29,0.206,3350,413
"11066",218061,1999,1,0,"FRANCIS MARION UNIVERSITY",NA,NA,570,332,238,104,27,77,0.232,0.182,0.113,3260,371
"11067",218061,2000,1,0,"FRANCIS MARION UNIVERSITY",NA,NA,602,356,246,95,33,62,0.174,0.158,0.134,3410,412
"11068",218061,2001,1,0,"FRANCIS MARION UNIVERSITY",NA,NA,634,377,257,127,41,86,0.228,0.2,0.16,3620,403
"11069",218061,2002,1,0,"FRANCIS MARION UNIVERSITY",NA,NA,734,431,303,142,48,94,0.218,0.193,0.158,4190,463
"11070",218061,2003,1,0,"FRANCIS MARION UNIVERSITY",NA,NA,765,447,318,153,48,105,0.235,0.2,0.151,4947,445
"11071",218061,2004,1,0,"FRANCIS MARION UNIVERSITY",NA,NA,745,463,282,139,34,105,0.227,0.187,0.121,5405,395
"11072",218061,2005,1,0,"Francis Marion University",NA,NA,797,517,280,158,40,118,0.228,0.198,0.143,5849,416
"11073",218061,2006,1,0,"Francis Marion University",NA,NA,795,519,276,142,34,108,0.208,0.179,0.123,6327,422
"11074",218061,2007,1,0,"Francis Marion University",NA,NA,776,493,283,127,47,80,0.162,0.164,0.166,6803,419
"11075",218061,2008,1,0,"Francis Marion University",NA,NA,676,452,224,104,34,70,0.155,0.154,0.152,7347,289
"11076",218061,2009,1,0,"Francis Marion University",NA,NA,791,533,258,142,44,98,0.184,0.18,0.171,7625,355
"11077",218061,2010,1,0,"Francis Marion University",NA,NA,737,479,258,130,40,90,0.188,0.176,0.155,8145,352
"11078",218229,1991,1,0,"LANDER COLLEGE",NA,NA,421,286,135,83,18,65,0.227,0.197,0.133,2620,343
"11079",218229,1992,1,0,"LANDER COLLEGE",NA,NA,402,273,129,65,16,49,0.18,0.162,0.124,2920,332
"11080",218229,1993,1,0,"LANDER UNIVERSITY",NA,NA,491,327,164,80,21,59,0.18,0.163,0.128,3220,398
"11081",218229,1995,1,0,"LANDER UNIVERSITY",NA,NA,477,301,176,155,46,109,0.362,0.325,0.261,3400,389
"11082",218229,1996,1,0,"LANDER UNIVERSITY",NA,NA,437,273,164,134,40,94,0.344,0.307,0.244,3550,342
"11083",218229,1997,1,0,"LANDER UNIVERSITY",NA,NA,434,288,146,94,23,71,0.246,0.217,0.158,5328,353
"11084",218229,1998,1,0,"LANDER UNIVERSITY",NA,NA,488,322,166,92,19,73,0.227,0.189,0.114,5476,396
"11085",218229,1999,1,0,"LANDER UNIVERSITY",NA,NA,494,313,181,107,22,85,0.272,0.217,0.122,5548,417
"11086",218229,2000,1,0,"LANDER UNIVERSITY",NA,NA,509,321,188,88,23,65,0.202,0.173,0.122,5832,414
"11087",218229,2001,1,0,"LANDER UNIVERSITY",NA,NA,488,291,197,118,25,93,0.32,0.242,0.127,4152,401
"11088",218229,2002,1,0,"LANDER UNIVERSITY",NA,NA,526,335,191,117,25,92,0.275,0.222,0.131,4704,439
"11089",218229,2003,1,0,"LANDER UNIVERSITY",NA,NA,541,356,185,139,30,109,0.306,0.257,0.162,5400,439
"11090",218229,2004,1,0,"LANDER UNIVERSITY",NA,NA,647,440,207,140,32,108,0.246,0.216,0.155,5856,471
"11091",218229,2005,1,0,"Lander University",NA,NA,555,369,186,110,34,76,0.206,0.198,0.183,6588,377
"11092",218229,2006,1,0,"Lander University",NA,NA,578,379,199,127,29,98,0.259,0.22,0.146,6602,395
"11093",218229,2007,1,0,"Lander University",NA,NA,433,296,137,139,35,104,0.351,0.321,0.255,7098,315
"11094",218229,2008,1,0,"Lander University",NA,NA,554,398,156,162,39,123,0.309,0.292,0.25,8380,344
"11095",218229,2009,1,0,"Lander University",NA,NA,581,405,176,160,46,114,0.281,0.275,0.261,7980,383
"11096",218229,2010,1,0,"Lander University",NA,NA,685,476,209,195,44,151,0.317,0.285,0.211,8374,447
"11097",218238,1991,1,0,"LIMESTONE COLLEGE",NA,NA,232,126,106,17,5,12,0.095,0.073,0.047,6464,118
"11098",218238,1992,1,0,"LIMESTONE COLLEGE",NA,NA,115,48,67,9,4,5,0.104,0.078,0.06,6878,80
"11099",218238,1993,1,0,"LIMESTONE COLLEGE",NA,NA,214,88,126,43,22,21,0.239,0.201,0.175,7200,143
"11100",218238,1995,1,0,"LIMESTONE COLLEGE",NA,NA,164,82,82,40,18,22,0.268,0.244,0.22,8000,127
"11101",218238,1996,1,0,"LIMESTONE COLLEGE",NA,NA,87,38,49,16,5,11,0.29,0.184,0.102,8200,73
"11102",218238,1997,1,0,"LIMESTONE COLLEGE",NA,NA,193,92,101,4,3,1,0.011,0.021,0.03,8600,141
"11103",218238,1998,1,0,"LIMESTONE COLLEGE",NA,NA,112,58,54,26,8,18,0.31,0.232,0.148,9100,80
"11104",218238,1999,1,0,"LIMESTONE COLLEGE",NA,NA,136,58,78,27,13,14,0.241,0.199,0.167,9500,105
"11105",218238,2000,1,0,"LIMESTONE COLLEGE",NA,NA,103,49,54,23,6,17,0.347,0.223,0.111,10100,80
"11106",218238,2001,1,0,"LIMESTONE COLLEGE",NA,NA,136,69,67,31,11,20,0.29,0.228,0.164,10800,107
"11107",218238,2002,1,0,"LIMESTONE COLLEGE",NA,NA,180,83,97,26,12,14,0.169,0.144,0.124,11500,136
"11108",218238,2003,1,0,"LIMESTONE COLLEGE",NA,NA,176,98,78,35,15,20,0.204,0.199,0.192,12300,112
"11109",218238,2004,1,0,"LIMESTONE COLLEGE",NA,NA,203,95,108,41,15,26,0.274,0.202,0.139,13200,146
"11110",218238,2005,1,0,"Limestone College",NA,NA,201,99,102,40,10,30,0.303,0.199,0.098,14040,137
"11111",218238,2006,1,0,"Limestone College",NA,NA,206,87,119,39,17,22,0.253,0.189,0.143,15000,145
"11112",218238,2007,1,0,"Limestone College",NA,NA,225,92,133,42,18,24,0.261,0.187,0.135,15900,163
"11113",218238,2008,1,0,"Limestone College",NA,NA,229,98,131,29,8,21,0.214,0.127,0.061,17300,145
"11114",218238,2009,1,0,"Limestone College",NA,NA,288,133,155,63,22,41,0.308,0.219,0.142,18300,179
"11115",218238,2010,1,0,"Limestone College",NA,NA,275,129,146,52,19,33,0.256,0.189,0.13,19200,165
"11116",218399,1991,1,0,"MORRIS COLLEGE",NA,NA,196,135,61,38,6,32,0.237,0.194,0.098,3939,0
"11117",218399,1992,1,0,"MORRIS COLLEGE",NA,NA,293,177,116,40,16,24,0.136,0.137,0.138,4136,0
"11118",218399,1993,1,0,"MORRIS COLLEGE",NA,NA,327,213,114,33,10,23,0.108,0.101,0.088,4290,1
"11119",218399,1995,1,0,"MORRIS COLLEGE",NA,NA,241,167,74,35,8,27,0.162,0.145,0.108,4867,0
"11120",218399,1996,1,0,"MORRIS COLLEGE",NA,NA,246,145,101,45,11,34,0.234,0.183,0.109,5105,0
"11121",218399,1997,1,0,"MORRIS COLLEGE",NA,NA,262,180,82,68,15,53,0.294,0.26,0.183,5240,0
"11122",218399,1998,1,0,"MORRIS COLLEGE",NA,NA,204,123,81,37,10,27,0.22,0.181,0.123,5515,0
"11123",218399,1999,1,0,"MORRIS COLLEGE",NA,NA,263,173,90,53,10,43,0.249,0.202,0.111,5640,0
"11124",218399,2000,1,0,"MORRIS COLLEGE",NA,NA,265,167,98,48,14,34,0.204,0.181,0.143,5894,0
"11125",218399,2001,1,0,"MORRIS COLLEGE",NA,NA,268,167,101,56,13,43,0.258,0.209,0.129,6483,0
"11126",218399,2002,1,0,"MORRIS COLLEGE",NA,NA,289,175,114,51,11,40,0.229,0.176,0.096,6783,0
"11127",218399,2003,1,0,"MORRIS COLLEGE",NA,NA,276,168,108,46,9,37,0.22,0.167,0.083,7190,0
"11128",218399,2004,1,0,"MORRIS COLLEGE",NA,NA,232,141,91,19,3,16,0.114,0.082,0.033,7550,0
"11129",218399,2005,1,0,"Morris College",NA,NA,207,130,77,30,9,21,0.161,0.145,0.117,7828,0
"11130",218399,2006,1,0,"Morris College",NA,NA,249,144,105,39,11,28,0.194,0.157,0.105,8562,0
"11131",218399,2007,1,0,"Morris College",NA,NA,295,152,143,40,14,26,0.171,0.136,0.098,8990,0
"11132",218399,2008,1,0,"Morris College",NA,NA,292,162,130,37,6,31,0.191,0.127,0.046,9621,1
"11133",218399,2009,1,0,"Morris College",NA,NA,300,166,134,37,9,28,0.169,0.123,0.067,9630,0
"11134",218399,2010,1,0,"Morris College",NA,NA,319,173,146,19,6,13,0.075,0.06,0.041,10015,0
"11135",218414,1991,1,0,"NEWBERRY COLLEGE",NA,NA,189,77,112,45,21,24,0.312,0.238,0.188,7400,143
"11136",218414,1992,1,0,"NEWBERRY COLLEGE",NA,NA,177,82,95,36,16,20,0.244,0.203,0.168,7900,136
"11137",218414,1993,1,0,"NEWBERRY COLLEGE",NA,NA,155,62,93,44,24,20,0.323,0.284,0.258,8594,110
"11138",218414,1995,1,0,"NEWBERRY COLLEGE",NA,NA,166,70,96,50,19,31,0.443,0.301,0.198,10950,125
"11139",218414,1996,1,0,"NEWBERRY COLLEGE",NA,NA,234,103,131,91,36,55,0.534,0.389,0.275,11510,197
"11140",218414,1997,1,0,"NEWBERRY COLLEGE",NA,NA,161,52,109,41,22,19,0.365,0.255,0.202,12322,130
"11141",218414,1998,1,0,"NEWBERRY COLLEGE",NA,NA,206,92,114,74,27,47,0.511,0.359,0.237,13062,157
"11142",218414,1999,1,0,"NEWBERRY COLLEGE",NA,NA,179,70,109,59,18,41,0.586,0.33,0.165,13602,139
"11143",218414,2000,1,0,"NEWBERRY COLLEGE",NA,NA,181,80,101,58,25,33,0.413,0.32,0.248,14282,131
"11144",218414,2001,1,0,"NEWBERRY COLLEGE",NA,NA,178,70,108,55,26,29,0.414,0.309,0.241,15000,129
"11145",218414,2002,1,0,"NEWBERRY COLLEGE",NA,NA,250,94,156,70,33,37,0.394,0.28,0.212,15800,168
"11146",218414,2003,1,0,"NEWBERRY COLLEGE",NA,NA,203,69,134,64,36,28,0.406,0.315,0.269,16640,145
"11147",218414,2004,1,0,"NEWBERRY COLLEGE",NA,NA,231,90,141,73,28,45,0.5,0.316,0.199,17470,152
"11148",218414,2005,1,0,"Newberry College",NA,NA,275,96,179,67,34,33,0.344,0.244,0.19,18170,178
"11149",218414,2006,1,0,"Newberry College",NA,NA,264,116,148,65,24,41,0.353,0.246,0.162,18900,173
"11150",218414,2007,1,0,"Newberry College",NA,NA,323,122,201,88,41,47,0.385,0.272,0.204,19900,227
"11151",218414,2008,1,0,"Newberry College",NA,NA,297,118,179,78,27,51,0.432,0.263,0.151,20500,211
"11152",218414,2009,1,0,"Newberry College",NA,NA,342,133,209,84,32,52,0.391,0.246,0.153,20500,221
"11153",218414,2010,1,0,"Newberry College",NA,NA,288,110,178,82,41,41,0.373,0.285,0.23,21500,203
"11154",218663,1991,1,0,"UNIVERSITY OF SOUTH CAROLINA AT COLUMBIA",NA,NA,2591,1398,1193,643,242,401,0.287,0.248,0.203,2686,1972
"11155",218663,1992,1,0,"UNIVERSITY OF SOUTH CAROLINA AT COLUMBIA",NA,NA,2460,1312,1148,643,257,386,0.294,0.261,0.224,2818,1768
"11156",218663,1993,1,0,"UNIVERSITY OF SOUTH CAROLINA AT COLUMBIA",NA,NA,2298,1269,1029,681,246,435,0.343,0.296,0.239,3090,1681
"11157",218663,1995,1,0,"UNIVERSITY OF SOUTH CAROLINA AT COLUMBIA",NA,NA,2593,1477,1116,799,282,517,0.35,0.308,0.253,3280,1945
"11158",218663,1996,1,0,"UNIVERSITY OF SOUTH CAROLINA AT COLUMBIA",NA,NA,2635,1518,1117,857,289,568,0.374,0.325,0.259,3432,1921
"11159",218663,1997,1,0,"UNIVERSITY OF SOUTH CAROLINA AT COLUMBIA",NA,NA,2919,1596,1323,1065,393,672,0.421,0.365,0.297,3534,2220
"11160",218663,1998,1,0,"UNIVERSITY OF SOUTH CAROLINA AT COLUMBIA",NA,NA,2756,1553,1203,1098,398,700,0.451,0.398,0.331,3630,2038
"11161",218663,1999,1,0,"UNIVERSITY OF SOUTH CAROLINA AT COLUMBIA",NA,NA,2596,1511,1085,1073,367,706,0.467,0.413,0.338,3640,1915
"11162",218663,2000,1,0,"UNIVERSITY OF SOUTH CAROLINA AT COLUMBIA",NA,NA,2475,1394,1081,988,351,637,0.457,0.399,0.325,3768,1852
"11163",218663,2001,1,0,"UNIVERSITY OF SOUTH CAROLINA AT COLUMBIA",NA,NA,3227,1770,1457,1304,461,843,0.476,0.404,0.316,3964,2415
"11164",218663,2002,1,0,"UNIVERSITY OF SOUTH CAROLINA AT COLUMBIA",NA,NA,3500,1909,1591,1557,594,963,0.505,0.445,0.373,4784,2632
"11165",218663,2003,1,0,"UNIVERSITY OF SOUTH CAROLINA-COLUMBIA",NA,NA,3441,1949,1492,1578,586,992,0.509,0.459,0.393,5548,2580
"11166",218663,2004,1,0,"UNIVERSITY OF SOUTH CAROLINA-COLUMBIA",NA,NA,3330,1841,1489,1524,593,931,0.506,0.458,0.398,6156,2319
"11167",218663,2005,1,0,"University of South Carolina-Columbia",NA,NA,3677,2087,1590,1881,682,1199,0.575,0.512,0.429,6914,2769
"11168",218663,2006,1,0,"University of South Carolina-Columbia",NA,NA,3646,2084,1562,1932,702,1230,0.59,0.53,0.449,7408,2717
"11169",218663,2007,1,0,"University of South Carolina-Columbia",NA,NA,3690,2117,1573,1999,734,1265,0.598,0.542,0.467,7946,2995
"11170",218663,2008,1,0,"University of South Carolina-Columbia",NA,NA,3826,2133,1693,2129,812,1317,0.617,0.556,0.48,8438,2983
"11171",218663,2009,1,0,"University of South Carolina-Columbia",NA,NA,3881,2089,1792,2132,825,1307,0.626,0.549,0.46,8756,3232
"11172",218663,2010,1,0,"University of South Carolina-Columbia",NA,NA,4421,2431,1990,2400,911,1489,0.613,0.543,0.458,9386,3663
"11173",218724,1991,1,0,"UNIVERSITY OF SOUTH CAROLINA AT COASTAL CAROLINA",NA,NA,584,328,256,84,26,58,0.177,0.144,0.102,2020,518
"11174",218724,1992,1,0,"UNIVERSITY OF SOUTH CAROLINA AT COASTAL CAROLINA",NA,NA,591,305,286,71,17,54,0.177,0.12,0.059,2170,506
"11175",218724,1993,1,0,"COASTAL CAROLINA UNIVERSITY",NA,NA,732,379,353,86,26,60,0.158,0.117,0.074,2470,635
"11176",218724,1995,1,0,"COASTAL CAROLINA UNIVERSITY",NA,NA,734,411,323,117,27,90,0.219,0.159,0.084,2800,648
"11177",218724,1996,1,0,"COASTAL CAROLINA UNIVERSITY",NA,NA,823,408,415,120,44,76,0.186,0.146,0.106,2910,713
"11178",218724,1997,1,0,"COASTAL CAROLINA UNIVERSITY",NA,NA,826,443,383,121,43,78,0.176,0.146,0.112,3030,725
"11179",218724,1998,1,0,"COASTAL CAROLINA UNIVERSITY",NA,NA,855,468,387,150,53,97,0.207,0.175,0.137,3150,757
"11180",218724,1999,1,0,"COASTAL CAROLINA UNIVERSITY",NA,NA,757,405,352,161,60,101,0.249,0.213,0.17,3270,674
"11181",218724,2000,1,0,"COASTAL CAROLINA UNIVERSITY",NA,NA,784,434,350,157,57,100,0.23,0.2,0.163,3420,687
"11182",218724,2001,1,0,"COASTAL CAROLINA UNIVERSITY",NA,NA,931,494,437,212,60,152,0.308,0.228,0.137,3690,842
"11183",218724,2002,1,0,"COASTAL CAROLINA UNIVERSITY",NA,NA,1072,523,549,236,104,132,0.252,0.22,0.189,4430,932
"11184",218724,2003,1,0,"COASTAL CAROLINA UNIVERSITY",NA,NA,1266,618,648,283,109,174,0.282,0.224,0.168,5270,1076
"11185",218724,2004,1,0,"COASTAL CAROLINA UNIVERSITY",NA,NA,1320,669,651,288,104,184,0.275,0.218,0.16,6100,1115
"11186",218724,2005,1,0,"Coastal Carolina University",NA,NA,1493,775,718,375,130,245,0.316,0.251,0.181,6780,1284
"11187",218724,2006,1,0,"Coastal Carolina University",NA,NA,1466,810,656,420,144,276,0.341,0.286,0.22,7420,1241
"11188",218724,2007,1,0,"Coastal Carolina University",NA,NA,1647,886,761,443,143,300,0.339,0.269,0.188,7520,1363
"11189",218724,2008,1,0,"Coastal Carolina University",NA,NA,1641,835,806,422,157,265,0.317,0.257,0.195,8570,1314
"11190",218724,2009,1,0,"Coastal Carolina University",NA,NA,1766,950,816,465,142,323,0.34,0.263,0.174,8870,1353
"11191",218724,2010,1,0,"Coastal Carolina University",NA,NA,1996,1087,909,530,181,349,0.321,0.266,0.199,9310,1437
"11192",218733,1991,1,0,"SOUTH CAROLINA STATE COLLEGE",NA,NA,888,486,402,85,17,68,0.14,0.096,0.042,2050,9
"11193",218733,1992,1,0,"SOUTH CAROLINA STATE UNIVERSITY",NA,NA,701,366,335,89,25,64,0.175,0.127,0.075,2200,3
"11194",218733,1993,1,0,"SOUTH CAROLINA STATE UNIVERSITY",NA,NA,613,329,284,80,20,60,0.182,0.131,0.07,2500,3
"11195",218733,1995,1,0,"SOUTH CAROLINA STATE UNIVERSITY",NA,NA,859,447,412,279,100,179,0.4,0.325,0.243,2550,10
"11196",218733,1996,1,0,"SOUTH CAROLINA STATE UNIVERSITY",NA,NA,801,452,349,159,24,135,0.299,0.199,0.069,2730,3
"11197",218733,1997,1,0,"SOUTH CAROLINA STATE UNIVERSITY",NA,NA,601,320,281,169,52,117,0.366,0.281,0.185,2974,3
"11198",218733,1998,1,0,"SOUTH CAROLINA STATE UNIVERSITY",NA,NA,739,428,311,186,50,136,0.318,0.252,0.161,3184,4
"11199",218733,1999,1,0,"SOUTH CAROLINA STATE UNIVERSITY",NA,NA,680,351,329,143,37,106,0.302,0.21,0.112,3410,7
"11200",218733,2000,1,0,"SOUTH CAROLINA STATE UNIVERSITY",NA,NA,571,307,264,170,48,122,0.397,0.298,0.182,3654,2
"11201",218733,2001,1,0,"SOUTH CAROLINA STATE UNIVERSITY",NA,NA,615,358,257,135,47,88,0.246,0.22,0.183,4096,2
"11202",218733,2002,1,0,"SOUTH CAROLINA STATE UNIVERSITY",NA,NA,717,401,316,174,45,129,0.322,0.243,0.142,2278,4
"11203",218733,2003,1,0,"SOUTH CAROLINA STATE UNIVERSITY",NA,NA,794,453,341,106,33,73,0.161,0.134,0.097,5570,8
"11204",218733,2004,1,0,"SOUTH CAROLINA STATE UNIVERSITY",NA,NA,945,523,422,164,41,123,0.235,0.174,0.097,6170,5
"11205",218733,2005,1,0,"South Carolina State University",NA,NA,1002,544,458,140,50,90,0.165,0.14,0.109,150,4
"11206",218733,2006,1,0,"South Carolina State University",NA,NA,870,458,412,134,49,85,0.186,0.154,0.119,514,8
"11207",218733,2007,1,0,"South Carolina State University",NA,NA,1292,652,640,177,59,118,0.181,0.137,0.092,550,10
"11208",218733,2008,1,0,"South Carolina State University",NA,NA,923,484,439,138,38,100,0.207,0.15,0.087,572,9
"11209",218733,2009,1,0,"South Carolina State University",NA,NA,713,358,355,106,37,69,0.193,0.149,0.104,624,14
"11210",218733,2010,1,0,"South Carolina State University",NA,NA,816,414,402,156,58,98,0.237,0.191,0.144,8328,10
"11211",218742,1991,1,0,"UNIVERSITY OF SOUTH CAROLINA AT SPARTANBURG",NA,NA,485,277,208,58,13,45,0.162,0.12,0.062,2020,416
"11212",218742,1992,1,0,"UNIVERSITY OF SOUTH CAROLINA AT SPARTANBURG",NA,NA,399,240,159,56,16,40,0.167,0.14,0.101,2120,332
"11213",218742,1993,1,0,"UNIVERSITY OF SOUTH CAROLINA AT SPARTANBURG",NA,NA,327,216,111,46,6,40,0.185,0.141,0.054,2320,258
"11214",218742,1995,1,0,"UNIVERSITY OF SOUTH CAROLINA AT SPARTANBURG",NA,NA,427,264,163,66,15,51,0.193,0.155,0.092,2578,338
"11215",218742,1996,1,0,"UNIVERSITY OF SOUTH CAROLINA AT SPARTANBURG",NA,NA,438,284,154,75,12,63,0.222,0.171,0.078,2808,327
"11216",218742,1997,1,0,"UNIVERSITY OF SOUTH CAROLINA AT SPARTANBURG",NA,NA,539,327,212,81,18,63,0.193,0.15,0.085,2974,390
"11217",218742,1998,1,0,"UNIVERSITY OF SOUTH CAROLINA AT SPARTANBURG",NA,NA,547,362,185,106,18,88,0.243,0.194,0.097,3118,369
"11218",218742,1999,1,0,"UNIVERSITY OF SOUTH CAROLINA AT SPARTANBURG",NA,NA,540,334,206,87,24,63,0.189,0.161,0.117,3250,355
"11219",218742,2000,1,0,"UNIVERSITY OF SOUTH CAROLINA AT SPARTANBURG",NA,NA,546,358,188,94,24,70,0.196,0.172,0.128,3494,348
"11220",218742,2001,1,0,"UNIVERSITY OF SOUTH CAROLINA AT SPARTANBURG",NA,NA,573,350,223,107,36,71,0.203,0.187,0.161,3738,334
"11221",218742,2002,1,0,"UNIVERSITY OF SOUTH CAROLINA AT SPARTANBURG",NA,NA,647,414,233,119,19,100,0.242,0.184,0.082,4598,410
"11222",218742,2003,1,0,"UNIVERSITY OF SOUTH CAROLINA-SPARTANBURG",NA,NA,684,450,234,139,35,104,0.231,0.203,0.15,5310,409
"11223",218742,2004,1,0,"UNIVERSITY OF SOUTH CAROLINA UPSTATE",NA,NA,643,398,245,145,51,94,0.236,0.226,0.208,5860,408
"11224",218742,2005,1,0,"University of South Carolina-Upstate",NA,NA,718,469,249,153,41,112,0.239,0.213,0.165,6436,382
"11225",218742,2006,1,0,"University of South Carolina-Upstate",NA,NA,781,497,284,166,42,124,0.25,0.213,0.148,6958,429
"11226",218742,2007,1,0,"University of South Carolina-Upstate",NA,NA,805,488,317,191,54,137,0.281,0.237,0.17,7480,458
"11227",218742,2008,1,0,"University of South Carolina-Upstate",NA,NA,708,455,253,164,47,117,0.257,0.232,0.186,8062,382
"11228",218742,2009,1,0,"University of South Carolina-Upstate",NA,NA,837,540,297,219,63,156,0.289,0.262,0.212,8362,474
"11229",218742,2010,1,0,"University of South Carolina-Upstate",NA,NA,838,559,279,200,54,146,0.261,0.239,0.194,8792,461
"11230",218973,1991,1,0,"WOFFORD COLLEGE",NA,NA,295,117,178,217,124,93,0.795,0.736,0.697,9790,264
"11231",218973,1992,1,0,"WOFFORD COLLEGE",NA,NA,287,132,155,206,113,93,0.705,0.718,0.729,10490,250
"11232",218973,1993,1,0,"WOFFORD COLLEGE",NA,NA,273,109,164,210,117,93,0.853,0.769,0.713,11480,248
"11233",218973,1995,1,0,"WOFFORD COLLEGE",NA,NA,286,140,146,219,99,120,0.857,0.766,0.678,13795,263
"11234",218973,1996,1,0,"WOFFORD COLLEGE",NA,NA,291,132,159,204,106,98,0.742,0.701,0.667,14675,266
"11235",218973,1997,1,0,"WOFFORD COLLEGE",NA,NA,296,139,157,210,102,108,0.777,0.709,0.65,15390,262
"11236",218973,1998,1,0,"WOFFORD COLLEGE",NA,NA,298,145,153,224,113,111,0.765,0.752,0.739,16170,263
"11237",218973,1999,1,0,"WOFFORD COLLEGE",NA,NA,307,154,153,226,112,114,0.74,0.736,0.732,16410,269
"11238",218973,2000,1,0,"WOFFORD COLLEGE",NA,NA,308,150,158,222,104,118,0.787,0.721,0.658,17030,280
"11239",218973,2001,1,0,"WOFFORD COLLEGE",NA,NA,303,152,151,218,100,118,0.776,0.719,0.662,17760,269
"11240",218973,2002,1,0,"WOFFORD COLLEGE",NA,NA,297,170,127,234,95,139,0.818,0.788,0.748,19415,267
"11241",218973,2003,1,0,"WOFFORD COLLEGE",NA,NA,330,163,167,255,127,128,0.785,0.773,0.76,20610,284
"11242",218973,2004,1,0,"WOFFORD COLLEGE",NA,NA,323,144,179,253,129,124,0.861,0.783,0.721,22300,293
"11243",218973,2005,1,0,"Wofford College",NA,NA,320,144,176,241,123,118,0.819,0.753,0.699,24130,280
"11244",218973,2006,1,0,"Wofford College",NA,NA,377,191,186,299,139,160,0.838,0.793,0.747,26110,329
"11245",218973,2007,1,0,"Wofford College",NA,NA,385,193,192,301,141,160,0.829,0.782,0.734,27830,324
"11246",218973,2008,1,0,"Wofford College",NA,NA,415,203,212,296,140,156,0.768,0.713,0.66,29465,364
"11247",218973,2009,1,0,"Wofford College",NA,NA,391,203,188,302,138,164,0.808,0.772,0.734,29240,318
"11248",218973,2010,1,0,"Wofford College",NA,NA,429,202,227,334,173,161,0.797,0.779,0.762,30630,357
"11249",219000,1991,1,0,"AUGUSTANA COLLEGE",NA,NA,323,221,102,151,41,110,0.498,0.467,0.402,9330,306
"11250",219000,1992,1,0,"AUGUSTANA COLLEGE",NA,NA,347,228,119,162,48,114,0.5,0.467,0.403,9800,334
"11251",219000,1993,1,0,"AUGUSTANA COLLEGE",NA,NA,306,208,98,128,25,103,0.495,0.418,0.255,10180,299
"11252",219000,1995,1,0,"AUGUSTANA COLLEGE",NA,NA,372,242,130,168,52,116,0.479,0.452,0.4,11780,363
"11253",219000,1996,1,0,"AUGUSTANA COLLEGE",NA,NA,383,244,139,190,55,135,0.553,0.496,0.396,12488,374
"11254",219000,1997,1,0,"AUGUSTANA COLLEGE",NA,NA,326,209,117,171,53,118,0.565,0.525,0.453,12968,318
"11255",219000,1998,1,0,"AUGUSTANA COLLEGE",NA,NA,403,257,146,213,61,152,0.591,0.529,0.418,13490,393
"11256",219000,1999,1,0,"AUGUSTANA COLLEGE",NA,NA,469,314,155,231,65,166,0.529,0.493,0.419,13960,463
"11257",219000,2000,1,0,"AUGUSTANA COLLEGE",NA,NA,460,286,174,222,76,146,0.51,0.483,0.437,14592,453
"11258",219000,2001,1,0,"AUGUSTANA COLLEGE",NA,NA,416,276,140,214,58,156,0.565,0.514,0.414,15280,404
"11259",219000,2002,1,0,"AUGUSTANA COLLEGE",NA,NA,416,259,157,208,74,134,0.517,0.5,0.471,15892,405
"11260",219000,2003,1,0,"AUGUSTANA COLLEGE",NA,NA,424,281,143,217,61,156,0.555,0.512,0.427,16766,409
"11261",219000,2004,1,0,"AUGUSTANA COLLEGE",NA,NA,392,231,161,197,70,127,0.55,0.503,0.435,17764,377
"11262",219000,2005,1,0,"Augustana College",NA,NA,390,256,134,192,54,138,0.539,0.492,0.403,18634,371
"11263",219000,2006,1,0,"Augustana College",NA,NA,442,282,160,228,64,164,0.582,0.516,0.4,19750,420
"11264",219000,2007,1,0,"Augustana College",NA,NA,429,272,157,207,54,153,0.562,0.483,0.344,20932,397
"11265",219000,2008,1,0,"Augustana College",NA,NA,426,292,134,211,50,161,0.551,0.495,0.373,22188,396
"11266",219000,2009,1,0,"Augustana College",NA,NA,431,261,170,245,80,165,0.632,0.568,0.471,23276,404
"11267",219000,2010,1,0,"Augustana College",NA,NA,418,276,142,226,55,171,0.62,0.541,0.387,24790,371
"11268",219046,1991,1,0,"BLACK HILLS STATE UNIVERSITY",NA,NA,492,285,207,23,5,18,0.063,0.047,0.024,1770,454
"11269",219046,1992,1,0,"BLACK HILLS STATE UNIVERSITY",NA,NA,1056,597,459,226,79,147,0.246,0.214,0.172,2126,986
"11270",219046,1993,1,0,"BLACK HILLS STATE UNIVERSITY",NA,NA,1078,586,492,243,85,158,0.27,0.225,0.173,2220,980
"11271",219046,1995,1,0,"BLACK HILLS STATE UNIVERSITY",NA,NA,435,234,201,33,8,25,0.107,0.076,0.04,2458,408
"11272",219046,1996,1,0,"BLACK HILLS STATE UNIVERSITY",NA,NA,452,260,192,58,15,43,0.165,0.128,0.078,2502,423
"11273",219046,1997,1,0,"BLACK HILLS STATE UNIVERSITY",NA,NA,451,227,224,38,8,30,0.132,0.084,0.036,2698,416
"11274",219046,1998,1,0,"BLACK HILLS STATE UNIVERSITY",NA,NA,632,381,251,48,13,35,0.092,0.076,0.052,2920,594
"11275",219046,1999,1,0,"BLACK HILLS STATE UNIVERSITY",NA,NA,630,360,270,71,17,54,0.15,0.113,0.063,3115,604
"11276",219046,2000,1,0,"BLACK HILLS STATE UNIVERSITY",NA,NA,586,361,225,48,11,37,0.103,0.082,0.049,3630,525
"11277",219046,2001,1,0,"BLACK HILLS STATE UNIVERSITY",NA,NA,565,354,211,65,27,38,0.107,0.115,0.128,1997,491
"11278",219046,2002,1,0,"BLACK HILLS STATE UNIVERSITY",NA,NA,537,334,203,43,11,32,0.096,0.08,0.054,2080,491
"11279",219046,2003,1,0,"BLACK HILLS STATE UNIVERSITY",NA,NA,653,409,244,62,17,45,0.11,0.095,0.07,2307,580
"11280",219046,2004,1,0,"BLACK HILLS STATE UNIVERSITY",NA,NA,581,350,231,46,11,35,0.1,0.079,0.048,2371,517
"11281",219046,2005,1,0,"Black Hills State University",NA,NA,584,353,231,74,22,52,0.147,0.127,0.095,2444,477
"11282",219046,2006,1,0,"Black Hills State University",NA,NA,595,353,242,122,28,94,0.266,0.205,0.116,2540,494
"11283",219046,2007,1,0,"Black Hills State University",NA,NA,472,268,204,51,14,37,0.138,0.108,0.069,2643,411
"11284",219046,2008,1,0,"Black Hills State University",NA,NA,545,345,200,64,17,47,0.136,0.117,0.085,2822,455
"11285",219046,2009,1,0,"Black Hills State University",NA,NA,540,308,232,85,23,62,0.201,0.157,0.099,2934,473
"11286",219046,2010,1,0,"Black Hills State University",NA,NA,648,386,262,105,30,75,0.194,0.162,0.115,3194,559
"11287",219082,1991,1,0,"DAKOTA STATE UNIVERSITY",NA,NA,209,110,99,9,2,7,0.064,0.043,0.02,1582,195
"11288",219082,1992,1,0,"DAKOTA STATE UNIVERSITY",NA,NA,234,123,111,26,12,14,0.114,0.111,0.108,1653,224
"11289",219082,1993,1,0,"DAKOTA STATE UNIVERSITY",NA,NA,208,116,92,14,2,12,0.103,0.067,0.022,1770,200
"11290",219082,1995,1,0,"DAKOTA STATE UNIVERSITY",NA,NA,256,125,131,22,5,17,0.136,0.086,0.038,2585,244
"11291",219082,1996,1,0,"DAKOTA STATE UNIVERSITY",NA,NA,189,100,89,25,5,20,0.2,0.132,0.056,2607,186
"11292",219082,1997,1,0,"DAKOTA STATE UNIVERSITY",NA,NA,249,135,114,1,1,0,0,0.004,0.009,2838,239
"11293",219082,1998,1,0,"DAKOTA STATE UNIVERSITY",NA,NA,231,110,121,45,17,28,0.254,0.195,0.14,3301,223
"11294",219082,1999,1,0,"DAKOTA STATE UNIVERSITY",NA,NA,306,124,182,45,21,24,0.194,0.147,0.115,1867,288
"11295",219082,2000,1,0,"DAKOTA STATE UNIVERSITY",NA,NA,351,149,202,51,25,26,0.174,0.145,0.124,1935,306
"11296",219082,2001,1,0,"DAKOTA STATE UNIVERSITY",NA,NA,292,123,169,54,28,26,0.211,0.185,0.166,1997,267
"11297",219082,2002,1,0,"DAKOTA STATE UNIVERSITY",NA,NA,273,111,162,45,22,23,0.207,0.165,0.136,2080,260
"11298",219082,2003,1,0,"DAKOTA STATE UNIVERSITY",NA,NA,290,120,170,43,18,25,0.208,0.148,0.106,2163,254
"11299",219082,2004,1,0,"DAKOTA STATE UNIVERSITY",NA,NA,249,114,135,44,18,26,0.228,0.177,0.133,2223,221
"11300",219082,2005,1,0,"Dakota State University",NA,NA,280,135,145,29,14,15,0.111,0.104,0.097,2290,265
"11301",219082,2006,1,0,"Dakota State University",NA,NA,295,137,158,41,23,18,0.131,0.139,0.146,2382,276
"11302",219082,2007,1,0,"Dakota State University",NA,NA,243,110,133,44,23,21,0.191,0.181,0.173,2478,220
"11303",219082,2008,1,0,"Dakota State University",NA,NA,258,121,137,45,18,27,0.223,0.174,0.131,2646,240
"11304",219082,2009,1,0,"Dakota State University",NA,NA,284,116,168,54,28,26,0.224,0.19,0.167,2751,252
"11305",219082,2010,1,0,"Dakota State University",NA,NA,314,113,201,62,43,19,0.168,0.197,0.214,2994,273
"11306",219198,1991,1,0,"MOUNT MARTY COLLEGE",NA,NA,126,95,31,38,8,30,0.316,0.302,0.258,6690,114
"11307",219198,1992,1,0,"MOUNT MARTY COLLEGE",NA,NA,107,72,35,31,9,22,0.306,0.29,0.257,7078,100
"11308",219198,1993,1,0,"MOUNT MARTY COLLEGE",NA,NA,117,96,21,39,9,30,0.312,0.333,0.429,7470,112
"11309",219198,1995,1,0,"MOUNT MARTY COLLEGE",NA,NA,95,62,33,27,11,16,0.258,0.284,0.333,8196,88
"11310",219198,1996,1,0,"MOUNT MARTY COLLEGE",NA,NA,117,77,40,42,11,31,0.403,0.359,0.275,8649,108
"11311",219198,1997,1,0,"MOUNT MARTY COLLEGE",NA,NA,129,96,33,47,12,35,0.365,0.364,0.364,9168,125
"11312",219198,1998,1,0,"MOUNT MARTY COLLEGE",NA,NA,126,85,41,44,13,31,0.365,0.349,0.317,9628,123
"11313",219198,1999,1,0,"MOUNT MARTY COLLEGE",NA,NA,121,84,37,34,8,26,0.31,0.281,0.216,9248,119
"11314",219198,2000,1,0,"MOUNT MARTY COLLEGE",NA,NA,154,97,57,46,21,25,0.258,0.299,0.368,9710,146
"11315",219198,2001,1,0,"MOUNT MARTY COLLEGE",NA,NA,148,109,39,49,10,39,0.358,0.331,0.256,9942,136
"11316",219198,2002,1,0,"MOUNT MARTY COLLEGE",NA,NA,137,104,33,44,7,37,0.356,0.321,0.212,11580,134
"11317",219198,2003,1,0,"MOUNT MARTY COLLEGE",NA,NA,158,113,45,33,11,22,0.195,0.209,0.244,12506,148
"11318",219198,2004,1,0,"MOUNT MARTY COLLEGE",NA,NA,150,111,39,51,13,38,0.342,0.34,0.333,13256,138
"11319",219198,2005,1,0,"Mount Marty College",NA,NA,139,91,48,54,15,39,0.429,0.388,0.312,14050,132
"11320",219198,2006,1,0,"Mount Marty College",NA,NA,127,92,35,57,14,43,0.467,0.449,0.4,14752,119
"11321",219198,2007,1,0,"Mount Marty College",NA,NA,108,73,35,49,14,35,0.48,0.454,0.4,15638,94
"11322",219198,2008,1,0,"Mount Marty College",NA,NA,136,88,48,66,20,46,0.523,0.485,0.417,16420,125
"11323",219198,2009,1,0,"Mount Marty College",NA,NA,109,66,43,47,16,31,0.47,0.431,0.372,17078,96
"11324",219198,2010,1,0,"Mount Marty College",NA,NA,120,64,56,48,17,31,0.484,0.4,0.304,18102,107
"11325",219259,1991,1,0,"NORTHERN STATE UNIVERSITY",NA,NA,511,258,253,45,15,30,0.116,0.088,0.059,1835,487
"11326",219259,1992,1,0,"NORTHERN STATE UNIVERSITY",NA,NA,587,313,274,60,20,40,0.128,0.102,0.073,1978,568
"11327",219259,1993,1,0,"NORTHERN STATE UNIVERSITY",NA,NA,647,360,287,73,14,59,0.164,0.113,0.049,2120,598
"11328",219259,1995,1,0,"NORTHERN STATE UNIVERSITY",NA,NA,574,343,231,75,19,56,0.163,0.131,0.082,2455,544
"11329",219259,1996,1,0,"NORTHERN STATE UNIVERSITY",NA,NA,560,324,236,68,24,44,0.136,0.121,0.102,2526,510
"11330",219259,1997,1,0,"NORTHERN STATE UNIVERSITY",NA,NA,539,321,218,83,22,61,0.19,0.154,0.101,2704,502
"11331",219259,1998,1,0,"NORTHERN STATE UNIVERSITY",NA,NA,480,276,204,66,16,50,0.181,0.138,0.078,2842,404
"11332",219259,1999,1,0,"NORTHERN STATE UNIVERSITY",NA,NA,523,303,220,69,15,54,0.178,0.132,0.068,1750,440
"11333",219259,2000,1,0,"NORTHERN STATE UNIVERSITY",NA,NA,446,257,189,61,10,51,0.198,0.137,0.053,1812,399
"11334",219259,2001,1,0,"NORTHERN STATE UNIVERSITY",NA,NA,409,244,165,61,14,47,0.193,0.149,0.085,1872,363
"11335",219259,2002,1,0,"NORTHERN STATE UNIVERSITY",NA,NA,376,214,162,51,12,39,0.182,0.136,0.074,1950,343
"11336",219259,2003,1,0,"NORTHERN STATE UNIVERSITY",NA,NA,380,210,170,59,16,43,0.205,0.155,0.094,2163,297
"11337",219259,2004,1,0,"NORTHERN STATE UNIVERSITY",NA,NA,384,238,146,53,12,41,0.172,0.138,0.082,2223,321
"11338",219259,2005,1,0,"Northern State University",NA,NA,368,197,171,47,13,34,0.173,0.128,0.076,2290,329
"11339",219259,2006,1,0,"Northern State University",NA,NA,367,178,189,50,14,36,0.202,0.136,0.074,2382,315
"11340",219259,2007,1,0,"Northern State University",NA,NA,340,203,137,70,15,55,0.271,0.206,0.109,2478,302
"11341",219259,2008,1,0,"Northern State University",NA,NA,389,204,185,67,16,51,0.25,0.172,0.086,2646,347
"11342",219259,2009,1,0,"Northern State University",NA,NA,317,197,120,65,16,49,0.249,0.205,0.133,2751,273
"11343",219259,2010,1,0,"Northern State University",NA,NA,380,208,172,84,25,59,0.284,0.221,0.145,2994,324
"11344",219356,1991,1,0,"SOUTH DAKOTA STATE UNIVERSITY",NA,NA,1306,657,649,189,77,112,0.17,0.145,0.119,2045,1278
"11345",219356,1992,1,0,"SOUTH DAKOTA STATE UNIVERSITY",NA,NA,1495,701,794,293,112,181,0.258,0.196,0.141,2146,1458
"11346",219356,1993,1,0,"SOUTH DAKOTA STATE UNIVERSITY",NA,NA,1670,831,839,320,128,192,0.231,0.192,0.153,2252,1631
"11347",219356,1995,1,0,"SOUTH DAKOTA STATE UNIVERSITY",NA,NA,1659,813,846,359,135,224,0.276,0.216,0.16,2705,1615
"11348",219356,1996,1,0,"SOUTH DAKOTA STATE UNIVERSITY",NA,NA,1481,733,748,303,129,174,0.237,0.205,0.172,2784,1437
"11349",219356,1997,1,0,"SOUTH DAKOTA STATE UNIVERSITY",NA,NA,1531,741,790,346,130,216,0.292,0.226,0.165,2912,1444
"11350",219356,1998,1,0,"SOUTH DAKOTA STATE UNIVERSITY",NA,NA,1510,766,744,384,147,237,0.309,0.254,0.198,3128,1444
"11351",219356,1999,1,0,"SOUTH DAKOTA STATE UNIVERSITY",NA,NA,1457,714,743,342,127,215,0.301,0.235,0.171,1867,1313
"11352",219356,2000,1,0,"SOUTH DAKOTA STATE UNIVERSITY",NA,NA,1446,740,706,327,129,198,0.268,0.226,0.183,1933,1363
"11353",219356,2001,1,0,"SOUTH DAKOTA STATE UNIVERSITY",NA,NA,1495,751,744,316,105,211,0.281,0.211,0.141,1997,1396
"11354",219356,2002,1,0,"SOUTH DAKOTA STATE UNIVERSITY",NA,NA,1767,864,903,348,140,208,0.241,0.197,0.155,2080,1671
"11355",219356,2003,1,0,"SOUTH DAKOTA STATE UNIVERSITY",NA,NA,1993,957,1036,427,176,251,0.262,0.214,0.17,2307,1881
"11356",219356,2004,1,0,"SOUTH DAKOTA STATE UNIVERSITY",NA,NA,1993,1011,982,485,194,291,0.288,0.243,0.198,2371,1824
"11357",219356,2005,1,0,"South Dakota State University",NA,NA,1784,893,891,528,213,315,0.353,0.296,0.239,2443,1646
"11358",219356,2006,1,0,"South Dakota State University",NA,NA,1833,922,911,484,173,311,0.337,0.264,0.19,2382,1688
"11359",219356,2007,1,0,"South Dakota State University",NA,NA,1933,950,983,495,183,312,0.328,0.256,0.186,2478,1764
"11360",219356,2008,1,0,"South Dakota State University",NA,NA,2008,987,1021,563,237,326,0.33,0.28,0.232,2646,1886
"11361",219356,2009,1,0,"South Dakota State University",NA,NA,2043,1032,1011,602,247,355,0.344,0.295,0.244,2751,1889
"11362",219356,2010,1,0,"South Dakota State University",NA,NA,2157,1051,1106,613,270,343,0.326,0.284,0.244,2994,1985
"11363",219471,1991,1,0,"UNIVERSITY OF SOUTH DAKOTA",NA,NA,1150,661,489,223,78,145,0.219,0.194,0.16,1977,1110
"11364",219471,1992,1,0,"UNIVERSITY OF SOUTH DAKOTA",NA,NA,1228,686,542,239,79,160,0.233,0.195,0.146,2073,1153
"11365",219471,1993,1,0,"UNIVERSITY OF SOUTH DAKOTA",NA,NA,1227,704,523,247,79,168,0.239,0.201,0.151,2294,1166
"11366",219471,1995,1,0,"UNIVERSITY OF SOUTH DAKOTA",NA,NA,1160,660,500,224,60,164,0.249,0.193,0.12,2803,1095
"11367",219471,1996,1,0,"UNIVERSITY OF SOUTH DAKOTA",NA,NA,875,489,386,175,62,113,0.231,0.2,0.161,2885,833
"11368",219471,1997,1,0,"UNIVERSITY OF SOUTH DAKOTA",NA,NA,896,503,393,213,80,133,0.264,0.238,0.204,2918,842
"11369",219471,1998,1,0,"UNIVERSITY OF SOUTH DAKOTA",NA,NA,894,500,394,180,58,122,0.244,0.201,0.147,3216,824
"11370",219471,1999,1,0,"UNIVERSITY OF SOUTH DAKOTA",NA,NA,868,493,375,176,53,123,0.25,0.203,0.141,1867,781
"11371",219471,2000,1,0,"UNIVERSITY OF SOUTH DAKOTA",NA,NA,918,504,414,199,62,137,0.272,0.217,0.15,1933,811
"11372",219471,2001,1,0,"UNIVERSITY OF SOUTH DAKOTA",NA,NA,932,578,354,196,45,151,0.261,0.21,0.127,1997,843
"11373",219471,2002,1,0,"UNIVERSITY OF SOUTH DAKOTA",NA,NA,976,544,432,186,74,112,0.206,0.191,0.171,2080,876
"11374",219471,2003,1,0,"UNIVERSITY OF SOUTH DAKOTA",NA,NA,982,539,443,186,76,110,0.204,0.189,0.172,2307,855
"11375",219471,2004,1,0,"UNIVERSITY OF SOUTH DAKOTA",NA,NA,945,538,407,220,80,140,0.26,0.233,0.197,2371,841
"11376",219471,2005,1,0,"University of South Dakota",NA,NA,1030,621,409,236,74,162,0.261,0.229,0.181,2443,908
"11377",219471,2006,1,0,"University of South Dakota",NA,NA,1109,674,435,237,88,149,0.221,0.214,0.202,2541,998
"11378",219471,2007,1,0,"University of South Dakota",NA,NA,1030,612,418,282,105,177,0.289,0.274,0.251,2643,810
"11379",219471,2008,1,0,"University of South Dakota",NA,NA,1023,597,426,295,111,184,0.308,0.288,0.261,2646,835
"11380",219471,2009,1,0,"University of South Dakota",NA,NA,971,559,412,286,91,195,0.349,0.295,0.221,2751,791
"11381",219471,2010,1,0,"University of South Dakota",NA,NA,1034,622,412,313,114,199,0.32,0.303,0.277,2994,840
"11382",219602,1991,1,0,"AUSTIN PEAY STATE UNIVERSITY",NA,NA,771,492,279,70,14,56,0.114,0.091,0.05,1628,563
"11383",219602,1992,1,0,"AUSTIN PEAY STATE UNIVERSITY",NA,NA,752,471,281,164,46,118,0.25,0.218,0.164,1726,577
"11384",219602,1993,1,0,"AUSTIN PEAY STATE UNIVERSITY",NA,NA,788,474,314,152,50,102,0.215,0.193,0.159,1800,587
"11385",219602,1995,1,0,"AUSTIN PEAY STATE UNIVERSITY",NA,NA,776,457,319,105,26,79,0.173,0.135,0.082,1946,591
"11386",219602,1996,1,0,"AUSTIN PEAY STATE UNIVERSITY",NA,NA,777,498,279,156,38,118,0.237,0.201,0.136,2108,609
"11387",219602,1997,1,0,"AUSTIN PEAY STATE UNIVERSITY",NA,NA,788,503,285,144,40,104,0.207,0.183,0.14,2280,595
"11388",219602,1998,1,0,"AUSTIN PEAY STATE UNIVERSITY",NA,NA,846,518,328,76,20,56,0.108,0.09,0.061,2470,612
"11389",219602,1999,1,0,"AUSTIN PEAY STATE UNIVERSITY",NA,NA,715,432,283,66,22,44,0.102,0.092,0.078,2584,506
"11390",219602,2000,1,0,"AUSTIN PEAY STATE UNIVERSITY",NA,NA,870,554,316,101,29,72,0.13,0.116,0.092,2222,630
"11391",219602,2001,1,0,"AUSTIN PEAY STATE UNIVERSITY",NA,NA,900,569,331,77,20,57,0.1,0.086,0.06,2556,642
"11392",219602,2002,1,0,"AUSTIN PEAY STATE UNIVERSITY",NA,NA,986,636,350,126,37,89,0.14,0.128,0.106,2748,662
"11393",219602,2003,1,0,"AUSTIN PEAY STATE UNIVERSITY",NA,NA,967,609,358,118,33,85,0.14,0.122,0.092,3132,677
"11394",219602,2004,1,0,"AUSTIN PEAY STATE UNIVERSITY",NA,NA,1196,714,482,173,64,109,0.153,0.145,0.133,3352,837
"11395",219602,2005,1,0,"Austin Peay State University",NA,NA,1226,708,518,175,70,105,0.148,0.143,0.135,3678,869
"11396",219602,2006,1,0,"Austin Peay State University",NA,NA,1210,731,479,188,56,132,0.181,0.155,0.117,3828,809
"11397",219602,2007,1,0,"Austin Peay State University",NA,NA,1188,683,505,178,55,123,0.18,0.15,0.109,4058,739
"11398",219602,2008,1,0,"Austin Peay State University",NA,NA,1326,806,520,208,70,138,0.171,0.157,0.135,4302,858
"11399",219602,2009,1,0,"Austin Peay State University",NA,NA,1465,897,568,214,74,140,0.156,0.146,0.13,4584,1038
"11400",219602,2010,1,0,"Austin Peay State University",NA,NA,1478,903,575,252,88,164,0.182,0.171,0.153,4824,981
"11401",219709,1991,1,0,"BELMONT UNIVERSITY",NA,NA,238,146,92,68,21,47,0.322,0.286,0.228,6100,223
"11402",219709,1992,1,0,"BELMONT UNIVERSITY",NA,NA,285,158,127,93,41,52,0.329,0.326,0.323,6480,264
"11403",219709,1993,1,0,"BELMONT UNIVERSITY",NA,NA,328,182,146,137,58,79,0.434,0.418,0.397,7300,307
"11404",219709,1995,1,0,"BELMONT UNIVERSITY",NA,NA,347,221,126,14,3,11,0.05,0.04,0.024,8750,313
"11405",219709,1996,1,0,"BELMONT UNIVERSITY",NA,NA,418,262,156,185,66,119,0.454,0.443,0.423,9500,389
"11406",219709,1997,1,0,"BELMONT UNIVERSITY",NA,NA,399,248,151,197,67,130,0.524,0.494,0.444,10300,365
"11407",219709,1998,1,0,"BELMONT UNIVERSITY",NA,NA,413,254,159,201,73,128,0.504,0.487,0.459,11050,377
"11408",219709,1999,1,0,"BELMONT UNIVERSITY",NA,NA,487,300,187,266,91,175,0.583,0.546,0.487,11300,447
"11409",219709,2000,1,0,"BELMONT UNIVERSITY",NA,NA,516,309,207,278,108,170,0.55,0.539,0.522,11990,479
"11410",219709,2001,1,0,"BELMONT UNIVERSITY",NA,NA,502,309,193,284,121,163,0.527,0.566,0.627,13040,455
"11411",219709,2002,1,0,"BELMONT UNIVERSITY",NA,NA,524,320,204,264,91,173,0.541,0.504,0.446,13690,476
"11412",219709,2003,1,0,"BELMONT UNIVERSITY",NA,NA,599,360,239,312,110,202,0.561,0.521,0.46,15164,555
"11413",219709,2004,1,0,"BELMONT UNIVERSITY",NA,NA,727,442,285,429,168,261,0.591,0.59,0.589,15360,661
"11414",219709,2005,1,0,"Belmont University",NA,NA,791,488,303,483,180,303,0.621,0.611,0.594,16360,715
"11415",219709,2006,1,0,"Belmont University",NA,NA,763,439,324,422,160,262,0.597,0.553,0.494,17470,679
"11416",219709,2007,1,0,"Belmont University",NA,NA,799,453,346,449,187,262,0.578,0.562,0.54,18780,706
"11417",219709,2008,1,0,"Belmont University",NA,NA,928,519,409,520,217,303,0.584,0.56,0.531,20070,800
"11418",219709,2009,1,0,"Belmont University",NA,NA,986,558,428,561,222,339,0.608,0.569,0.519,21770,870
"11419",219709,2010,1,0,"Belmont University",NA,NA,1013,581,432,597,247,350,0.602,0.589,0.572,22530,877
"11420",219718,1991,1,0,"BETHEL COLLEGE",NA,NA,107,68,39,12,6,6,0.088,0.112,0.154,4350,98
"11421",219718,1992,1,0,"BETHEL COLLEGE",NA,NA,104,65,39,12,6,6,0.092,0.115,0.154,5250,86
"11422",219718,1993,1,0,"BETHEL COLLEGE",NA,NA,125,43,82,15,4,11,0.256,0.12,0.049,6200,97
"11423",219718,1995,1,0,"BETHEL COLLEGE",NA,NA,149,52,97,17,5,12,0.231,0.114,0.052,7000,125
"11424",219718,1996,1,0,"BETHEL COLLEGE",NA,NA,180,82,98,24,6,18,0.22,0.133,0.061,6990,156
"11425",219718,1997,1,0,"BETHEL COLLEGE",NA,NA,65,26,39,8,2,6,0.231,0.123,0.051,6990,60
"11426",219718,1998,1,0,"BETHEL COLLEGE",NA,NA,82,29,53,16,6,10,0.345,0.195,0.113,6990,70
"11427",219718,1999,1,0,"BETHEL COLLEGE",NA,NA,142,42,100,17,10,7,0.167,0.12,0.1,7800,110
"11428",219718,2000,1,0,"BETHEL COLLEGE",NA,NA,137,44,93,17,7,10,0.227,0.124,0.075,7860,104
"11429",219718,2001,1,0,"BETHEL COLLEGE",NA,NA,141,63,78,21,3,18,0.286,0.149,0.038,8180,103
"11430",219718,2002,1,0,"BETHEL COLLEGE",NA,NA,139,53,86,16,5,11,0.208,0.115,0.058,8180,85
"11431",219718,2003,1,0,"BETHEL COLLEGE",NA,NA,129,59,70,27,10,17,0.288,0.209,0.143,9360,90
"11432",219718,2004,1,0,"BETHEL COLLEGE",NA,NA,252,97,155,40,15,25,0.258,0.159,0.097,9360,149
"11433",219718,2005,1,0,"Bethel College",NA,NA,234,108,126,29,9,20,0.185,0.124,0.071,10016,139
"11434",219718,2006,1,0,"Bethel College",NA,NA,243,94,149,26,13,13,0.138,0.107,0.087,10516,144
"11435",219718,2007,1,0,"Bethel College",NA,NA,255,115,140,27,13,14,0.122,0.106,0.093,11040,145
"11436",219718,2008,1,0,"Bethel College",NA,NA,268,122,146,57,19,38,0.312,0.213,0.13,11592,168
"11437",219718,2009,1,0,"Bethel University",NA,NA,351,151,200,90,36,54,0.358,0.256,0.18,11592,195
"11438",219718,2010,1,0,"Bethel University",NA,NA,377,133,244,51,27,24,0.181,0.135,0.111,12288,265
"11439",219949,1991,1,0,"CUMBERLAND UNIVERSITY",NA,NA,165,88,77,26,13,13,0.148,0.158,0.169,4700,153
"11440",219949,1992,1,0,"CUMBERLAND UNIVERSITY",NA,NA,173,80,93,40,18,22,0.275,0.231,0.194,5000,147
"11441",219949,1993,1,0,"CUMBERLAND UNIVERSITY",NA,NA,169,106,63,37,6,31,0.292,0.219,0.095,5500,134
"11442",219949,1995,1,0,"CUMBERLAND UNIVERSITY",NA,NA,171,64,107,38,17,21,0.328,0.222,0.159,6950,137
"11443",219949,1996,1,0,"CUMBERLAND UNIVERSITY",NA,NA,154,78,76,37,10,27,0.346,0.24,0.132,7440,128
"11444",219949,1997,1,0,"CUMBERLAND UNIVERSITY",NA,NA,186,91,95,42,10,32,0.352,0.226,0.105,8590,149
"11445",219949,1998,1,0,"CUMBERLAND UNIVERSITY",NA,NA,236,111,125,44,8,36,0.324,0.186,0.064,9000,197
"11446",219949,1999,1,0,"CUMBERLAND UNIVERSITY",NA,NA,174,67,107,36,19,17,0.254,0.207,0.178,9850,141
"11447",219949,2000,1,0,"CUMBERLAND UNIVERSITY",NA,NA,189,78,111,28,9,19,0.244,0.148,0.081,10530,145
"11448",219949,2001,1,0,"CUMBERLAND UNIVERSITY",NA,NA,200,92,108,39,15,24,0.261,0.195,0.139,10950,164
"11449",219949,2002,1,0,"CUMBERLAND UNIVERSITY",NA,NA,164,74,90,35,6,29,0.392,0.213,0.067,11660,128
"11450",219949,2003,1,0,"CUMBERLAND UNIVERSITY",NA,NA,149,76,73,24,9,15,0.197,0.161,0.123,12130,113
"11451",219949,2004,1,0,"CUMBERLAND UNIVERSITY",NA,NA,203,104,99,37,15,22,0.212,0.182,0.152,12130,159
"11452",219949,2005,1,0,"Cumberland University",NA,NA,217,107,110,44,17,27,0.252,0.203,0.155,13344,178
"11453",219949,2006,1,0,"Cumberland University",NA,NA,189,75,114,34,8,26,0.347,0.18,0.07,14010,138
"11454",219949,2007,1,0,"Cumberland University",NA,NA,210,75,135,43,22,21,0.28,0.205,0.163,14710,158
"11455",219949,2008,1,0,"Cumberland University",NA,NA,194,82,112,43,20,23,0.28,0.222,0.179,15820,154
"11456",219949,2009,1,0,"Cumberland University",NA,NA,200,101,99,62,25,37,0.366,0.31,0.253,16530,160
"11457",219949,2010,1,0,"Cumberland University",NA,NA,163,67,96,56,29,27,0.403,0.344,0.302,17356,130
"11458",220075,1991,1,0,"EAST TENNESSEE STATE UNIVERSITY",NA,NA,1599,950,649,149,47,102,0.107,0.093,0.072,1456,1481
"11459",220075,1992,1,0,"EAST TENNESSEE STATE UNIVERSITY",NA,NA,1610,971,639,150,37,113,0.116,0.093,0.058,1554,1450
"11460",220075,1993,1,0,"EAST TENNESSEE STATE UNIVERSITY",NA,NA,1289,757,532,128,51,77,0.102,0.099,0.096,1680,1159
"11461",220075,1995,1,0,"EAST TENNESSEE STATE UNIVERSITY",NA,NA,1505,867,638,178,59,119,0.137,0.118,0.092,1878,1371
"11462",220075,1996,1,0,"EAST TENNESSEE STATE UNIVERSITY",NA,NA,1532,894,638,186,62,124,0.139,0.121,0.097,1928,1392
"11463",220075,1997,1,0,"EAST TENNESSEE STATE UNIVERSITY",NA,NA,1487,853,634,192,70,122,0.143,0.129,0.11,2100,1339
"11464",220075,1998,1,0,"EAST TENNESSEE STATE UNIVERSITY",NA,NA,1507,880,627,204,64,140,0.159,0.135,0.102,2384,1357
"11465",220075,1999,1,0,"EAST TENNESSEE STATE UNIVERSITY",NA,NA,1466,821,645,217,62,155,0.189,0.148,0.096,2020,1313
"11466",220075,2000,1,0,"EAST TENNESSEE STATE UNIVERSITY",NA,NA,1483,824,659,244,73,171,0.208,0.165,0.111,2222,1321
"11467",220075,2001,1,0,"EAST TENNESSEE STATE UNIVERSITY",NA,NA,1472,838,634,255,79,176,0.21,0.173,0.125,2556,1322
"11468",220075,2002,1,0,"EAST TENNESSEE STATE UNIVERSITY",NA,NA,1473,831,642,262,76,186,0.224,0.178,0.118,2748,1325
"11469",220075,2003,1,0,"EAST TENNESSEE STATE UNIVERSITY",NA,NA,1563,921,642,301,99,202,0.219,0.193,0.154,3132,1433
"11470",220075,2004,1,0,"EAST TENNESSEE STATE UNIVERSITY",NA,NA,1479,846,633,259,76,183,0.216,0.175,0.12,3352,1311
"11471",220075,2005,1,0,"East Tennessee State University",NA,NA,1565,897,668,308,102,206,0.23,0.197,0.153,3678,1404
"11472",220075,2006,1,0,"East Tennessee State University",NA,NA,1712,966,746,279,106,173,0.179,0.163,0.142,3828,1495
"11473",220075,2007,1,0,"East Tennessee State University",NA,NA,1918,1063,855,330,110,220,0.207,0.172,0.129,4058,1669
"11474",220075,2008,1,0,"East Tennessee State University",NA,NA,1932,1069,863,380,133,247,0.231,0.197,0.154,4302,1665
"11475",220075,2009,1,0,"East Tennessee State University",NA,NA,2063,1144,919,415,146,269,0.235,0.201,0.159,4584,1785
"11476",220075,2010,1,0,"East Tennessee State University",NA,NA,2052,1165,887,406,147,259,0.222,0.198,0.166,4824,1714
"11477",220215,1991,1,0,"FREED-HARDEMAN UNIVERSITY",NA,NA,295,147,148,80,38,42,0.286,0.271,0.257,5040,275
"11478",220215,1992,1,0,"FREED-HARDEMAN UNIVERSITY",NA,NA,286,156,130,92,32,60,0.385,0.322,0.246,5560,269
"11479",220215,1993,1,0,"FREED-HARDEMAN UNIVERSITY",NA,NA,296,169,127,83,31,52,0.308,0.28,0.244,5605,276
"11480",220215,1995,1,0,"FREED-HARDEMAN UNIVERSITY",NA,NA,294,170,124,90,37,53,0.312,0.306,0.298,6620,279
"11481",220215,1996,1,0,"FREED-HARDEMAN UNIVERSITY",NA,NA,314,194,120,107,30,77,0.397,0.341,0.25,7120,298
"11482",220215,1997,1,0,"FREED-HARDEMAN UNIVERSITY",NA,NA,294,181,113,100,40,60,0.332,0.34,0.354,7524,279
"11483",220215,1998,1,0,"FREED-HARDEMAN UNIVERSITY",NA,NA,358,199,159,116,53,63,0.317,0.324,0.333,7894,339
"11484",220215,1999,1,0,"FREED-HARDEMAN UNIVERSITY",NA,NA,322,187,135,125,59,66,0.353,0.388,0.437,7328,287
"11485",220215,2000,1,0,"FREED-HARDEMAN UNIVERSITY",NA,NA,357,198,159,132,60,72,0.364,0.37,0.377,7696,336
"11486",220215,2001,1,0,"FREED-HARDEMAN UNIVERSITY",NA,NA,346,191,155,146,58,88,0.461,0.422,0.374,8080,317
"11487",220215,2002,1,0,"FREED-HARDEMAN UNIVERSITY",NA,NA,414,231,183,181,73,108,0.468,0.437,0.399,8568,385
"11488",220215,2003,1,0,"FREED-HARDEMAN UNIVERSITY",NA,NA,374,211,163,138,53,85,0.403,0.369,0.325,9300,347
"11489",220215,2004,1,0,"FREED-HARDEMAN UNIVERSITY",NA,NA,371,205,166,145,54,91,0.444,0.391,0.325,10080,342
"11490",220215,2005,1,0,"Freed-Hardeman University",NA,NA,373,203,170,139,61,78,0.384,0.373,0.359,10500,340
"11491",220215,2006,1,0,"Freed-Hardeman University",NA,NA,358,206,152,145,48,97,0.471,0.405,0.316,11100,331
"11492",220215,2007,1,0,"Freed-Hardeman University",NA,NA,385,222,163,148,58,90,0.405,0.384,0.356,11100,346
"11493",220215,2008,1,0,"Freed-Hardeman University",NA,NA,405,220,185,154,61,93,0.423,0.38,0.33,11700,368
"11494",220215,2009,1,0,"Freed-Hardeman University",NA,NA,405,240,165,177,72,105,0.438,0.437,0.436,12060,358
"11495",220215,2010,1,0,"Freed-Hardeman University",NA,NA,370,214,156,164,62,102,0.477,0.443,0.397,12840,328
"11496",220613,1991,1,0,"LEE COLLEGE",NA,NA,368,185,183,62,24,38,0.205,0.168,0.131,4418,336
"11497",220613,1992,1,0,"LEE COLLEGE",NA,NA,359,207,152,63,20,43,0.208,0.175,0.132,4282,278
"11498",220613,1993,1,0,"LEE COLLEGE",NA,NA,395,205,190,87,37,50,0.244,0.22,0.195,4560,337
"11499",220613,1995,1,0,"LEE COLLEGE",NA,NA,493,287,206,115,37,78,0.272,0.233,0.18,5132,479
"11500",220613,1996,1,0,"LEE COLLEGE",NA,NA,525,304,221,128,45,83,0.273,0.244,0.204,5472,504
"11501",220613,1997,1,0,"LEE UNIVERSITY",NA,NA,655,379,276,149,50,99,0.261,0.227,0.181,5636,627
"11502",220613,1998,1,0,"LEE UNIVERSITY",NA,NA,722,417,305,193,62,131,0.314,0.267,0.203,5966,640
"11503",220613,1999,1,0,"LEE UNIVERSITY",NA,NA,690,400,290,213,80,133,0.332,0.309,0.276,6118,626
"11504",220613,2000,1,0,"LEE UNIVERSITY",NA,NA,711,435,276,204,72,132,0.303,0.287,0.261,6700,594
"11505",220613,2001,1,0,"LEE UNIVERSITY",NA,NA,663,405,258,204,57,147,0.363,0.308,0.221,7336,588
"11506",220613,2002,1,0,"LEE UNIVERSITY",NA,NA,705,423,282,195,60,135,0.319,0.277,0.213,8040,610
"11507",220613,2003,1,0,"LEE UNIVERSITY",NA,NA,646,393,253,197,66,131,0.333,0.305,0.261,8520,548
"11508",220613,2004,1,0,"LEE UNIVERSITY",NA,NA,723,430,293,223,67,156,0.363,0.308,0.229,8950,621
"11509",220613,2005,1,0,"Lee University",NA,NA,755,454,301,297,99,198,0.436,0.393,0.329,9400,629
"11510",220613,2006,1,0,"Lee University",NA,NA,810,473,337,270,77,193,0.408,0.333,0.228,9888,648
"11511",220613,2007,1,0,"Lee University",NA,NA,783,437,346,271,88,183,0.419,0.346,0.254,10392,624
"11512",220613,2008,1,0,"Lee University",NA,NA,848,501,347,333,103,230,0.459,0.393,0.297,10824,705
"11513",220613,2009,1,0,"Lee University",NA,NA,829,507,322,288,80,208,0.41,0.347,0.248,11100,692
"11514",220613,2010,1,0,"Lee University",NA,NA,851,494,357,288,93,195,0.395,0.338,0.261,11660,678
"11515",220631,1991,1,0,"LINCOLN MEMORIAL UNIVERSITY",NA,NA,311,209,102,126,40,86,0.412,0.405,0.392,4790,290
"11516",220631,1992,1,0,"LINCOLN MEMORIAL UNIVERSITY",NA,NA,328,207,121,127,47,80,0.386,0.387,0.388,5250,302
"11517",220631,1993,1,0,"LINCOLN MEMORIAL UNIVERSITY",NA,NA,217,134,83,59,23,36,0.269,0.272,0.277,5530,197
"11518",220631,1995,1,0,"LINCOLN MEMORIAL UNIVERSITY",NA,NA,204,131,73,31,9,22,0.168,0.152,0.123,6550,185
"11519",220631,1996,1,0,"LINCOLN MEMORIAL UNIVERSITY",NA,NA,212,134,78,58,23,35,0.261,0.274,0.295,6950,186
"11520",220631,1997,1,0,"LINCOLN MEMORIAL UNIVERSITY",NA,NA,134,88,46,39,15,24,0.273,0.291,0.326,7400,110
"11521",220631,1998,1,0,"LINCOLN MEMORIAL UNIVERSITY",NA,NA,179,122,57,31,10,21,0.172,0.173,0.175,8100,156
"11522",220631,1999,1,0,"LINCOLN MEMORIAL UNIVERSITY",NA,NA,113,80,33,35,9,26,0.325,0.31,0.273,8520,102
"11523",220631,2000,1,0,"LINCOLN MEMORIAL UNIVERSITY",NA,NA,168,104,64,50,21,29,0.279,0.298,0.328,9600,146
"11524",220631,2001,1,0,"LINCOLN MEMORIAL UNIVERSITY",NA,NA,153,101,52,34,12,22,0.218,0.222,0.231,10800,124
"11525",220631,2002,1,0,"LINCOLN MEMORIAL UNIVERSITY",NA,NA,151,109,42,33,8,25,0.229,0.219,0.19,11760,135
"11526",220631,2003,1,0,"LINCOLN MEMORIAL UNIVERSITY",NA,NA,183,129,54,33,7,26,0.202,0.18,0.13,11760,160
"11527",220631,2004,1,0,"LINCOLN MEMORIAL UNIVERSITY",NA,NA,201,138,63,50,18,32,0.232,0.249,0.286,12600,143
"11528",220631,2005,1,0,"Lincoln Memorial University",NA,NA,139,90,49,25,6,19,0.211,0.18,0.122,13104,105
"11529",220631,2006,1,0,"Lincoln Memorial University",NA,NA,219,135,84,3,0,3,0.022,0.014,0,13752,185
"11530",220631,2007,1,0,"Lincoln Memorial University",NA,NA,230,159,71,23,19,4,0.025,0.1,0.268,14400,198
"11531",220631,2008,1,0,"Lincoln Memorial University",NA,NA,256,169,87,31,10,21,0.124,0.121,0.115,15120,209
"11532",220631,2009,1,0,"Lincoln Memorial University",NA,NA,314,218,96,61,15,46,0.211,0.194,0.156,15120,243
"11533",220631,2010,1,0,"Lincoln Memorial University",NA,NA,352,232,120,115,46,69,0.297,0.327,0.383,16200,254
"11534",220710,1991,1,0,"MARYVILLE COLLEGE",NA,NA,154,80,74,50,16,34,0.425,0.325,0.216,8400,128
"11535",220710,1992,1,0,"MARYVILLE COLLEGE",NA,NA,194,94,100,67,23,44,0.468,0.345,0.23,9580,172
"11536",220710,1993,1,0,"MARYVILLE COLLEGE",NA,NA,175,73,102,56,28,28,0.384,0.32,0.275,10428,161
"11537",220710,1995,1,0,"MARYVILLE COLLEGE",NA,NA,217,106,111,86,32,54,0.509,0.396,0.288,12246,197
"11538",220710,1996,1,0,"MARYVILLE COLLEGE",NA,NA,259,134,125,134,54,80,0.597,0.517,0.432,13030,231
"11539",220710,1997,1,0,"MARYVILLE COLLEGE",NA,NA,245,117,128,99,44,55,0.47,0.404,0.344,14425,227
"11540",220710,1998,1,0,"MARYVILLE COLLEGE",NA,NA,228,132,96,96,35,61,0.462,0.421,0.365,15425,206
"11541",220710,1999,1,0,"MARYVILLE COLLEGE",NA,NA,313,174,139,141,50,91,0.523,0.45,0.36,15600,285
"11542",220710,2000,1,0,"MARYVILLE COLLEGE",NA,NA,269,132,137,135,54,81,0.614,0.502,0.394,16224,244
"11543",220710,2001,1,0,"MARYVILLE COLLEGE",NA,NA,288,166,122,133,35,98,0.59,0.462,0.287,16985,257
"11544",220710,2002,1,0,"MARYVILLE COLLEGE",NA,NA,246,127,119,103,44,59,0.465,0.419,0.37,18260,208
"11545",220710,2003,1,0,"MARYVILLE COLLEGE",NA,NA,293,140,153,133,51,82,0.586,0.454,0.333,19180,270
"11546",220710,2004,1,0,"MARYVILLE COLLEGE",NA,NA,317,169,148,155,56,99,0.586,0.489,0.378,20465,292
"11547",220710,2005,1,0,"Maryville College",NA,NA,333,163,170,158,67,91,0.558,0.474,0.394,21624,292
"11548",220710,2006,1,0,"Maryville College",NA,NA,298,163,135,123,49,74,0.454,0.413,0.363,23125,265
"11549",220710,2007,1,0,"Maryville College",NA,NA,317,158,159,148,49,99,0.627,0.467,0.308,24675,271
"11550",220710,2008,1,0,"Maryville College",NA,NA,297,146,151,120,50,70,0.48,0.404,0.331,26272,262
"11551",220710,2009,1,0,"Maryville College",NA,NA,304,154,150,56,46,10,0.065,0.184,0.307,27296,260
"11552",220710,2010,1,0,"Maryville College",NA,NA,277,126,151,129,53,76,0.603,0.466,0.351,28798,226
"11553",221351,1991,1,0,"RHODES COLLEGE",NA,NA,379,208,171,258,108,150,0.721,0.681,0.632,12958,345
"11554",221351,1992,1,0,"RHODES COLLEGE",NA,NA,360,202,158,256,113,143,0.708,0.711,0.715,13950,330
"11555",221351,1993,1,0,"RHODES COLLEGE",NA,NA,385,215,170,284,124,160,0.744,0.738,0.729,14916,350
"11556",221351,1995,1,0,"RHODES COLLEGE",NA,NA,373,204,169,256,105,151,0.74,0.686,0.621,15920,340
"11557",221351,1996,1,0,"RHODES COLLEGE",NA,NA,375,196,179,264,128,136,0.694,0.704,0.715,16550,357
"11558",221351,1997,1,0,"RHODES COLLEGE",NA,NA,422,239,183,301,128,173,0.724,0.713,0.699,17518,370
"11559",221351,1998,1,0,"RHODES COLLEGE",NA,NA,383,206,177,291,128,163,0.791,0.76,0.723,18196,343
"11560",221351,1999,1,0,"RHODES COLLEGE",NA,NA,438,251,187,338,143,195,0.777,0.772,0.765,18561,382
"11561",221351,2000,1,0,"RHODES COLLEGE",NA,NA,396,227,169,296,125,171,0.753,0.747,0.74,19303,352
"11562",221351,2001,1,0,"RHODES COLLEGE",NA,NA,417,249,168,292,107,185,0.743,0.7,0.637,20366,359
"11563",221351,2002,1,0,"RHODES COLLEGE",NA,NA,439,238,201,306,136,170,0.714,0.697,0.677,21366,379
"11564",221351,2003,1,0,"RHODES COLLEGE",NA,NA,456,274,182,343,140,203,0.741,0.752,0.769,22628,397
"11565",221351,2004,1,0,"RHODES COLLEGE",NA,NA,474,269,205,360,144,216,0.803,0.759,0.702,23964,424
"11566",221351,2005,1,0,"Rhodes College",NA,NA,440,255,185,313,131,182,0.714,0.711,0.708,26175,375
"11567",221351,2006,1,0,"Rhodes College",NA,NA,451,272,179,363,141,222,0.816,0.805,0.788,27450,375
"11568",221351,2007,1,0,"Rhodes College",NA,NA,452,252,200,335,148,187,0.742,0.741,0.74,30342,357
"11569",221351,2008,1,0,"Rhodes College",NA,NA,475,276,199,353,143,210,0.761,0.743,0.719,32136,342
"11570",221351,2009,1,0,"Rhodes College",NA,NA,427,236,191,320,133,187,0.792,0.749,0.696,33400,297
"11571",221351,2010,1,0,"Rhodes College",NA,NA,500,307,193,382,139,243,0.792,0.764,0.72,34270,390
"11572",221519,1991,1,0,"THE UNIVERSITY OF THE SOUTH",NA,NA,327,159,168,236,118,118,0.742,0.722,0.702,13505,297
"11573",221519,1992,1,0,"UNIVERSITY OF THE SOUTH",NA,NA,338,171,167,230,111,119,0.696,0.68,0.665,14060,317
"11574",221519,1993,1,0,"UNIVERSITY OF THE SOUTH",NA,NA,322,157,165,250,131,119,0.758,0.776,0.794,14910,315
"11575",221519,1995,1,0,"UNIVERSITY OF THE SOUTH",NA,NA,370,197,173,275,120,155,0.787,0.743,0.694,16140,356
"11576",221519,1996,1,0,"UNIVERSITY OF THE SOUTH",NA,NA,365,205,160,264,115,149,0.727,0.723,0.719,16790,339
"11577",221519,1997,1,0,"UNIVERSITY OF THE SOUTH",NA,NA,364,195,169,285,130,155,0.795,0.783,0.769,17555,343
"11578",221519,1998,1,0,"UNIVERSITY OF THE SOUTH",NA,NA,382,198,184,284,124,160,0.808,0.743,0.674,18350,357
"11579",221519,1999,1,0,"UNIVERSITY OF THE SOUTH",NA,NA,391,227,164,308,123,185,0.815,0.788,0.75,18900,358
"11580",221519,2000,1,0,"UNIVERSITY OF THE SOUTH",NA,NA,385,203,182,276,126,150,0.739,0.717,0.692,19940,357
"11581",221519,2001,1,0,"UNIVERSITY OF THE SOUTH",NA,NA,353,185,168,259,117,142,0.768,0.734,0.696,21140,319
"11582",221519,2002,1,0,"UNIVERSITY OF THE SOUTH",NA,NA,368,198,170,270,116,154,0.778,0.734,0.682,22370,327
"11583",221519,2003,1,0,"SEWANEE-THE UNIVERSITY OF THE SOUTH",NA,NA,426,239,187,318,142,176,0.736,0.746,0.759,23930,382
"11584",221519,2004,1,0,"SEWANEE: THE UNIVERSITY OF THE SOUTH",NA,NA,397,207,190,309,142,167,0.807,0.778,0.747,25374,361
"11585",221519,2005,1,0,"Sewanee:  The University of the South",NA,NA,420,241,179,337,144,193,0.801,0.802,0.804,26874,383
"11586",221519,2006,1,0,"Sewanee:  The University of the South",NA,NA,412,202,210,305,150,155,0.767,0.74,0.714,28528,357
"11587",221519,2007,1,0,"Sewanee:  The University of the South",NA,NA,401,235,166,303,115,188,0.8,0.756,0.693,30438,352
"11588",221519,2008,1,0,"Sewanee:  The University of the South",NA,NA,409,199,210,310,149,161,0.809,0.758,0.71,32488,354
"11589",221519,2009,1,0,"Sewanee-The University of the South",NA,NA,401,203,198,296,140,156,0.768,0.738,0.707,33900,331
"11590",221519,2010,1,0,"Sewanee-The University of the South",NA,NA,401,216,185,317,138,179,0.829,0.791,0.746,35590,338
"11591",221731,1991,1,0,"TENNESSEE WESLEYAN COLLEGE",NA,NA,90,38,52,18,6,12,0.316,0.2,0.115,5564,74
"11592",221731,1992,1,0,"TENNESSEE WESLEYAN COLLEGE",NA,NA,74,20,54,13,3,10,0.5,0.176,0.056,5990,54
"11593",221731,1993,1,0,"TENNESSEE WESLEYAN COLLEGE",NA,NA,90,28,62,8,2,6,0.214,0.089,0.032,6430,66
"11594",221731,1995,1,0,"TENNESSEE WESLEYAN COLLEGE",NA,NA,90,49,41,29,7,22,0.449,0.322,0.171,6100,71
"11595",221731,1996,1,0,"TENNESSEE WESLEYAN COLLEGE",NA,NA,145,98,47,2,0,2,0.02,0.014,0,6300,132
"11596",221731,1997,1,0,"TENNESSEE WESLEYAN COLLEGE",NA,NA,96,61,35,35,12,23,0.377,0.365,0.343,6500,94
"11597",221731,1998,1,0,"TENNESSEE WESLEYAN COLLEGE",NA,NA,105,61,44,28,8,20,0.328,0.267,0.182,6950,102
"11598",221731,1999,1,0,"TENNESSEE WESLEYAN COLLEGE",NA,NA,140,93,47,22,3,19,0.204,0.157,0.064,7400,130
"11599",221731,2000,1,0,"TENNESSEE WESLEYAN COLLEGE",NA,NA,134,72,62,35,9,26,0.361,0.261,0.145,7900,121
"11600",221731,2001,1,0,"TENNESSEE WESLEYAN COLLEGE",NA,NA,119,69,50,33,9,24,0.348,0.277,0.18,8500,111
"11601",221731,2002,1,0,"TENNESSEE WESLEYAN COLLEGE",NA,NA,128,79,49,34,5,29,0.367,0.266,0.102,10000,112
"11602",221731,2003,1,0,"TENNESSEE WESLEYAN COLLEGE",NA,NA,106,63,43,33,4,29,0.46,0.311,0.093,11000,86
"11603",221731,2004,1,0,"TENNESSEE WESLEYAN COLLEGE",NA,NA,163,102,61,49,11,38,0.372,0.301,0.18,12000,124
"11604",221731,2005,1,0,"Tennessee Wesleyan College",NA,NA,167,100,67,52,14,38,0.38,0.311,0.209,13000,122
"11605",221731,2006,1,0,"Tennessee Wesleyan College",NA,NA,160,88,72,42,10,32,0.364,0.262,0.139,14000,132
"11606",221731,2007,1,0,"Tennessee Wesleyan College",NA,NA,153,86,67,49,19,30,0.349,0.32,0.284,15000,138
"11607",221731,2008,1,0,"Tennessee Wesleyan College",NA,NA,251,141,110,77,30,47,0.333,0.307,0.273,16500,215
"11608",221731,2009,1,0,"Tennessee Wesleyan College",NA,NA,246,163,83,75,22,53,0.325,0.305,0.265,18000,218
"11609",221731,2010,1,0,"Tennessee Wesleyan College",NA,NA,218,142,76,70,20,50,0.352,0.321,0.263,18500,180
"11610",221847,1991,1,0,"TENNESSEE TECHNOLOGICAL UNIVERSITY",NA,NA,1362,637,725,185,57,128,0.201,0.136,0.079,1485,1288
"11611",221847,1992,1,0,"TENNESSEE TECHNOLOGICAL UNIVERSITY",NA,NA,1381,584,797,267,113,154,0.264,0.193,0.142,1634,1294
"11612",221847,1993,1,0,"TENNESSEE TECHNOLOGICAL UNIVERSITY",NA,NA,1330,608,722,172,55,117,0.192,0.129,0.076,1710,1257
"11613",221847,1995,1,0,"TENNESSEE TECHNOLOGICAL UNIVERSITY",NA,NA,1113,513,600,130,37,93,0.181,0.117,0.062,1840,1052
"11614",221847,1996,1,0,"TENNESSEE TECHNOLOGICAL UNIVERSITY",NA,NA,1130,497,633,134,39,95,0.191,0.119,0.062,1890,1053
"11615",221847,1997,1,0,"TENNESSEE TECHNOLOGICAL UNIVERSITY",NA,NA,1089,466,623,100,33,67,0.144,0.092,0.053,2116,1005
"11616",221847,1998,1,0,"TENNESSEE TECHNOLOGICAL UNIVERSITY",NA,NA,1044,460,584,124,38,86,0.187,0.119,0.065,2306,956
"11617",221847,1999,1,0,"TENNESSEE TECHNOLOGICAL UNIVERSITY",NA,NA,1175,524,651,67,63,4,0.008,0.057,0.097,2020,1087
"11618",221847,2000,1,0,"TENNESSEE TECHNOLOGICAL UNIVERSITY",NA,NA,1305,609,696,241,85,156,0.256,0.185,0.122,2222,1183
"11619",221847,2001,1,0,"TENNESSEE TECHNOLOGICAL UNIVERSITY",NA,NA,1289,529,760,230,108,122,0.231,0.178,0.142,2556,1173
"11620",221847,2002,1,0,"TENNESSEE TECHNOLOGICAL UNIVERSITY",NA,NA,1376,585,791,251,99,152,0.26,0.182,0.125,2748,1228
"11621",221847,2003,1,0,"TENNESSEE TECHNOLOGICAL UNIVERSITY",NA,NA,1374,577,797,300,133,167,0.289,0.218,0.167,3132,1221
"11622",221847,2004,1,0,"TENNESSEE TECHNOLOGICAL UNIVERSITY",NA,NA,1476,611,865,312,122,190,0.311,0.211,0.141,3352,1258
"11623",221847,2005,1,0,"Tennessee Technological University",NA,NA,1409,623,786,321,121,200,0.321,0.228,0.154,3678,1239
"11624",221847,2006,1,0,"Tennessee Technological University",NA,NA,1515,653,862,301,127,174,0.266,0.199,0.147,3828,1337
"11625",221847,2007,1,0,"Tennessee Technological University",NA,NA,1649,730,919,371,157,214,0.293,0.225,0.171,4058,1469
"11626",221847,2008,1,0,"Tennessee Technological University",NA,NA,1659,736,923,379,165,214,0.291,0.228,0.179,4302,1414
"11627",221847,2009,1,0,"Tennessee Technological University",NA,NA,1879,884,995,476,181,295,0.334,0.253,0.182,4584,1676
"11628",221847,2010,1,0,"Tennessee Technological University",NA,NA,1898,846,1052,468,177,291,0.344,0.247,0.168,4824,1662
"11629",221892,1991,1,0,"TREVECCA NAZARENE COLLEGE",NA,NA,193,113,80,46,23,23,0.204,0.238,0.288,5720,154
"11630",221892,1992,1,0,"TREVECCA NAZARENE COLLEGE",NA,NA,180,96,84,27,10,17,0.177,0.15,0.119,6220,158
"11631",221892,1993,1,0,"TREVECCA NAZARENE COLLEGE",NA,NA,139,84,55,25,9,16,0.19,0.18,0.164,6721,125
"11632",221892,1995,1,0,"TREVECCA NAZARENE UNIVERSITY",NA,NA,214,113,101,43,14,29,0.257,0.201,0.139,7856,196
"11633",221892,1996,1,0,"TREVECCA NAZARENE UNIVERSITY",NA,NA,189,108,81,37,9,28,0.259,0.196,0.111,8644,166
"11634",221892,1997,1,0,"TREVECCA NAZARENE UNIVERSITY",NA,NA,179,100,79,30,9,21,0.21,0.168,0.114,8660,164
"11635",221892,1998,1,0,"TREVECCA NAZARENE UNIVERSITY",NA,NA,187,111,76,40,16,24,0.216,0.214,0.211,9536,176
"11636",221892,1999,1,0,"TREVECCA NAZARENE UNIVERSITY",NA,NA,192,119,73,43,14,29,0.244,0.224,0.192,10016,178
"11637",221892,2000,1,0,"TREVECCA NAZARENE UNIVERSITY",NA,NA,220,130,90,80,24,56,0.431,0.364,0.267,10528,198
"11638",221892,2001,1,0,"TREVECCA NAZARENE UNIVERSITY",NA,NA,216,112,104,82,36,46,0.411,0.38,0.346,10848,199
"11639",221892,2002,1,0,"TREVECCA NAZARENE UNIVERSITY",NA,NA,198,134,64,75,24,51,0.381,0.379,0.375,11390,180
"11640",221892,2003,1,0,"TREVECCA NAZARENE UNIVERSITY",NA,NA,219,126,93,82,31,51,0.405,0.374,0.333,11960,195
"11641",221892,2004,1,0,"TREVECCA NAZARENE UNIVERSITY",NA,NA,237,119,118,84,38,46,0.387,0.354,0.322,12792,208
"11642",221892,2005,1,0,"Trevecca Nazarene University",NA,NA,239,124,115,95,40,55,0.444,0.397,0.348,13432,207
"11643",221892,2006,1,0,"Trevecca Nazarene University",NA,NA,240,147,93,97,32,65,0.442,0.404,0.344,14774,211
"11644",221892,2007,1,0,"Trevecca Nazarene University",NA,NA,238,139,99,85,31,54,0.388,0.357,0.313,15512,209
"11645",221892,2008,1,0,"Trevecca Nazarene University",NA,NA,218,125,93,86,31,55,0.44,0.394,0.333,16288,183
"11646",221892,2009,1,0,"Trevecca Nazarene University",NA,NA,240,145,95,96,35,61,0.421,0.4,0.368,16776,203
"11647",221892,2010,1,0,"Trevecca Nazarene University",NA,NA,234,142,92,92,33,59,0.416,0.393,0.359,18318,180
"11648",222178,1991,1,0,"ABILENE CHRISTIAN UNIVERSITY",NA,NA,656,338,318,176,75,101,0.299,0.268,0.236,6510,546
"11649",222178,1992,1,0,"ABILENE CHRISTIAN UNIVERSITY",NA,NA,672,323,349,168,66,102,0.316,0.25,0.189,6900,436
"11650",222178,1993,1,0,"ABILENE CHRISTIAN UNIVERSITY",NA,NA,650,343,307,165,66,99,0.289,0.254,0.215,7170,441
"11651",222178,1995,1,0,"ABILENE CHRISTIAN UNIVERSITY",NA,NA,917,506,411,250,93,157,0.31,0.273,0.226,7800,771
"11652",222178,1996,1,0,"ABILENE CHRISTIAN UNIVERSITY",NA,NA,898,478,420,241,97,144,0.301,0.268,0.231,8660,761
"11653",222178,1997,1,0,"ABILENE CHRISTIAN UNIVERSITY",NA,NA,964,530,434,259,97,162,0.306,0.269,0.224,9180,813
"11654",222178,1998,1,0,"ABILENE CHRISTIAN UNIVERSITY",NA,NA,988,541,447,280,110,170,0.314,0.283,0.246,9710,857
"11655",222178,1999,1,0,"ABILENE CHRISTIAN UNIVERSITY",NA,NA,924,533,391,335,120,215,0.403,0.363,0.307,9810,749
"11656",222178,2000,1,0,"ABILENE CHRISTIAN UNIVERSITY",NA,NA,1023,565,458,355,139,216,0.382,0.347,0.303,10410,856
"11657",222178,2001,1,0,"ABILENE CHRISTIAN UNIVERSITY",NA,NA,1031,598,433,387,127,260,0.435,0.375,0.293,11130,845
"11658",222178,2002,1,0,"ABILENE CHRISTIAN UNIVERSITY",NA,NA,942,536,406,360,112,248,0.463,0.382,0.276,11910,761
"11659",222178,2003,1,0,"ABILENE CHRISTIAN UNIVERSITY",NA,NA,948,489,459,369,125,244,0.499,0.389,0.272,12750,763
"11660",222178,2004,1,0,"ABILENE CHRISTIAN UNIVERSITY",NA,NA,1018,553,465,377,127,250,0.452,0.37,0.273,13650,808
"11661",222178,2005,1,0,"Abilene Christian University",NA,NA,1030,560,470,393,150,243,0.434,0.382,0.319,14610,821
"11662",222178,2006,1,0,"Abilene Christian University",NA,NA,961,526,435,394,147,247,0.47,0.41,0.338,15630,777
"11663",222178,2007,1,0,"Abilene Christian University",NA,NA,887,476,411,324,113,211,0.443,0.365,0.275,16710,683
"11664",222178,2008,1,0,"Abilene Christian University",NA,NA,971,518,453,434,167,267,0.515,0.447,0.369,17880,761
"11665",222178,2009,1,0,"Abilene Christian University",NA,NA,979,520,459,406,136,270,0.519,0.415,0.296,19200,730
"11666",222178,2010,1,0,"Abilene Christian University",NA,NA,977,526,451,465,194,271,0.515,0.476,0.43,21510,785
"11667",222983,1991,1,0,"AUSTIN COLLEGE",NA,NA,307,173,134,187,77,110,0.636,0.609,0.575,9465,251
"11668",222983,1992,1,0,"AUSTIN COLLEGE",NA,NA,289,144,145,165,76,89,0.618,0.571,0.524,10085,219
"11669",222983,1993,1,0,"AUSTIN COLLEGE",NA,NA,294,175,119,165,57,108,0.617,0.561,0.479,10740,218
"11670",222983,1995,1,0,"AUSTIN COLLEGE",NA,NA,293,155,138,195,90,105,0.677,0.666,0.652,12070,215
"11671",222983,1996,1,0,"AUSTIN COLLEGE",NA,NA,344,181,163,254,106,148,0.818,0.738,0.65,12675,289
"11672",222983,1997,1,0,"AUSTIN COLLEGE",NA,NA,317,150,167,215,103,112,0.747,0.678,0.617,13435,246
"11673",222983,1998,1,0,"AUSTIN COLLEGE",NA,NA,347,190,157,242,97,145,0.763,0.697,0.618,14205,262
"11674",222983,1999,1,0,"AUSTIN COLLEGE",NA,NA,324,188,136,222,74,148,0.787,0.685,0.544,14785,254
"11675",222983,2000,1,0,"AUSTIN COLLEGE",NA,NA,347,186,161,249,106,143,0.769,0.718,0.658,15177,280
"11676",222983,2001,1,0,"AUSTIN COLLEGE",NA,NA,312,174,138,220,91,129,0.741,0.705,0.659,15792,235
"11677",222983,2002,1,0,"AUSTIN COLLEGE",NA,NA,347,191,156,245,104,141,0.738,0.706,0.667,16392,261
"11678",222983,2003,1,0,"AUSTIN COLLEGE",NA,NA,338,193,145,228,86,142,0.736,0.675,0.593,17740,257
"11679",222983,2004,1,0,"AUSTIN COLLEGE",NA,NA,370,193,177,274,121,153,0.793,0.741,0.684,18980,283
"11680",222983,2005,1,0,"Austin College",NA,NA,347,171,176,239,103,136,0.795,0.689,0.585,20310,253
"11681",222983,2006,1,0,"Austin College",NA,NA,340,175,165,251,113,138,0.789,0.738,0.685,23355,241
"11682",222983,2007,1,0,"Austin College",NA,NA,333,174,159,223,91,132,0.759,0.67,0.572,24760,233
"11683",222983,2008,1,0,"Austin College",NA,NA,318,191,127,229,88,141,0.738,0.72,0.693,26370,203
"11684",222983,2009,1,0,"Austin College",NA,NA,413,213,200,295,129,166,0.779,0.714,0.645,27690,260
"11685",222983,2010,1,0,"Austin College",NA,NA,318,173,145,220,90,130,0.751,0.692,0.621,29075,195
"11686",223232,1991,1,0,"BAYLOR UNIVERSITY",NA,NA,2150,1240,910,947,347,600,0.484,0.44,0.381,6110,1763
"11687",223232,1992,1,0,"BAYLOR UNIVERSITY",NA,NA,2363,1400,963,930,336,594,0.424,0.394,0.349,6590,1879
"11688",223232,1993,1,0,"BAYLOR UNIVERSITY",NA,NA,2426,1420,1006,978,350,628,0.442,0.403,0.348,7070,1958
"11689",223232,1995,1,0,"BAYLOR UNIVERSITY",NA,NA,2329,1390,939,1004,337,667,0.48,0.431,0.359,8444,1796
"11690",223232,1996,1,0,"BAYLOR UNIVERSITY",NA,NA,2463,1444,1019,1062,350,712,0.493,0.431,0.343,8806,1895
"11691",223232,1997,1,0,"BAYLOR UNIVERSITY",NA,NA,2404,1416,988,967,300,667,0.471,0.402,0.304,9478,1856
"11692",223232,1998,1,0,"BAYLOR UNIVERSITY",NA,NA,2933,1712,1221,1261,405,856,0.5,0.43,0.332,10316,2204
"11693",223232,1999,1,0,"BAYLOR UNIVERSITY",NA,NA,2766,1668,1098,1272,379,893,0.535,0.46,0.345,9870,2107
"11694",223232,2000,1,0,"BAYLOR UNIVERSITY",NA,NA,2822,1666,1156,1388,442,946,0.568,0.492,0.382,10650,2229
"11695",223232,2001,1,0,"BAYLOR UNIVERSITY",NA,NA,2790,1664,1126,1340,434,906,0.545,0.48,0.385,11370,2198
"11696",223232,2002,1,0,"BAYLOR UNIVERSITY",NA,NA,2601,1558,1043,1323,439,884,0.567,0.509,0.421,15700,1992
"11697",223232,2003,1,0,"BAYLOR UNIVERSITY",NA,NA,2667,1673,994,1266,347,919,0.549,0.475,0.349,16750,1945
"11698",223232,2004,1,0,"BAYLOR UNIVERSITY",NA,NA,2772,1674,1098,1398,488,910,0.544,0.504,0.444,17900,1924
"11699",223232,2005,1,0,"Baylor University",NA,NA,3158,1867,1291,1641,582,1059,0.567,0.52,0.451,19050,2156
"11700",223232,2006,1,0,"Baylor University",NA,NA,2775,1713,1062,1550,494,1056,0.617,0.559,0.465,20574,2065
"11701",223232,2007,1,0,"Baylor University",NA,NA,2721,1618,1103,1556,552,1004,0.62,0.572,0.5,22220,1897
"11702",223232,2008,1,0,"Baylor University",NA,NA,3054,1801,1253,1669,594,1075,0.597,0.546,0.474,23664,2041
"11703",223232,2009,1,0,"Baylor University",NA,NA,3097,1825,1272,1672,592,1080,0.592,0.54,0.465,25320,1947
"11704",223232,2010,1,0,"Baylor University",NA,NA,3254,1913,1341,1897,668,1229,0.642,0.583,0.498,26966,2050
"11705",224004,1991,1,0,"CONCORDIA LUTHERAN COLLEGE",NA,NA,116,72,44,26,7,19,0.264,0.224,0.159,6090,94
"11706",224004,1992,1,0,"CONCORDIA LUTHERAN COLLEGE",NA,NA,115,65,50,16,2,14,0.215,0.139,0.04,6360,95
"11707",224004,1993,1,0,"CONCORDIA LUTHERAN COLLEGE",NA,NA,107,62,45,26,7,19,0.306,0.243,0.156,6760,87
"11708",224004,1995,1,0,"CONCORDIA UNIVERSITY AT AUSTIN",NA,NA,90,55,35,18,5,13,0.236,0.2,0.143,7980,73
"11709",224004,1996,1,0,"CONCORDIA UNIVERSITY AT AUSTIN",NA,NA,121,74,47,42,12,30,0.405,0.347,0.255,8680,101
"11710",224004,1997,1,0,"CONCORDIA UNIVERSITY AT AUSTIN",NA,NA,125,57,68,15,7,8,0.14,0.12,0.103,9500,89
"11711",224004,1998,1,0,"CONCORDIA UNIVERSITY AT AUSTIN",NA,NA,127,75,52,23,8,15,0.2,0.181,0.154,10500,99
"11712",224004,1999,1,0,"CONCORDIA UNIVERSITY AT AUSTIN",NA,NA,134,66,68,15,10,5,0.076,0.112,0.147,11500,93
"11713",224004,2000,1,0,"CONCORDIA UNIVERSITY AT AUSTIN",NA,NA,130,73,57,24,8,16,0.219,0.185,0.14,12500,88
"11714",224004,2001,1,0,"CONCORDIA UNIVERSITY AT AUSTIN",NA,NA,189,104,85,28,10,18,0.173,0.148,0.118,13120,139
"11715",224004,2002,1,0,"CONCORDIA UNIVERSITY AT AUSTIN",NA,NA,166,85,81,12,9,3,0.035,0.072,0.111,14300,120
"11716",224004,2003,1,0,"CONCORDIA UNIVERSITY AT AUSTIN",NA,NA,154,83,71,26,13,13,0.157,0.169,0.183,15300,101
"11717",224004,2004,1,0,"CONCORDIA UNIVERSITY AT AUSTIN",NA,NA,149,84,65,21,10,11,0.131,0.141,0.154,16050,98
"11718",224004,2005,1,0,"Concordia University at Austin",NA,NA,196,96,100,40,12,28,0.292,0.204,0.12,16740,136
"11719",224004,2006,1,0,"Concordia University at Austin",NA,NA,191,89,102,37,16,21,0.236,0.194,0.157,17800,133
"11720",224004,2007,1,0,"Concordia University Texas",NA,NA,160,87,73,29,9,20,0.23,0.181,0.123,18600,100
"11721",224004,2008,1,0,"Concordia University Texas",NA,NA,229,129,100,44,16,28,0.217,0.192,0.16,20100,144
"11722",224004,2009,1,0,"Concordia University Texas",NA,NA,225,122,103,58,22,36,0.295,0.258,0.214,20800,146
"11723",224004,2010,1,0,"Concordia University-Texas",NA,NA,235,157,78,54,11,43,0.274,0.23,0.141,21700,137
"11724",224323,1991,1,0,"UNIVERSITY OF DALLAS",NA,NA,280,163,117,138,50,88,0.54,0.493,0.427,8600,209
"11725",224323,1992,1,0,"UNIVERSITY OF DALLAS",NA,NA,251,137,114,114,42,72,0.525,0.454,0.368,9400,169
"11726",224323,1993,1,0,"UNIVERSITY OF DALLAS",NA,NA,246,138,108,118,56,62,0.449,0.48,0.519,10200,171
"11727",224323,1995,1,0,"UNIVERSITY OF DALLAS",NA,NA,244,146,98,134,58,76,0.52,0.549,0.592,11375,183
"11728",224323,1996,1,0,"UNIVERSITY OF DALLAS",NA,NA,251,157,94,141,46,95,0.605,0.562,0.489,12113,190
"11729",224323,1997,1,0,"UNIVERSITY OF DALLAS",NA,NA,261,160,101,136,47,89,0.556,0.521,0.465,12790,175
"11730",224323,1998,1,0,"UNIVERSITY OF DALLAS",NA,NA,291,188,103,207,67,140,0.745,0.711,0.65,13672,217
"11731",224323,1999,1,0,"UNIVERSITY OF DALLAS",NA,NA,309,191,118,188,67,121,0.634,0.608,0.568,14354,206
"11732",224323,2000,1,0,"UNIVERSITY OF DALLAS",NA,NA,279,168,111,167,59,108,0.643,0.599,0.532,15028,184
"11733",224323,2001,1,0,"UNIVERSITY OF DALLAS",NA,NA,310,180,130,170,77,93,0.517,0.548,0.592,15824,192
"11734",224323,2002,1,0,"UNIVERSITY OF DALLAS",NA,NA,307,185,122,142,52,90,0.486,0.463,0.426,16694,207
"11735",224323,2003,1,0,"UNIVERSITY OF DALLAS",NA,NA,299,189,110,185,58,127,0.672,0.619,0.527,17612,190
"11736",224323,2004,1,0,"UNIVERSITY OF DALLAS",NA,NA,243,126,117,153,65,88,0.698,0.63,0.556,18582,158
"11737",224323,2005,1,0,"University of Dallas",NA,NA,256,165,91,160,53,107,0.648,0.625,0.582,19604,200
"11738",224323,2006,1,0,"University of Dallas",NA,NA,315,169,146,189,82,107,0.633,0.6,0.562,20780,209
"11739",224323,2007,1,0,"University of Dallas",NA,NA,362,200,162,201,85,116,0.58,0.555,0.525,21819,245
"11740",224323,2008,1,0,"University of Dallas",NA,NA,341,168,173,216,104,112,0.667,0.633,0.601,23250,236
"11741",224323,2009,1,0,"University of Dallas",NA,NA,319,169,150,212,96,116,0.686,0.665,0.64,24646,179
"11742",224323,2010,1,0,"University of Dallas",NA,NA,375,207,168,223,89,134,0.647,0.595,0.53,27815,257
"11743",225432,1991,1,0,"UNIVERSITY OF HOUSTON-DOWNTOWN",NA,NA,570,299,271,10,6,4,0.013,0.018,0.022,1150,95
"11744",225432,1992,1,0,"UNIVERSITY OF HOUSTON-DOWNTOWN",NA,NA,540,275,265,3,1,2,0.007,0.006,0.004,1358,85
"11745",225432,1993,1,0,"UNIVERSITY OF HOUSTON-DOWNTOWN",NA,NA,666,362,304,8,2,6,0.017,0.012,0.007,1506,103
"11746",225432,1995,1,0,"UNIVERSITY OF HOUSTON-DOWNTOWN",NA,NA,624,351,273,10,3,7,0.02,0.016,0.011,1646,86
"11747",225432,1996,1,0,"UNIVERSITY OF HOUSTON-DOWNTOWN",NA,NA,638,385,253,13,5,8,0.021,0.02,0.02,1866,69
"11748",225432,1997,1,0,"UNIVERSITY OF HOUSTON-DOWNTOWN",NA,NA,679,374,305,14,2,12,0.032,0.021,0.007,2046,85
"11749",225432,1998,1,0,"UNIVERSITY OF HOUSTON-DOWNTOWN",NA,NA,696,406,290,8,3,5,0.012,0.011,0.01,2106,89
"11750",225432,1999,1,0,"UNIVERSITY OF HOUSTON-DOWNTOWN",NA,NA,729,418,311,10,3,7,0.017,0.014,0.01,1140,58
"11751",225432,2000,1,0,"UNIVERSITY OF HOUSTON-DOWNTOWN",NA,NA,794,437,357,16,6,10,0.023,0.02,0.017,1200,94
"11752",225432,2001,1,0,"UNIVERSITY OF HOUSTON-DOWNTOWN",NA,NA,869,481,388,19,5,14,0.029,0.022,0.013,1200,97
"11753",225432,2002,1,0,"UNIVERSITY OF HOUSTON-DOWNTOWN",NA,NA,905,498,407,14,4,10,0.02,0.015,0.01,2220,76
"11754",225432,2003,1,0,"UNIVERSITY OF HOUSTON-DOWNTOWN",NA,NA,1012,559,453,16,5,11,0.02,0.016,0.011,2088,115
"11755",225432,2004,1,0,"UNIVERSITY OF HOUSTON-DOWNTOWN",NA,NA,964,541,423,10,5,5,0.009,0.01,0.012,3170,99
"11756",225432,2005,1,0,"University of Houston-Downtown",NA,NA,889,487,402,20,8,12,0.025,0.022,0.02,2700,86
"11757",225432,2006,1,0,"University of Houston-Downtown",NA,NA,840,452,388,12,7,5,0.011,0.014,0.018,2898,79
"11758",225432,2007,1,0,"University of Houston-Downtown",NA,NA,831,438,393,22,7,15,0.034,0.026,0.018,3240,73
"11759",225432,2008,1,0,"University of Houston-Downtown",NA,NA,699,400,299,20,9,11,0.028,0.029,0.03,3240,71
"11760",225432,2009,1,0,"University of Houston-Downtown",NA,NA,722,378,344,10,6,4,0.011,0.014,0.017,3360,71
"11761",225432,2010,1,0,"University of Houston-Downtown",NA,NA,824,453,371,11,3,8,0.018,0.013,0.008,3552,51
"11762",225548,1991,1,0,"HOWARD PAYNE UNIVERSITY",NA,NA,266,125,141,42,14,28,0.224,0.158,0.099,4160,203
"11763",225548,1992,1,0,"HOWARD PAYNE UNIVERSITY",NA,NA,265,123,142,60,31,29,0.236,0.226,0.218,4430,219
"11764",225548,1993,1,0,"HOWARD PAYNE UNIVERSITY",NA,NA,322,133,189,56,31,25,0.188,0.174,0.164,5070,259
"11765",225548,1995,1,0,"HOWARD PAYNE UNIVERSITY",NA,NA,325,170,155,82,28,54,0.318,0.252,0.181,5940,267
"11766",225548,1996,1,0,"HOWARD PAYNE UNIVERSITY",NA,NA,335,151,184,83,27,56,0.371,0.248,0.147,6450,265
"11767",225548,1997,1,0,"HOWARD PAYNE UNIVERSITY",NA,NA,323,112,211,66,32,34,0.304,0.204,0.152,7109,237
"11768",225548,1998,1,0,"HOWARD PAYNE UNIVERSITY",NA,NA,315,143,172,66,25,41,0.287,0.21,0.145,8460,255
"11769",225548,1999,1,0,"HOWARD PAYNE UNIVERSITY",NA,NA,286,137,149,10,3,7,0.051,0.035,0.02,8400,228
"11770",225548,2000,1,0,"HOWARD PAYNE UNIVERSITY",NA,NA,355,175,180,82,28,54,0.309,0.231,0.156,8400,301
"11771",225548,2001,1,0,"HOWARD PAYNE UNIVERSITY",NA,NA,319,152,167,80,34,46,0.303,0.251,0.204,9200,241
"11772",225548,2002,1,0,"HOWARD PAYNE UNIVERSITY",NA,NA,325,157,168,78,24,54,0.344,0.24,0.143,9700,241
"11773",225548,2003,1,0,"HOWARD PAYNE UNIVERSITY",NA,NA,293,136,157,76,27,49,0.36,0.259,0.172,10300,217
"11774",225548,2004,1,0,"HOWARD PAYNE UNIVERSITY",NA,NA,285,126,159,62,29,33,0.262,0.218,0.182,11000,209
"11775",225548,2005,1,0,"Howard Payne University",NA,NA,281,146,135,104,41,63,0.432,0.37,0.304,11500,206
"11776",225548,2006,1,0,"Howard Payne University",NA,NA,318,130,188,109,46,63,0.485,0.343,0.245,13440,238
"11777",225548,2007,1,0,"Howard Payne University",NA,NA,255,103,152,77,31,46,0.447,0.302,0.204,15000,159
"11778",225548,2008,1,0,"Howard Payne University",NA,NA,304,128,176,107,48,59,0.461,0.352,0.273,16350,222
"11779",225548,2009,1,0,"Howard Payne University",NA,NA,209,84,125,74,31,43,0.512,0.354,0.248,17600,126
"11780",225548,2010,1,0,"Howard Payne University",NA,NA,318,149,169,88,32,56,0.376,0.277,0.189,18850,224
"11781",225627,1991,1,0,"INCARNATE WORD COLLEGE",NA,NA,330,246,84,35,4,31,0.126,0.106,0.048,7200,97
"11782",225627,1992,1,0,"INCARNATE WORD COLLEGE",NA,NA,310,224,86,33,4,29,0.13,0.106,0.047,7800,82
"11783",225627,1993,1,0,"INCARNATE WORD COLLEGE",NA,NA,297,202,95,29,8,21,0.104,0.098,0.084,8250,81
"11784",225627,1995,1,0,"UNIVERSITY OF THE INCARNATE WORD",NA,NA,370,259,111,50,11,39,0.151,0.135,0.099,9690,101
"11785",225627,1996,1,0,"UNIVERSITY OF THE INCARNATE WORD",NA,NA,404,288,116,46,6,40,0.139,0.114,0.052,10150,106
"11786",225627,1997,1,0,"UNIVERSITY OF THE INCARNATE WORD",NA,NA,341,233,108,47,10,37,0.159,0.138,0.093,10600,91
"11787",225627,1998,1,0,"UNIVERSITY OF THE INCARNATE WORD",NA,NA,375,265,110,59,10,49,0.185,0.157,0.091,11200,101
"11788",225627,1999,1,0,"UNIVERSITY OF THE INCARNATE WORD",NA,NA,380,253,127,51,9,42,0.166,0.134,0.071,11850,87
"11789",225627,2000,1,0,"UNIVERSITY OF THE INCARNATE WORD",NA,NA,388,253,135,77,20,57,0.225,0.198,0.148,12470,102
"11790",225627,2001,1,0,"UNIVERSITY OF THE INCARNATE WORD",NA,NA,416,285,131,66,10,56,0.196,0.159,0.076,13220,93
"11791",225627,2002,1,0,"UNIVERSITY OF THE INCARNATE WORD",NA,NA,395,244,151,58,18,40,0.164,0.147,0.119,14000,105
"11792",225627,2003,1,0,"UNIVERSITY OF THE INCARNATE WORD",NA,NA,396,280,116,70,18,52,0.186,0.177,0.155,14800,95
"11793",225627,2004,1,0,"UNIVERSITY OF THE INCARNATE WORD",NA,NA,474,331,143,61,12,49,0.148,0.129,0.084,15600,107
"11794",225627,2005,1,0,"University of the Incarnate Word",NA,NA,571,394,177,114,23,91,0.231,0.2,0.13,16500,131
"11795",225627,2006,1,0,"University of the Incarnate Word",NA,NA,613,439,174,119,23,96,0.219,0.194,0.132,17400,129
"11796",225627,2007,1,0,"University of the Incarnate Word",NA,NA,715,463,252,138,41,97,0.21,0.193,0.163,18400,146
"11797",225627,2008,1,0,"University of the Incarnate Word",NA,NA,880,553,327,157,39,118,0.213,0.178,0.119,19400,193
"11798",225627,2009,1,0,"University of the Incarnate Word",NA,NA,717,469,248,178,49,129,0.275,0.248,0.198,20400,156
"11799",225627,2010,1,0,"University of the Incarnate Word",NA,NA,871,571,300,257,70,187,0.328,0.295,0.233,21000,169
"11800",226231,1991,1,0,"LETOURNEAU UNIVERSITY",NA,NA,207,26,181,51,44,7,0.269,0.246,0.243,7350,181
"11801",226231,1992,1,0,"LETOURNEAU UNIVERSITY",NA,NA,182,26,156,37,30,7,0.269,0.203,0.192,7940,157
"11802",226231,1993,1,0,"LETOURNEAU UNIVERSITY",NA,NA,202,33,169,46,36,10,0.303,0.228,0.213,8460,180
"11803",226231,1995,1,0,"LETOURNEAU UNIVERSITY",NA,NA,218,66,152,68,42,26,0.394,0.312,0.276,9430,195
"11804",226231,1996,1,0,"LETOURNEAU UNIVERSITY",NA,NA,163,35,128,26,19,7,0.2,0.16,0.148,10220,146
"11805",226231,1997,1,0,"LETOURNEAU UNIVERSITY",NA,NA,209,50,159,65,45,20,0.4,0.311,0.283,10724,182
"11806",226231,1998,1,0,"LETOURNEAU UNIVERSITY",NA,NA,257,55,202,72,48,24,0.436,0.28,0.238,11264,236
"11807",226231,1999,1,0,"LETOURNEAU UNIVERSITY",NA,NA,259,58,201,75,52,23,0.397,0.29,0.259,11570,229
"11808",226231,2000,1,0,"LETOURNEAU UNIVERSITY",NA,NA,286,79,207,96,58,38,0.481,0.336,0.28,12090,261
"11809",226231,2001,1,0,"LETOURNEAU UNIVERSITY",NA,NA,242,66,176,74,47,27,0.409,0.306,0.267,12670,211
"11810",226231,2002,1,0,"LETOURNEAU UNIVERSITY",NA,NA,243,55,188,68,46,22,0.4,0.28,0.245,13240,214
"11811",226231,2003,1,0,"LETOURNEAU UNIVERSITY",NA,NA,333,94,239,93,52,41,0.436,0.279,0.218,14010,294
"11812",226231,2004,1,0,"LETOURNEAU UNIVERSITY",NA,NA,327,92,235,98,58,40,0.435,0.3,0.247,14850,272
"11813",226231,2005,1,0,"LeTourneau University",NA,NA,317,74,243,95,66,29,0.392,0.3,0.272,15710,276
"11814",226231,2006,1,0,"LeTourneau University",NA,NA,309,88,221,130,75,55,0.625,0.421,0.339,16720,271
"11815",226231,2007,1,0,"LeTourneau University",NA,NA,322,97,225,108,71,37,0.381,0.335,0.316,17710,263
"11816",226231,2008,1,0,"LeTourneau University",NA,NA,340,106,234,118,76,42,0.396,0.347,0.325,18940,283
"11817",226231,2009,1,0,"LeTourneau University",NA,NA,341,109,232,123,83,40,0.367,0.361,0.358,20100,265
"11818",226231,2010,1,0,"LeTourneau University",NA,NA,425,169,256,152,85,67,0.396,0.358,0.332,21510,244
"11819",226833,1991,1,0,"MIDWESTERN STATE UNIVERSITY",NA,NA,708,332,376,14,8,6,0.018,0.02,0.021,1359,569
"11820",226833,1992,1,0,"MIDWESTERN STATE UNIVERSITY",NA,NA,641,313,328,43,16,27,0.086,0.067,0.049,1474,509
"11821",226833,1993,1,0,"MIDWESTERN STATE UNIVERSITY",NA,NA,553,284,269,49,23,26,0.092,0.089,0.086,1666,440
"11822",226833,1995,1,0,"MIDWESTERN STATE UNIVERSITY",NA,NA,578,276,302,49,16,33,0.12,0.085,0.053,1870,458
"11823",226833,1996,1,0,"MIDWESTERN STATE UNIVERSITY",NA,NA,602,312,290,52,17,35,0.112,0.086,0.059,1477,482
"11824",226833,1997,1,0,"MIDWESTERN STATE UNIVERSITY",NA,NA,668,329,339,37,13,24,0.073,0.055,0.038,1498,505
"11825",226833,1998,1,0,"MIDWESTERN STATE UNIVERSITY",NA,NA,685,350,335,74,26,48,0.137,0.108,0.078,1789,531
"11826",226833,1999,1,0,"MIDWESTERN STATE UNIVERSITY",NA,NA,732,409,323,67,21,46,0.112,0.092,0.065,1140,550
"11827",226833,2000,1,0,"MIDWESTERN STATE UNIVERSITY",NA,NA,696,355,341,64,33,31,0.087,0.092,0.097,1200,495
"11828",226833,2001,1,0,"MIDWESTERN STATE UNIVERSITY",NA,NA,668,376,292,69,22,47,0.125,0.103,0.075,1260,480
"11829",226833,2002,1,0,"MIDWESTERN STATE UNIVERSITY",NA,NA,624,327,297,66,23,43,0.132,0.106,0.077,1320,461
"11830",226833,2003,1,0,"MIDWESTERN STATE UNIVERSITY",NA,NA,613,302,311,41,18,23,0.076,0.067,0.058,1380,438
"11831",226833,2004,1,0,"MIDWESTERN STATE UNIVERSITY",NA,NA,611,301,310,35,13,22,0.073,0.057,0.042,1152,391
"11832",226833,2005,1,0,"Midwestern State University",NA,NA,818,447,371,100,27,73,0.163,0.122,0.073,1200,544
"11833",226833,2006,1,0,"Midwestern State University",NA,NA,657,355,302,108,33,75,0.211,0.164,0.109,1200,481
"11834",226833,2007,1,0,"Midwestern State University",NA,NA,735,384,351,118,43,75,0.195,0.161,0.123,1200,542
"11835",226833,2008,1,0,"Midwestern State University",NA,NA,706,405,301,119,44,75,0.185,0.169,0.146,1200,490
"11836",226833,2009,1,0,"Midwestern State University",NA,NA,701,386,315,139,40,99,0.256,0.198,0.127,1200,487
"11837",226833,2010,1,0,"Midwestern State University",NA,NA,742,380,362,141,39,102,0.268,0.19,0.108,1200,511
"11838",227216,1991,1,0,"UNIVERSITY OF NORTH TEXAS",NA,NA,2085,1169,916,210,62,148,0.127,0.101,0.068,1046,1655
"11839",227216,1992,1,0,"UNIVERSITY OF NORTH TEXAS",NA,NA,1794,1014,780,191,41,150,0.148,0.106,0.053,1196,1382
"11840",227216,1993,1,0,"UNIVERSITY OF NORTH TEXAS",NA,NA,1872,1045,827,211,63,148,0.142,0.113,0.076,1273,1457
"11841",227216,1995,1,0,"UNIVERSITY OF NORTH TEXAS",NA,NA,2134,1180,954,201,50,151,0.128,0.094,0.052,1439,1597
"11842",227216,1996,1,0,"UNIVERSITY OF NORTH TEXAS",NA,NA,2268,1304,964,256,70,186,0.143,0.113,0.073,1705,1630
"11843",227216,1997,1,0,"UNIVERSITY OF NORTH TEXAS",NA,NA,2292,1310,982,303,83,220,0.168,0.132,0.085,1776,1646
"11844",227216,1998,1,0,"UNIVERSITY OF NORTH TEXAS",NA,NA,2449,1400,1049,363,105,258,0.184,0.148,0.1,2075,1772
"11845",227216,1999,1,0,"UNIVERSITY OF NORTH TEXAS",NA,NA,2687,1550,1137,410,111,299,0.193,0.153,0.098,1656,1903
"11846",227216,2000,1,0,"UNIVERSITY OF NORTH TEXAS",NA,NA,2841,1664,1177,515,142,373,0.224,0.181,0.121,1824,2003
"11847",227216,2001,1,0,"UNIVERSITY OF NORTH TEXAS",NA,NA,2803,1665,1138,466,146,320,0.192,0.166,0.128,2016,2005
"11848",227216,2002,1,0,"UNIVERSITY OF NORTH TEXAS",NA,NA,2912,1683,1229,523,147,376,0.223,0.18,0.12,2288,2044
"11849",227216,2003,1,0,"UNIVERSITY OF NORTH TEXAS",NA,NA,3320,1945,1375,632,194,438,0.225,0.19,0.141,2392,2310
"11850",227216,2004,1,0,"UNIVERSITY OF NORTH TEXAS",NA,NA,3216,1872,1344,611,180,431,0.23,0.19,0.134,3444,2234
"11851",227216,2005,1,0,"University of North Texas",NA,NA,3557,2008,1549,760,214,546,0.272,0.214,0.138,3144,2363
"11852",227216,2006,1,0,"University of North Texas",NA,NA,3599,2039,1560,784,252,532,0.261,0.218,0.162,3372,2385
"11853",227216,2007,1,0,"University of North Texas",NA,NA,3495,1996,1499,862,254,608,0.305,0.247,0.169,4035,2236
"11854",227216,2008,1,0,"University of North Texas",NA,NA,3442,1928,1514,891,271,620,0.322,0.259,0.179,4528,2187
"11855",227216,2009,1,0,"University of North Texas",NA,NA,3255,1832,1423,881,271,610,0.333,0.271,0.19,5060,1888
"11856",227216,2010,1,0,"University of North Texas",NA,NA,3534,1908,1626,1009,345,664,0.348,0.286,0.212,5363,1857
"11857",227331,1991,1,0,"OUR LADY OF THE LAKE UNIVERSITY SAN ANTONIO",NA,NA,361,278,83,38,6,32,0.115,0.105,0.072,6472,34
"11858",227331,1992,1,0,"OUR LADY OF THE LAKE UNIVERSITY SAN ANTONIO",NA,NA,315,241,74,40,8,32,0.133,0.127,0.108,7564,39
"11859",227331,1993,1,0,"OUR LADY OF THE LAKE UNIVERSITY-SAN ANTONIO",NA,NA,291,224,67,29,0,29,0.13,0.1,0,8160,31
"11860",227331,1995,1,0,"OUR LADY OF THE LAKE UNIVERSITY-SAN ANTONIO",NA,NA,258,189,69,34,8,26,0.138,0.132,0.116,9134,24
"11861",227331,1996,1,0,"OUR LADY OF THE LAKE UNIVERSITY-SAN ANTONIO",NA,NA,355,257,98,66,12,54,0.21,0.186,0.122,9674,47
"11862",227331,1997,1,0,"OUR LADY OF THE LAKE UNIVERSITY-SAN ANTONIO",NA,NA,372,293,79,59,10,49,0.167,0.159,0.127,10366,58
"11863",227331,1998,1,0,"OUR LADY OF THE LAKE UNIVERSITY-SAN ANTONIO",NA,NA,310,251,59,50,2,48,0.191,0.161,0.034,10872,49
"11864",227331,1999,1,0,"OUR LADY OF THE LAKE UNIVERSITY-SAN ANTONIO",NA,NA,308,241,67,44,10,34,0.141,0.143,0.149,11150,36
"11865",227331,2000,1,0,"OUR LADY OF THE LAKE UNIVERSITY-SAN ANTONIO",NA,NA,267,205,62,42,7,35,0.171,0.157,0.113,11708,24
"11866",227331,2001,1,0,"OUR LADY OF THE LAKE UNIVERSITY-SAN ANTONIO",NA,NA,401,323,78,49,7,42,0.13,0.122,0.09,12528,37
"11867",227331,2002,1,0,"OUR LADY OF THE LAKE UNIVERSITY-SAN ANTONIO",NA,NA,331,241,90,55,11,44,0.183,0.166,0.122,13404,27
"11868",227331,2003,1,0,"OUR LADY OF THE LAKE UNIVERSITY-SAN ANTONIO",NA,NA,322,238,84,60,10,50,0.21,0.186,0.119,14650,53
"11869",227331,2004,1,0,"OUR LADY OF THE LAKE UNIVERSITY-SAN ANTONIO",NA,NA,216,171,45,30,3,27,0.158,0.139,0.067,15594,28
"11870",227331,2005,1,0,"Our Lady of the Lake University-San Antonio",NA,NA,269,204,65,1,1,0,0,0.004,0.015,17048,28
"11871",227331,2006,1,0,"Our Lady of the Lake University-San Antonio",NA,NA,262,195,67,27,6,21,0.108,0.103,0.09,17900,24
"11872",227331,2007,1,0,"Our Lady of the Lake University-San Antonio",NA,NA,283,189,94,51,13,38,0.201,0.18,0.138,18616,25
"11873",227331,2008,1,0,"Our Lady of the Lake University-San Antonio",NA,NA,306,213,93,67,14,53,0.249,0.219,0.151,19732,30
"11874",227331,2009,1,0,"Our Lady of the Lake University-San Antonio",NA,NA,246,170,76,54,14,40,0.235,0.22,0.184,20324,21
"11875",227331,2010,1,0,"Our Lady of the Lake University-San Antonio",NA,NA,299,219,80,77,18,59,0.269,0.258,0.225,21400,46
"11876",227526,1991,1,0,"PRAIRIE VIEW A & M UNIVERSITY",NA,NA,1116,534,582,91,24,67,0.126,0.082,0.041,1148,13
"11877",227526,1992,1,0,"PRAIRIE VIEW A & M UNIVERSITY",NA,NA,1194,579,615,261,97,164,0.283,0.219,0.158,1316,24
"11878",227526,1993,1,0,"PRAIRIE VIEW A & M UNIVERSITY",NA,NA,1208,610,598,110,27,83,0.136,0.091,0.045,1537,32
"11879",227526,1995,1,0,"PRAIRIE VIEW A & M UNIVERSITY",NA,NA,1114,536,578,105,29,76,0.142,0.094,0.05,1926,20
"11880",227526,1996,1,0,"PRAIRIE VIEW A & M UNIVERSITY",NA,NA,1166,568,598,133,48,85,0.15,0.114,0.08,2146,21
"11881",227526,1997,1,0,"PRAIRIE VIEW A & M UNIVERSITY",NA,NA,1183,670,513,127,34,93,0.139,0.107,0.066,2436,10
"11882",227526,1998,1,0,"PRAIRIE VIEW A & M UNIVERSITY",NA,NA,1197,626,571,132,42,90,0.144,0.11,0.074,2496,11
"11883",227526,1999,1,0,"PRAIRIE VIEW A & M UNIVERSITY",NA,NA,967,504,463,113,33,80,0.159,0.117,0.071,1140,5
"11884",227526,2000,1,0,"PRAIRIE VIEW A & M UNIVERSITY",NA,NA,1230,657,573,163,46,117,0.178,0.133,0.08,1200,21
"11885",227526,2001,1,0,"PRAIRIE VIEW A & M UNIVERSITY",NA,NA,1380,771,609,182,62,120,0.156,0.132,0.102,1260,17
"11886",227526,2002,1,0,"PRAIRIE VIEW A & M UNIVERSITY",NA,NA,1431,769,662,222,74,148,0.192,0.155,0.112,1320,22
"11887",227526,2003,1,0,"PRAIRIE VIEW A & M UNIVERSITY",NA,NA,1553,820,733,175,71,104,0.127,0.113,0.097,1380,17
"11888",227526,2004,1,0,"PRAIRIE VIEW A & M UNIVERSITY",NA,NA,1573,823,750,156,56,100,0.122,0.099,0.075,1440,17
"11889",227526,2005,1,0,"Prairie View A & M University",NA,NA,1155,668,487,126,39,87,0.13,0.109,0.08,1500,18
"11890",227526,2006,1,0,"Prairie View A & M University",NA,NA,1231,689,542,121,28,93,0.135,0.098,0.052,3765,11
"11891",227526,2007,1,0,"Prairie View A & M University",NA,NA,1391,784,607,155,36,119,0.152,0.111,0.059,4350,18
"11892",227526,2008,1,0,"Prairie View A & M University",NA,NA,1290,761,529,355,112,243,0.319,0.275,0.212,4590,35
"11893",227526,2009,1,0,"Prairie View A & M University",NA,NA,1638,957,681,180,42,138,0.144,0.11,0.062,4884,21
"11894",227526,2010,1,0,"Prairie View A & M University",NA,NA,1731,1046,685,154,43,111,0.106,0.089,0.063,5077,24
"11895",227757,1991,1,0,"RICE UNIVERSITY",NA,NA,625,257,368,437,239,198,0.77,0.699,0.649,7700,416
"11896",227757,1992,1,0,"RICE UNIVERSITY",NA,NA,598,266,332,437,221,216,0.812,0.731,0.666,8500,416
"11897",227757,1993,1,0,"RICE UNIVERSITY",NA,NA,639,281,358,440,228,212,0.754,0.689,0.637,9644,421
"11898",227757,1995,1,0,"RICE UNIVERSITY",NA,NA,688,338,350,472,213,259,0.766,0.686,0.609,11122,409
"11899",227757,1996,1,0,"RICE UNIVERSITY",NA,NA,668,314,354,499,240,259,0.825,0.747,0.678,12031,354
"11900",227757,1997,1,0,"RICE UNIVERSITY",NA,NA,703,334,369,516,248,268,0.802,0.734,0.672,13094,451
"11901",227757,1998,1,0,"RICE UNIVERSITY",NA,NA,642,320,322,489,228,261,0.816,0.762,0.708,14131,403
"11902",227757,1999,1,0,"RICE UNIVERSITY",NA,NA,670,325,345,512,251,261,0.803,0.764,0.728,15350,393
"11903",227757,2000,1,0,"RICE UNIVERSITY",NA,NA,628,290,338,498,249,249,0.859,0.793,0.737,15438,423
"11904",227757,2001,1,0,"RICE UNIVERSITY",NA,NA,657,326,331,509,247,262,0.804,0.775,0.746,16300,343
"11905",227757,2002,1,0,"RICE UNIVERSITY",NA,NA,700,318,382,570,301,269,0.846,0.814,0.788,16925,388
"11906",227757,2003,1,0,"RICE UNIVERSITY",NA,NA,716,364,352,591,279,312,0.857,0.825,0.793,17800,393
"11907",227757,2004,1,0,"RICE UNIVERSITY",NA,NA,725,380,345,574,259,315,0.829,0.792,0.751,18863,416
"11908",227757,2005,1,0,"Rice University",NA,NA,722,337,385,571,279,292,0.867,0.791,0.725,21203,386
"11909",227757,2006,1,0,"Rice University",NA,NA,713,357,356,597,282,315,0.882,0.837,0.792,23786,338
"11910",227757,2007,1,0,"Rice University",NA,NA,742,346,396,585,288,297,0.858,0.788,0.727,26633,340
"11911",227757,2008,1,0,"Rice University",NA,NA,777,386,391,636,307,329,0.852,0.819,0.785,29188,339
"11912",227757,2009,1,0,"Rice University",NA,NA,887,427,460,710,342,368,0.862,0.8,0.743,31303,355
"11913",227757,2010,1,0,"Rice University",NA,NA,944,453,491,783,376,407,0.898,0.829,0.766,33120,416
"11914",227845,1991,1,0,"SAINT EDWARD'S UNIVERSITY",NA,NA,347,198,149,67,22,45,0.227,0.193,0.148,7764,168
"11915",227845,1992,1,0,"SAINT EDWARD'S UNIVERSITY",NA,NA,337,196,141,57,27,30,0.153,0.169,0.191,8376,169
"11916",227845,1993,1,0,"SAINT EDWARDS UNIVERSITY",NA,NA,370,235,135,98,32,66,0.281,0.265,0.237,8902,194
"11917",227845,1995,1,0,"SAINT EDWARDS UNIVERSITY",NA,NA,387,230,157,119,37,82,0.356,0.307,0.236,9950,199
"11918",227845,1996,1,0,"SAINT EDWARDS UNIVERSITY",NA,NA,373,239,134,107,35,72,0.301,0.287,0.261,10400,197
"11919",227845,1997,1,0,"SAINT EDWARDS UNIVERSITY",NA,NA,359,216,143,98,38,60,0.278,0.273,0.266,10730,197
"11920",227845,1998,1,0,"SAINT EDWARDS UNIVERSITY",NA,NA,367,212,155,95,34,61,0.288,0.259,0.219,11160,192
"11921",227845,1999,1,0,"SAINT EDWARDSS UNIVERSITY",NA,NA,357,184,173,101,35,66,0.359,0.283,0.202,11438,182
"11922",227845,2000,1,0,"SAINT EDWARD'S UNIVERSITY",NA,NA,397,207,190,118,42,76,0.367,0.297,0.221,11896,223
"11923",227845,2001,1,0,"SAINT EDWARD'S UNIVERSITY",NA,NA,413,254,159,131,37,94,0.37,0.317,0.233,12728,220
"11924",227845,2002,1,0,"SAINT EDWARD'S UNIVERSITY",NA,NA,445,255,190,164,60,104,0.408,0.369,0.316,13620,256
"11925",227845,2003,1,0,"SAINT EDWARD'S UNIVERSITY",NA,NA,544,327,217,239,78,161,0.492,0.439,0.359,14710,296
"11926",227845,2004,1,0,"SAINT EDWARD'S UNIVERSITY",NA,NA,600,371,229,291,97,194,0.523,0.485,0.424,15960,334
"11927",227845,2005,1,0,"Saint Edward's University",NA,NA,646,401,245,333,109,224,0.559,0.515,0.445,17320,341
"11928",227845,2006,1,0,"Saint Edward's University",NA,NA,698,423,275,372,144,228,0.539,0.533,0.524,18800,387
"11929",227845,2007,1,0,"Saint Edward's University",NA,NA,725,437,288,372,127,245,0.561,0.513,0.441,20400,413
"11930",227845,2008,1,0,"Saint Edward's University",NA,NA,741,480,261,397,121,276,0.575,0.536,0.464,22150,406
"11931",227845,2009,1,0,"Saint Edward's University",NA,NA,755,470,285,383,123,260,0.553,0.507,0.432,24040,400
"11932",227845,2010,1,0,"Saint Edward's University",NA,NA,770,505,265,403,122,281,0.556,0.523,0.46,26084,361
"11933",227863,1991,1,0,"UNIVERSITY OF SAINT THOMAS",NA,NA,170,114,56,64,22,42,0.368,0.376,0.393,6830,79
"11934",227863,1992,1,0,"UNIVERSITY OF SAINT THOMAS",NA,NA,173,123,50,2,0,2,0.016,0.012,0,7442,79
"11935",227863,1993,1,0,"UNIVERSITY OF SAINT THOMAS",NA,NA,192,129,63,53,13,40,0.31,0.276,0.206,8042,90
"11936",227863,1995,1,0,"UNIVERSITY OF SAINT THOMAS",NA,NA,232,145,87,58,17,41,0.283,0.25,0.195,9423,102
"11937",227863,1996,1,0,"UNIVERSITY OF SAINT THOMAS",NA,NA,222,136,86,55,19,36,0.265,0.248,0.221,9975,102
"11938",227863,1997,1,0,"UNIVERSITY OF SAINT THOMAS",NA,NA,235,155,80,58,19,39,0.252,0.247,0.238,10577,105
"11939",227863,1998,1,0,"UNIVERSITY OF SAINT THOMAS",NA,NA,231,153,78,65,12,53,0.346,0.281,0.154,11210,93
"11940",227863,1999,1,0,"UNIVERSITY OF ST THOMAS",NA,NA,215,128,87,50,16,34,0.266,0.233,0.184,11700,102
"11941",227863,2000,1,0,"UNIVERSITY OF ST THOMAS",NA,NA,303,207,96,72,19,53,0.256,0.238,0.198,12300,98
"11942",227863,2001,1,0,"UNIVERSITY OF ST THOMAS",NA,NA,272,166,106,68,23,45,0.271,0.25,0.217,13050,102
"11943",227863,2002,1,0,"UNIVERSITY OF ST THOMAS",NA,NA,276,174,102,65,15,50,0.287,0.236,0.147,13800,98
"11944",227863,2003,1,0,"UNIVERSITY OF ST THOMAS",NA,NA,292,172,120,87,33,54,0.314,0.298,0.275,15000,116
"11945",227863,2004,1,0,"UNIVERSITY OF ST THOMAS",NA,NA,297,189,108,80,24,56,0.296,0.269,0.222,16200,116
"11946",227863,2005,1,0,"University of St Thomas",NA,NA,289,185,104,75,27,48,0.26,0.26,0.26,16950,108
"11947",227863,2006,1,0,"University of St Thomas",NA,NA,291,187,104,93,26,67,0.358,0.32,0.25,17700,103
"11948",227863,2007,1,0,"University of St Thomas",NA,NA,288,179,109,77,25,52,0.291,0.267,0.229,18900,98
"11949",227863,2008,1,0,"University of St Thomas",NA,NA,293,187,106,101,30,71,0.38,0.345,0.283,20190,86
"11950",227863,2009,1,0,"University of St Thomas",NA,NA,284,181,103,106,34,72,0.398,0.373,0.33,21510,104
"11951",227863,2010,1,0,"University of St Thomas",NA,NA,191,127,64,63,14,49,0.386,0.33,0.219,23160,58
"11952",228042,1991,1,0,"SCHREINER COLLEGE",NA,NA,156,79,77,27,15,12,0.152,0.173,0.195,7385,114
"11953",228042,1992,1,0,"SCHREINER COLLEGE",NA,NA,140,75,65,12,3,9,0.12,0.086,0.046,7975,99
"11954",228042,1993,1,0,"SCHREINER COLLEGE",NA,NA,134,77,57,26,10,16,0.208,0.194,0.175,8610,98
"11955",228042,1995,1,0,"SCHREINER COLLEGE",NA,NA,221,107,114,35,15,20,0.187,0.158,0.132,9335,148
"11956",228042,1996,1,0,"SCHREINER COLLEGE",NA,NA,180,112,68,34,10,24,0.214,0.189,0.147,9735,148
"11957",228042,1997,1,0,"SCHREINER COLLEGE",NA,NA,194,116,78,40,16,24,0.207,0.206,0.205,9900,150
"11958",228042,1998,1,0,"SCHREINER COLLEGE",NA,NA,198,118,80,39,17,22,0.186,0.197,0.212,10490,157
"11959",228042,1999,1,0,"SCHREINER COLLEGE",NA,NA,225,148,77,44,7,37,0.25,0.196,0.091,10990,174
"11960",228042,2000,1,0,"SCHREINER COLLEGE",NA,NA,207,124,83,40,16,24,0.194,0.193,0.193,11540,171
"11961",228042,2001,1,0,"SCHREINER UNIVERSITY",NA,NA,180,110,70,46,12,34,0.309,0.256,0.171,12118,146
"11962",228042,2002,1,0,"SCHREINER UNIVERSITY",NA,NA,165,80,85,45,18,27,0.338,0.273,0.212,12118,119
"11963",228042,2003,1,0,"SCHREINER UNIVERSITY",NA,NA,168,88,80,40,14,26,0.296,0.238,0.175,13240,132
"11964",228042,2004,1,0,"SCHREINER UNIVERSITY",NA,NA,204,122,82,53,20,33,0.27,0.26,0.244,14040,154
"11965",228042,2005,1,0,"Schreiner University",NA,NA,167,92,75,50,19,31,0.337,0.299,0.253,14742,105
"11966",228042,2006,1,0,"Schreiner University",NA,NA,243,128,115,57,20,37,0.289,0.235,0.174,15479,173
"11967",228042,2007,1,0,"Schreiner University",NA,NA,262,135,127,92,36,56,0.415,0.351,0.283,16408,179
"11968",228042,2008,1,0,"Schreiner University",NA,NA,266,145,121,84,34,50,0.345,0.316,0.281,17392,183
"11969",228042,2009,1,0,"Schreiner University",NA,NA,289,155,134,98,44,54,0.348,0.339,0.328,18132,190
"11970",228042,2010,1,0,"Schreiner University",NA,NA,253,150,103,106,40,66,0.44,0.419,0.388,18948,163
"11971",228149,1991,1,0,"SAINT MARY'S UNIVERSITY",NA,NA,429,260,169,131,43,88,0.338,0.305,0.254,7170,103
"11972",228149,1992,1,0,"SAINT MARY'S UNIVERSITY",NA,NA,491,285,206,139,43,96,0.337,0.283,0.209,8000,116
"11973",228149,1993,1,0,"SAINT MARYS UNIVERSITY",NA,NA,402,231,171,125,34,91,0.394,0.311,0.199,8276,114
"11974",228149,1995,1,0,"SAINT MARYS UNIVERSITY",NA,NA,452,254,198,123,34,89,0.35,0.272,0.172,9527,113
"11975",228149,1996,1,0,"ST MARYS UNIVERSITY",NA,NA,507,312,195,177,56,121,0.388,0.349,0.287,9934,122
"11976",228149,1997,1,0,"ST MARYS UNIVERSITY",NA,NA,507,311,196,170,50,120,0.386,0.335,0.255,10668,105
"11977",228149,1998,1,0,"ST MARYS UNIVERSITY",NA,NA,499,313,186,147,49,98,0.313,0.295,0.263,11280,114
"11978",228149,1999,1,0,"ST MARYS UNIVERSITY",NA,NA,485,277,208,165,54,111,0.401,0.34,0.26,11500,101
"11979",228149,2000,1,0,"ST MARYS UNIVERSITY",NA,NA,656,399,257,201,60,141,0.353,0.306,0.233,12160,143
"11980",228149,2001,1,0,"ST MARYS UNIVERSITY",NA,NA,534,299,235,181,72,109,0.365,0.339,0.306,12980,92
"11981",228149,2002,1,0,"ST MARYS UNIVERSITY",NA,NA,667,397,270,214,63,151,0.38,0.321,0.233,14727,136
"11982",228149,2003,1,0,"ST MARYS UNIVERSITY",NA,NA,470,292,178,147,41,106,0.363,0.313,0.23,15992,107
"11983",228149,2004,1,0,"ST MARYS UNIVERSITY",NA,NA,463,277,186,159,51,108,0.39,0.343,0.274,17256,93
"11984",228149,2005,1,0,"St Marys University",NA,NA,494,314,180,147,38,109,0.347,0.298,0.211,18274,73
"11985",228149,2006,1,0,"St Marys University",NA,NA,548,347,201,187,39,148,0.426,0.341,0.194,19334,99
"11986",228149,2007,1,0,"St Marys University",NA,NA,565,334,231,187,54,133,0.398,0.331,0.234,20300,110
"11987",228149,2008,1,0,"St Marys University",NA,NA,535,335,200,237,63,174,0.519,0.443,0.315,20600,87
"11988",228149,2009,1,0,"St Marys University",NA,NA,530,335,195,270,76,194,0.579,0.509,0.39,21320,99
"11989",228149,2010,1,0,"St Marys University",NA,NA,585,358,227,249,85,164,0.458,0.426,0.374,21980,84
"11990",228246,1991,1,0,"SOUTHERN METHODIST UNIVERSITY",NA,NA,1229,652,577,671,289,382,0.586,0.546,0.501,11768,1004
"11991",228246,1992,1,0,"SOUTHERN METHODIST UNIVERSITY",NA,NA,1221,634,587,663,274,389,0.614,0.543,0.467,12688,961
"11992",228246,1993,1,0,"SOUTHERN METHODIST UNIVERSITY",NA,NA,1161,630,531,657,265,392,0.622,0.566,0.499,13580,861
"11993",228246,1995,1,0,"SOUTHERN METHODIST UNIVERSITY",NA,NA,1228,662,566,743,287,456,0.689,0.605,0.507,15228,963
"11994",228246,1996,1,0,"SOUTHERN METHODIST UNIVERSITY",NA,NA,1217,663,554,687,270,417,0.629,0.565,0.487,15990,936
"11995",228246,1997,1,0,"SOUTHERN METHODIST UNIVERSITY",NA,NA,1247,686,561,702,282,420,0.612,0.563,0.503,16790,977
"11996",228246,1998,1,0,"SOUTHERN METHODIST UNIVERSITY",NA,NA,1306,720,586,689,249,440,0.611,0.528,0.425,17628,975
"11997",228246,1999,1,0,"SOUTHERN METHODIST UNIVERSITY",NA,NA,1331,688,643,656,262,394,0.573,0.493,0.407,16422,1002
"11998",228246,2000,1,0,"SOUTHERN METHODIST UNIVERSITY",NA,NA,1276,713,563,736,280,456,0.64,0.577,0.497,17406,981
"11999",228246,2001,1,0,"SOUTHERN METHODIST UNIVERSITY",NA,NA,1353,713,640,751,297,454,0.637,0.555,0.464,18450,1073
"12000",228246,2002,1,0,"SOUTHERN METHODIST UNIVERSITY",NA,NA,1380,764,616,811,315,496,0.649,0.588,0.511,19466,1080
"12001",228246,2003,1,0,"SOUTHERN METHODIST UNIVERSITY",NA,NA,1383,772,611,853,324,529,0.685,0.617,0.53,20926,1049
"12002",228246,2004,1,0,"SOUTHERN METHODIST UNIVERSITY",NA,NA,1313,717,596,789,310,479,0.668,0.601,0.52,22496,1015
"12003",228246,2005,1,0,"Southern Methodist University",NA,NA,1401,754,647,846,345,501,0.665,0.604,0.533,23846,1120
"12004",228246,2006,1,0,"Southern Methodist University",NA,NA,1369,753,616,937,377,560,0.744,0.684,0.612,25400,1069
"12005",228246,2007,1,0,"Southern Methodist University",NA,NA,1306,697,609,870,359,511,0.733,0.666,0.589,27400,1042
"12006",228246,2008,1,0,"Southern Methodist University",NA,NA,1397,751,646,941,404,537,0.715,0.674,0.625,29430,1050
"12007",228246,2009,1,0,"Southern Methodist University",NA,NA,1325,702,623,886,374,512,0.729,0.669,0.6,31200,958
"12008",228246,2010,1,0,"Southern Methodist University",NA,NA,1476,786,690,1008,429,579,0.737,0.683,0.622,33040,1003
"12009",228343,1991,1,0,"SOUTHWESTERN UNIVERSITY",NA,NA,324,173,151,191,89,102,0.59,0.59,0.589,9400,269
"12010",228343,1992,1,0,"SOUTHWESTERN UNIVERSITY",NA,NA,317,176,141,175,62,113,0.642,0.552,0.44,10300,249
"12011",228343,1993,1,0,"SOUTHWESTERN UNIVERSITY",NA,NA,351,207,144,218,79,139,0.672,0.621,0.549,11000,275
"12012",228343,1995,1,0,"SOUTHWESTERN UNIVERSITY",NA,NA,326,188,138,188,69,119,0.633,0.577,0.5,12700,257
"12013",228343,1996,1,0,"SOUTHWESTERN UNIVERSITY",NA,NA,310,198,112,179,60,119,0.601,0.577,0.536,13400,245
"12014",228343,1997,1,0,"SOUTHWESTERN UNIVERSITY",NA,NA,332,177,155,201,85,116,0.655,0.605,0.548,14000,278
"12015",228343,1998,1,0,"SOUTHWESTERN UNIVERSITY",NA,NA,378,218,160,227,74,153,0.702,0.601,0.462,14600,331
"12016",228343,1999,1,0,"SOUTHWESTERN UNIVERSITY",NA,NA,354,210,144,236,83,153,0.729,0.667,0.576,15000,288
"12017",228343,2000,1,0,"SOUTHWESTERN UNIVERSITY",NA,NA,355,195,160,230,91,139,0.713,0.648,0.569,15750,270
"12018",228343,2001,1,0,"SOUTHWESTERN UNIVERSITY",NA,NA,327,174,153,196,77,119,0.684,0.599,0.503,16650,260
"12019",228343,2002,1,0,"SOUTHWESTERN UNIVERSITY",NA,NA,342,217,125,227,76,151,0.696,0.664,0.608,17570,244
"12020",228343,2003,1,0,"SOUTHWESTERN UNIVERSITY",NA,NA,343,196,147,234,80,154,0.786,0.682,0.544,18870,261
"12021",228343,2004,1,0,"SOUTHWESTERN UNIVERSITY",NA,NA,366,221,145,228,68,160,0.724,0.623,0.469,20220,283
"12022",228343,2005,1,0,"Southwestern University",NA,NA,327,192,135,223,87,136,0.708,0.682,0.644,21900,262
"12023",228343,2006,1,0,"Southwestern University",NA,NA,345,221,124,231,74,157,0.71,0.67,0.597,23650,267
"12024",228343,2007,1,0,"Southwestern University",NA,NA,371,232,139,242,84,158,0.681,0.652,0.604,25740,286
"12025",228343,2008,1,0,"Southwestern University",NA,NA,349,216,133,227,78,149,0.69,0.65,0.586,27940,252
"12026",228343,2009,1,0,"Southwestern University",NA,NA,375,231,144,257,88,169,0.732,0.685,0.611,30220,284
"12027",228343,2010,1,0,"Southwestern University",NA,NA,383,224,159,252,98,154,0.688,0.658,0.616,31630,268
"12028",228431,1991,1,0,"STEPHEN F AUSTIN STATE UNIVERSITY",NA,NA,2047,1234,813,353,74,279,0.226,0.172,0.091,1042,1841
"12029",228431,1992,1,0,"STEPHEN F AUSTIN STATE UNIVERSITY",NA,NA,2183,1255,928,332,95,237,0.189,0.152,0.102,1338,1923
"12030",228431,1993,1,0,"STEPHEN F AUSTIN STATE UNIVERSITY",NA,NA,2247,1255,992,308,81,227,0.181,0.137,0.082,1515,1946
"12031",228431,1995,1,0,"STEPHEN F AUSTIN STATE UNIVERSITY",NA,NA,1714,986,728,275,69,206,0.209,0.16,0.095,1907,1481
"12032",228431,1996,1,0,"STEPHEN F AUSTIN STATE UNIVERSITY",NA,NA,2007,1188,819,332,71,261,0.22,0.165,0.087,2127,1632
"12033",228431,1997,1,0,"STEPHEN F AUSTIN STATE UNIVERSITY",NA,NA,2360,1422,938,358,71,287,0.202,0.152,0.076,2247,1854
"12034",228431,1998,1,0,"STEPHEN F AUSTIN STATE UNIVERSITY",NA,NA,2348,1432,916,388,69,319,0.223,0.165,0.075,2408,1830
"12035",228431,1999,1,0,"STEPHEN F AUSTIN STATE UNIVERSITY",NA,NA,2255,1353,902,339,92,247,0.183,0.15,0.102,1140,1719
"12036",228431,2000,1,0,"STEPHEN F AUSTIN STATE UNIVERSITY",NA,NA,2210,1371,839,370,88,282,0.206,0.167,0.105,960,1624
"12037",228431,2001,1,0,"STEPHEN F AUSTIN STATE UNIVERSITY",NA,NA,2191,1370,821,360,90,270,0.197,0.164,0.11,1728,1521
"12038",228431,2002,1,0,"STEPHEN F AUSTIN STATE UNIVERSITY",NA,NA,2006,1229,777,314,83,231,0.188,0.157,0.107,1848,1452
"12039",228431,2003,1,0,"STEPHEN F AUSTIN STATE UNIVERSITY",NA,NA,1839,1148,691,348,88,260,0.226,0.189,0.127,2088,1322
"12040",228431,2004,1,0,"STEPHEN F AUSTIN STATE UNIVERSITY",NA,NA,1736,1091,645,381,95,286,0.262,0.219,0.147,2688,1257
"12041",228431,2005,1,0,"Stephen F Austin State University",NA,NA,1967,1199,768,441,125,316,0.264,0.224,0.163,3024,1343
"12042",228431,2006,1,0,"Stephen F Austin State University",NA,NA,2305,1420,885,538,132,406,0.286,0.233,0.149,3240,1515
"12043",228431,2007,1,0,"Stephen F Austin State University",NA,NA,2268,1375,893,521,156,365,0.266,0.23,0.175,3528,1421
"12044",228431,2008,1,0,"Stephen F Austin State University",NA,NA,2480,1545,935,590,131,459,0.297,0.238,0.14,3744,1416
"12045",228431,2009,1,0,"Stephen F Austin State University",NA,NA,2553,1613,940,576,135,441,0.273,0.226,0.144,3864,1440
"12046",228431,2010,1,0,"Stephen F Austin State University",NA,NA,2280,1473,807,556,128,428,0.291,0.244,0.159,4076,1192
"12047",228459,1991,1,0,"SOUTHWEST TEXAS STATE UNIVERSITY",NA,NA,2916,1634,1282,201,61,140,0.086,0.069,0.048,1130,2010
"12048",228459,1992,1,0,"SOUTHWEST TEXAS STATE UNIVERSITY",NA,NA,2310,1372,938,229,59,170,0.124,0.099,0.063,1406,1690
"12049",228459,1993,1,0,"SOUTHWEST TEXAS STATE UNIVERSITY",NA,NA,2281,1358,923,248,62,186,0.137,0.109,0.067,1578,1647
"12050",228459,1995,1,0,"SOUTHWEST TEXAS STATE UNIVERSITY",NA,NA,2426,1461,965,309,80,229,0.157,0.127,0.083,1588,1802
"12051",228459,1996,1,0,"SOUTHWEST TEXAS STATE UNIVERSITY",NA,NA,2396,1472,924,408,88,320,0.217,0.17,0.095,2022,1753
"12052",228459,1997,1,0,"SOUTHWEST TEXAS STATE UNIVERSITY",NA,NA,2331,1399,932,413,107,306,0.219,0.177,0.115,2214,1737
"12053",228459,1998,1,0,"SOUTHWEST TEXAS STATE UNIVERSITY",NA,NA,2592,1546,1046,458,127,331,0.214,0.177,0.121,2388,1923
"12054",228459,1999,1,0,"SOUTHWEST TEXAS STATE UNIVERSITY",NA,NA,2447,1479,968,504,130,374,0.253,0.206,0.134,1140,1806
"12055",228459,2000,1,0,"SOUTHWEST TEXAS STATE UNIVERSITY",NA,NA,2531,1553,978,522,122,400,0.258,0.206,0.125,1200,1873
"12056",228459,2001,1,0,"SOUTHWEST TEXAS STATE UNIVERSITY",NA,NA,2469,1508,961,553,134,419,0.278,0.224,0.139,1260,1872
"12057",228459,2002,1,0,"SOUTHWEST TEXAS STATE UNIVERSITY",NA,NA,2674,1665,1009,587,140,447,0.268,0.22,0.139,2640,1997
"12058",228459,2003,1,0,"TEXAS STATE UNIVERSITY-SAN MARCOS",NA,NA,2818,1681,1137,667,195,472,0.281,0.237,0.172,2208,2104
"12059",228459,2004,1,0,"TEXAS STATE UNIVERSITY-SAN MARCOS",NA,NA,2783,1616,1167,691,187,504,0.312,0.248,0.16,2616,2067
"12060",228459,2005,1,0,"Texas State University-San Marcos",NA,NA,3053,1786,1267,825,235,590,0.33,0.27,0.185,3024,2172
"12061",228459,2006,1,0,"Texas State University-San Marcos",NA,NA,2975,1746,1229,815,250,565,0.324,0.274,0.203,3312,2038
"12062",228459,2007,1,0,"Texas State University-San Marcos",NA,NA,3237,1900,1337,983,288,695,0.366,0.304,0.215,3840,2148
"12063",228459,2008,1,0,"Texas State University-San Marcos",NA,NA,3444,2051,1393,916,289,627,0.306,0.266,0.207,4080,2253
"12064",228459,2009,1,0,"Texas State University-San Marcos",NA,NA,3804,2260,1544,985,271,714,0.316,0.259,0.176,4368,2371
"12065",228459,2010,1,0,"Texas State University-San Marcos",NA,NA,4033,2403,1630,1091,306,785,0.327,0.271,0.188,4584,2323
"12066",228501,1991,1,0,"SUL ROSS STATE UNIVERSITY",NA,NA,335,123,212,19,9,10,0.081,0.057,0.042,946,154
"12067",228501,1992,1,0,"SUL ROSS STATE UNIVERSITY",NA,NA,278,124,154,17,6,11,0.089,0.061,0.039,1108,130
"12068",228501,1993,1,0,"SUL ROSS STATE UNIVERSITY",NA,NA,317,107,210,23,9,14,0.131,0.073,0.043,1224,145
"12069",228501,1995,1,0,"SUL ROSS STATE UNIVERSITY",NA,NA,393,140,253,34,16,18,0.129,0.087,0.063,1508,205
"12070",228501,1996,1,0,"SUL ROSS STATE UNIVERSITY",NA,NA,355,135,220,22,8,14,0.104,0.062,0.036,1642,175
"12071",228501,1997,1,0,"SUL ROSS STATE UNIVERSITY",NA,NA,280,113,167,20,12,8,0.071,0.071,0.072,1750,138
"12072",228501,1998,1,0,"SUL ROSS STATE UNIVERSITY",NA,NA,316,113,203,26,10,16,0.142,0.082,0.049,1834,148
"12073",228501,1999,1,0,"SUL ROSS STATE UNIVERSITY",NA,NA,227,95,132,25,11,14,0.147,0.11,0.083,912,117
"12074",228501,2000,1,0,"SUL ROSS STATE UNIVERSITY",NA,NA,263,105,158,13,7,6,0.057,0.049,0.044,960,130
"12075",228501,2001,1,0,"SUL ROSS STATE UNIVERSITY",NA,NA,333,124,209,28,7,21,0.169,0.084,0.033,1536,139
"12076",228501,2002,1,0,"SUL ROSS STATE UNIVERSITY",NA,NA,315,130,185,14,3,11,0.085,0.044,0.016,1632,98
"12077",228501,2003,1,0,"SUL ROSS STATE UNIVERSITY",NA,NA,357,163,194,30,11,19,0.117,0.084,0.057,1824,127
"12078",228501,2004,1,0,"SUL ROSS STATE UNIVERSITY",NA,NA,275,113,162,25,11,14,0.124,0.091,0.068,2064,115
"12079",228501,2005,1,0,"Sul Ross State University",NA,NA,329,127,202,31,19,12,0.094,0.094,0.094,2256,132
"12080",228501,2006,1,0,"Sul Ross State University",NA,NA,192,73,119,22,8,14,0.192,0.115,0.067,2400,81
"12081",228501,2007,1,0,"Sul Ross State University",NA,NA,242,92,150,34,6,28,0.304,0.14,0.04,2688,84
"12082",228501,2008,1,0,"Sul Ross State University",NA,NA,315,124,191,43,18,25,0.202,0.137,0.094,2784,109
"12083",228501,2009,1,0,"Sul Ross State University",NA,NA,374,135,239,36,15,21,0.156,0.096,0.063,2928,112
"12084",228501,2010,1,0,"Sul Ross State University",NA,NA,322,146,176,42,17,25,0.171,0.13,0.097,3072,95
"12085",228529,1991,1,0,"TARLETON STATE UNIVERSITY",NA,NA,924,421,503,88,35,53,0.126,0.095,0.07,992,806
"12086",228529,1992,1,0,"TARLETON STATE UNIVERSITY",NA,NA,942,428,514,69,28,41,0.096,0.073,0.054,1104,833
"12087",228529,1993,1,0,"TARLETON STATE UNIVERSITY",NA,NA,923,432,491,82,24,58,0.134,0.089,0.049,1184,829
"12088",228529,1995,1,0,"TARLETON STATE UNIVERSITY",NA,NA,1021,531,490,140,52,88,0.166,0.137,0.106,1566,935
"12089",228529,1996,1,0,"TARLETON STATE UNIVERSITY",NA,NA,919,455,464,117,35,82,0.18,0.127,0.075,1774,850
"12090",228529,1997,1,0,"TARLETON STATE UNIVERSITY",NA,NA,595,306,289,98,38,60,0.196,0.165,0.131,2331,546
"12091",228529,1998,1,0,"TARLETON STATE UNIVERSITY",NA,NA,605,296,309,102,44,58,0.196,0.169,0.142,2412,562
"12092",228529,1999,1,0,"TARLETON STATE UNIVERSITY",NA,NA,585,303,282,109,45,64,0.211,0.186,0.16,1488,547
"12093",228529,2000,1,0,"TARLETON STATE UNIVERSITY",NA,NA,475,238,237,100,40,60,0.252,0.211,0.169,1608,421
"12094",228529,2001,1,0,"TARLETON STATE UNIVERSITY",NA,NA,783,411,372,126,37,89,0.216,0.161,0.099,1728,701
"12095",228529,2002,1,0,"TARLETON STATE UNIVERSITY",NA,NA,974,507,467,148,46,102,0.201,0.152,0.099,1920,862
"12096",228529,2003,1,0,"TARLETON STATE UNIVERSITY",NA,NA,1277,686,591,201,62,139,0.203,0.157,0.105,2136,1118
"12097",228529,2004,1,0,"TARLETON STATE UNIVERSITY",NA,NA,1178,655,523,200,59,141,0.215,0.17,0.113,2400,1041
"12098",228529,2005,1,0,"Tarleton State University",NA,NA,1188,678,510,212,65,147,0.217,0.178,0.127,2640,1013
"12099",228529,2006,1,0,"Tarleton State University",NA,NA,1256,667,589,230,94,136,0.204,0.183,0.16,2880,1066
"12100",228529,2007,1,0,"Tarleton State University",NA,NA,1190,685,505,259,86,173,0.253,0.218,0.17,3120,1011
"12101",228529,2008,1,0,"Tarleton State University",NA,NA,1274,722,552,276,92,184,0.255,0.217,0.167,3324,1053
"12102",228529,2009,1,0,"Tarleton State University",NA,NA,1207,668,539,293,96,197,0.295,0.243,0.178,3324,991
"12103",228529,2010,1,0,"Tarleton State University",NA,NA,1435,858,577,339,98,241,0.281,0.236,0.17,3455,1129
"12104",228705,1991,1,0,"TEXAS A & I UNIVERSITY",NA,NA,979,465,514,49,16,33,0.071,0.05,0.031,882,224
"12105",228705,1992,1,0,"TEXAS A & I UNIVERSITY",NA,NA,987,484,503,72,20,52,0.107,0.073,0.04,882,234
"12106",228705,1993,1,0,"TEXAS A & I UNIVERSITY",NA,NA,1012,481,531,50,19,31,0.064,0.049,0.036,882,268
"12107",228705,1995,1,0,"TEXAS A & M UNIVERSITY-KINGSVILLE",NA,NA,893,420,473,40,17,23,0.055,0.045,0.036,1418,210
"12108",228705,1996,1,0,"TEXAS A & M UNIVERSITY-KINGSVILLE",NA,NA,916,406,510,55,22,33,0.081,0.06,0.043,1634,253
"12109",228705,1997,1,0,"TEXAS A & M UNIVERSITY-KINGSVILLE",NA,NA,898,402,496,47,15,32,0.08,0.052,0.03,1774,193
"12110",228705,1998,1,0,"TEXAS A & M UNIVERSITY-KINGSVILLE",NA,NA,872,375,497,73,34,39,0.104,0.084,0.068,1822,225
"12111",228705,1999,1,0,"TEXAS A & M UNIVERSITY-KINGSVILLE",NA,NA,736,293,443,53,24,29,0.099,0.072,0.054,1140,176
"12112",228705,2000,1,0,"TEXAS A & M UNIVERSITY-KINGSVILLE",NA,NA,819,332,487,79,33,46,0.139,0.096,0.068,1200,224
"12113",228705,2001,1,0,"TEXAS A & M UNIVERSITY-KINGSVILLE",NA,NA,820,388,432,66,28,38,0.098,0.08,0.065,1260,233
"12114",228705,2002,1,0,"TEXAS A & M UNIVERSITY-KINGSVILLE",NA,NA,962,401,561,135,75,60,0.15,0.14,0.134,1320,226
"12115",228705,2003,1,0,"TEXAS A & M UNIVERSITY-KINGSVILLE",NA,NA,828,370,458,60,24,36,0.097,0.072,0.052,1104,200
"12116",228705,2004,1,0,"TEXAS A & M UNIVERSITY-KINGSVILLE",NA,NA,741,328,413,80,29,51,0.156,0.108,0.07,1440,171
"12117",228705,2005,1,0,"Texas A & M University-Kingsville",NA,NA,606,244,362,83,40,43,0.176,0.137,0.11,2448,155
"12118",228705,2006,1,0,"Texas A & M University-Kingsville",NA,NA,731,297,434,95,32,63,0.212,0.13,0.074,2640,189
"12119",228705,2007,1,0,"Texas A & M University-Kingsville",NA,NA,651,251,400,115,58,57,0.227,0.177,0.145,2800,140
"12120",228705,2008,1,0,"Texas A & M University-Kingsville",NA,NA,737,310,427,124,70,54,0.174,0.168,0.164,3104,194
"12121",228705,2009,1,0,"Texas A & M University-Kingsville",NA,NA,971,414,557,165,75,90,0.217,0.17,0.135,3104,193
"12122",228705,2010,1,0,"Texas A & M University-Kingsville",NA,NA,1287,539,748,196,70,126,0.234,0.152,0.094,4066,213
"12123",228723,1991,1,0,"TEXAS A & M UNIVERSITY",NA,NA,6034,2816,3218,1454,510,944,0.335,0.241,0.158,1224,4915
"12124",228723,1992,1,0,"TEXAS A & M UNIVERSITY",NA,NA,5968,2872,3096,2475,953,1522,0.53,0.415,0.308,1488,4745
"12125",228723,1993,1,0,"TEXAS A & M UNIVERSITY",NA,NA,6341,3083,3258,1631,524,1107,0.359,0.257,0.161,1646,4975
"12126",228723,1995,1,0,"TEXAS A & M UNIVERSITY",NA,NA,5985,2986,2999,1643,498,1145,0.384,0.275,0.166,1988,4602
"12127",228723,1996,1,0,"TEXAS A & M UNIVERSITY",NA,NA,6326,3218,3108,1931,625,1306,0.406,0.305,0.201,1948,5154
"12128",228723,1997,1,0,"TEXAS A & M UNIVERSITY",NA,NA,6169,3158,3011,1953,619,1334,0.422,0.317,0.206,2740,5098
"12129",228723,1998,1,0,"TEXAS A & M UNIVERSITY",NA,NA,7322,3701,3621,2350,782,1568,0.424,0.321,0.216,2897,6011
"12130",228723,1999,1,0,"TEXAS A & M UNIVERSITY",NA,NA,6659,3419,3240,2359,722,1637,0.479,0.354,0.223,2280,5529
"12131",228723,2000,1,0,"TEXAS A & M UNIVERSITY",NA,NA,6591,3453,3138,2409,774,1635,0.474,0.365,0.247,2400,5346
"12132",228723,2001,1,0,"TEXAS A & M UNIVERSITY",NA,NA,6271,3265,3006,2408,815,1593,0.488,0.384,0.271,2520,5149
"12133",228723,2002,1,0,"TEXAS A & M UNIVERSITY",NA,NA,6589,3528,3061,2734,863,1871,0.53,0.415,0.282,2640,5445
"12134",228723,2003,1,0,"TEXAS A & M UNIVERSITY",NA,NA,6389,3358,3031,2898,981,1917,0.571,0.454,0.324,2895,5236
"12135",228723,2004,1,0,"TEXAS A & M UNIVERSITY",NA,NA,6645,3465,3180,3071,1049,2022,0.584,0.462,0.33,3675,5276
"12136",228723,2005,1,0,"Texas A & M University",NA,NA,6713,3406,3307,3352,1259,2093,0.615,0.499,0.381,4110,5099
"12137",228723,2006,1,0,"Texas A & M University",NA,NA,7472,3774,3698,3636,1358,2278,0.604,0.487,0.367,4371,5620
"12138",228723,2007,1,0,"Texas A & M University",NA,NA,8025,4074,3951,3968,1491,2477,0.608,0.494,0.377,4680,6107
"12139",228723,2008,1,0,"Texas A & M University",NA,NA,8038,3940,4098,3989,1575,2414,0.613,0.496,0.384,4898,5754
"12140",228723,2009,1,0,"Texas A & M University",NA,NA,7933,3908,4025,4017,1602,2415,0.618,0.506,0.398,5152,5630
"12141",228723,2010,1,0,"Texas A & M University-College Station",NA,NA,8033,3862,4171,4175,1709,2466,0.639,0.52,0.41,5297,5544
"12142",228769,1991,1,0,"UNIVERSITY OF TEXAS AT ARLINGTON",NA,NA,1608,759,849,116,45,71,0.094,0.072,0.053,1054,1077
"12143",228769,1992,1,0,"UNIVERSITY OF TEXAS AT ARLINGTON",NA,NA,1523,724,799,105,39,66,0.091,0.069,0.049,1236,1010
"12144",228769,1993,1,0,"THE UNIVERSITY OF TEXAS AT ARLINGTON",NA,NA,1314,638,676,81,34,47,0.074,0.062,0.05,1159,832
"12145",228769,1995,1,0,"THE UNIVERSITY OF TEXAS AT ARLINGTON",NA,NA,1243,623,620,117,47,70,0.112,0.094,0.076,1560,777
"12146",228769,1996,1,0,"THE UNIVERSITY OF TEXAS AT ARLINGTON",NA,NA,1208,617,591,235,90,145,0.235,0.195,0.152,1859,707
"12147",228769,1997,1,0,"THE UNIVERSITY OF TEXAS AT ARLINGTON",NA,NA,1270,644,626,250,105,145,0.225,0.197,0.168,2106,716
"12148",228769,1998,1,0,"THE UNIVERSITY OF TEXAS AT ARLINGTON",NA,NA,1241,568,673,155,64,91,0.16,0.125,0.095,2398,723
"12149",228769,1999,1,0,"THE UNIVERSITY OF TEXAS AT ARLINGTON",NA,NA,1402,714,688,214,95,119,0.167,0.153,0.138,1824,775
"12150",228769,2000,1,0,"THE UNIVERSITY OF TEXAS AT ARLINGTON",NA,NA,1589,801,788,225,102,123,0.154,0.142,0.129,1920,866
"12151",228769,2001,1,0,"THE UNIVERSITY OF TEXAS AT ARLINGTON",NA,NA,1838,914,924,271,104,167,0.183,0.147,0.113,2016,1001
"12152",228769,2002,1,0,"THE UNIVERSITY OF TEXAS AT ARLINGTON",NA,NA,2126,1070,1056,269,112,157,0.147,0.127,0.106,2112,1193
"12153",228769,2003,1,0,"THE UNIVERSITY OF TEXAS AT ARLINGTON",NA,NA,2431,1182,1249,364,144,220,0.186,0.15,0.115,2208,1399
"12154",228769,2004,1,0,"THE UNIVERSITY OF TEXAS AT ARLINGTON",NA,NA,2009,1068,941,325,115,210,0.197,0.162,0.122,2904,993
"12155",228769,2005,1,0,"The University of Texas at Arlington",NA,NA,2075,1069,1006,347,130,217,0.203,0.167,0.129,3306,973
"12156",228769,2006,1,0,"The University of Texas at Arlington",NA,NA,1974,984,990,340,124,216,0.22,0.172,0.125,5930,979
"12157",228769,2007,1,0,"The University of Texas at Arlington",NA,NA,2096,1041,1055,354,130,224,0.215,0.169,0.123,6464,963
"12158",228769,2008,1,0,"The University of Texas at Arlington",NA,NA,2254,1106,1148,396,151,245,0.222,0.176,0.132,7780,942
"12159",228769,2009,1,0,"The University of Texas at Arlington",NA,NA,2435,1261,1174,502,206,296,0.235,0.206,0.175,8186,987
"12160",228769,2010,1,0,"The University of Texas at Arlington",NA,NA,2585,1319,1266,549,228,321,0.243,0.212,0.18,8500,920
"12161",228778,1991,1,0,"UNIVERSITY OF TEXAS AT AUSTIN",NA,NA,5850,2743,3107,1722,723,999,0.364,0.294,0.233,1189,3881
"12162",228778,1992,1,0,"UNIVERSITY OF TEXAS AT AUSTIN",NA,NA,5633,2670,2963,1696,691,1005,0.376,0.301,0.233,1372,3696
"12163",228778,1993,1,0,"THE UNIVERSITY OF TEXAS AT AUSTIN",NA,NA,5872,2810,3062,1776,741,1035,0.368,0.302,0.242,1691,3737
"12164",228778,1995,1,0,"THE UNIVERSITY OF TEXAS AT AUSTIN",NA,NA,6212,3139,3073,2207,865,1342,0.428,0.355,0.281,2208,4001
"12165",228778,1996,1,0,"THE UNIVERSITY OF TEXAS AT AUSTIN",NA,NA,6281,3087,3194,2420,985,1435,0.465,0.385,0.308,2612,4071
"12166",228778,1997,1,0,"THE UNIVERSITY OF TEXAS AT AUSTIN",NA,NA,6945,3568,3377,2531,990,1541,0.432,0.364,0.293,2866,4638
"12167",228778,1998,1,0,"THE UNIVERSITY OF TEXAS AT AUSTIN",NA,NA,6598,3388,3210,2590,1036,1554,0.459,0.393,0.323,3004,4305
"12168",228778,1999,1,0,"THE UNIVERSITY OF TEXAS AT AUSTIN",NA,NA,6925,3508,3417,2888,1186,1702,0.485,0.417,0.347,2280,4370
"12169",228778,2000,1,0,"THE UNIVERSITY OF TEXAS AT AUSTIN",NA,NA,7551,3857,3694,3447,1403,2044,0.53,0.456,0.38,2400,4727
"12170",228778,2001,1,0,"THE UNIVERSITY OF TEXAS AT AUSTIN",NA,NA,7198,3742,3456,3385,1392,1993,0.533,0.47,0.403,2520,4383
"12171",228778,2002,1,0,"THE UNIVERSITY OF TEXAS AT AUSTIN",NA,NA,7842,4111,3731,3769,1531,2238,0.544,0.481,0.41,2640,4828
"12172",228778,2003,1,0,"THE UNIVERSITY OF TEXAS AT AUSTIN",NA,NA,6477,3537,2940,3300,1309,1991,0.563,0.509,0.445,2760,3831
"12173",228778,2004,1,0,"THE UNIVERSITY OF TEXAS AT AUSTIN",NA,NA,6741,3693,3048,3540,1426,2114,0.572,0.525,0.468,4260,3874
"12174",228778,2005,1,0,"The University of Texas at Austin",NA,NA,6783,3630,3153,3572,1419,2153,0.593,0.527,0.45,6972,3764
"12175",228778,2006,1,0,"The University of Texas at Austin",NA,NA,7369,4008,3361,3731,1482,2249,0.561,0.506,0.441,7630,4001
"12176",228778,2007,1,0,"The University of Texas at Austin",NA,NA,7419,3973,3446,3776,1472,2304,0.58,0.509,0.427,7670,3807
"12177",228778,2008,1,0,"The University of Texas at Austin",NA,NA,6679,3679,3000,3487,1358,2129,0.579,0.522,0.453,8532,3491
"12178",228778,2009,1,0,"The University of Texas at Austin",NA,NA,7198,3853,3345,3746,1514,2232,0.579,0.52,0.453,8936,3675
"12179",228778,2010,1,0,"The University of Texas at Austin",NA,NA,7232,3869,3363,3986,1608,2378,0.615,0.551,0.478,9416,3445
"12180",228787,1991,1,0,"UNIVERSITY OF TEXAS AT DALLAS",NA,NA,99,50,49,21,10,11,0.22,0.212,0.204,1070,54
"12181",228787,1992,1,0,"UNIVERSITY OF TEXAS AT DALLAS",NA,NA,93,34,59,21,9,12,0.353,0.226,0.153,1096,62
"12182",228787,1993,1,0,"THE UNIVERSITY OF TEXAS AT DALLAS",NA,NA,414,156,258,125,76,49,0.314,0.302,0.295,1450,297
"12183",228787,1995,1,0,"THE UNIVERSITY OF TEXAS AT DALLAS",NA,NA,351,154,197,113,45,68,0.442,0.322,0.228,2033,211
"12184",228787,1996,1,0,"THE UNIVERSITY OF TEXAS AT DALLAS",NA,NA,451,199,252,138,59,79,0.397,0.306,0.234,2333,300
"12185",228787,1997,1,0,"THE UNIVERSITY OF TEXAS AT DALLAS",NA,NA,444,183,261,143,77,66,0.361,0.322,0.295,2788,279
"12186",228787,1998,1,0,"THE UNIVERSITY OF TEXAS AT DALLAS",NA,NA,494,213,281,187,98,89,0.418,0.379,0.349,3117,308
"12187",228787,1999,1,0,"THE UNIVERSITY OF TEXAS AT DALLAS",NA,NA,603,242,361,180,88,92,0.38,0.299,0.244,1140,376
"12188",228787,2000,1,0,"THE UNIVERSITY OF TEXAS AT DALLAS",NA,NA,801,303,498,248,127,121,0.399,0.31,0.255,960,469
"12189",228787,2001,1,0,"THE UNIVERSITY OF TEXAS AT DALLAS",NA,NA,984,402,582,304,145,159,0.395,0.309,0.249,1008,563
"12190",228787,2002,1,0,"THE UNIVERSITY OF TEXAS AT DALLAS",NA,NA,903,405,498,325,141,184,0.454,0.36,0.283,1056,537
"12191",228787,2003,1,0,"THE UNIVERSITY OF TEXAS AT DALLAS",NA,NA,1043,420,623,446,242,204,0.486,0.428,0.388,1104,647
"12192",228787,2004,1,0,"THE UNIVERSITY OF TEXAS AT DALLAS",NA,NA,1129,429,700,473,255,218,0.508,0.419,0.364,1152,669
"12193",228787,2005,1,0,"The University of Texas at Dallas",NA,NA,1058,403,655,433,235,198,0.491,0.409,0.359,5904,636
"12194",228787,2006,1,0,"The University of Texas at Dallas",NA,NA,1053,394,659,470,252,218,0.553,0.446,0.382,6940,640
"12195",228787,2007,1,0,"The University of Texas at Dallas",NA,NA,1030,421,609,472,237,235,0.558,0.458,0.389,7356,563
"12196",228787,2008,1,0,"The University of Texas at Dallas",NA,NA,1090,434,656,553,280,273,0.629,0.507,0.427,9050,550
"12197",228787,2009,1,0,"The University of Texas at Dallas",NA,NA,1293,560,733,615,304,311,0.555,0.476,0.415,9510,606
"12198",228787,2010,1,0,"The University of Texas at Dallas",NA,NA,1346,544,802,680,362,318,0.585,0.505,0.451,9886,559
"12199",228796,1991,1,0,"UNIVERSITY OF TEXAS AT EL PASO",NA,NA,1897,1005,892,45,16,29,0.029,0.024,0.018,990,352
"12200",228796,1992,1,0,"UNIVERSITY OF TEXAS AT EL PASO",NA,NA,1846,989,857,38,18,20,0.02,0.021,0.021,1318,296
"12201",228796,1993,1,0,"THE UNIVERSITY OF TEXAS AT EL PASO",NA,NA,1948,1023,925,59,22,37,0.036,0.03,0.024,1480,291
"12202",228796,1995,1,0,"THE UNIVERSITY OF TEXAS AT EL PASO",NA,NA,1618,887,731,36,12,24,0.027,0.022,0.016,1897,192
"12203",228796,1996,1,0,"THE UNIVERSITY OF TEXAS AT EL PASO",NA,NA,1393,728,665,38,13,25,0.034,0.027,0.02,1981,189
"12204",228796,1997,1,0,"THE UNIVERSITY OF TEXAS AT EL PASO",NA,NA,1482,750,732,36,15,21,0.028,0.024,0.02,2272,158
"12205",228796,1998,1,0,"THE UNIVERSITY OF TEXAS AT EL PASO",NA,NA,1639,847,792,58,21,37,0.044,0.035,0.027,2336,158
"12206",228796,1999,1,0,"THE UNIVERSITY OF TEXAS AT EL PASO",NA,NA,1662,874,788,79,22,57,0.065,0.048,0.028,2040,194
"12207",228796,2000,1,0,"THE UNIVERSITY OF TEXAS AT EL PASO",NA,NA,2018,1046,972,85,30,55,0.053,0.042,0.031,1776,202
"12208",228796,2001,1,0,"THE UNIVERSITY OF TEXAS AT EL PASO",NA,NA,2156,1156,1000,89,30,59,0.051,0.041,0.03,1920,208
"12209",228796,2002,1,0,"THE UNIVERSITY OF TEXAS AT EL PASO",NA,NA,2279,1202,1077,101,41,60,0.05,0.044,0.038,2064,190
"12210",228796,2003,1,0,"THE UNIVERSITY OF TEXAS AT EL PASO",NA,NA,2386,1237,1149,111,46,65,0.052,0.047,0.04,2208,179
"12211",228796,2004,1,0,"THE UNIVERSITY OF TEXAS AT EL PASO",NA,NA,2296,1205,1091,174,58,116,0.096,0.076,0.053,3780,170
"12212",228796,2005,1,0,"The University of Texas at El Paso",NA,NA,2154,1085,1069,210,74,136,0.125,0.097,0.069,3930,175
"12213",228796,2006,1,0,"The University of Texas at El Paso",NA,NA,2446,1256,1190,269,95,174,0.138,0.11,0.08,4065,161
"12214",228796,2007,1,0,"The University of Texas at El Paso",NA,NA,2017,1046,971,245,94,151,0.144,0.121,0.097,4311,152
"12215",228796,2008,1,0,"The University of Texas at El Paso",NA,NA,2060,1006,1054,251,83,168,0.167,0.122,0.079,4551,132
"12216",228796,2009,1,0,"The University of Texas at El Paso",NA,NA,2281,1153,1128,274,95,179,0.155,0.12,0.084,4806,142
"12217",228796,2010,1,0,"The University of Texas at El Paso",NA,NA,2450,1262,1188,363,134,229,0.182,0.148,0.113,5063,207
"12218",228875,1991,1,0,"TEXAS CHRISTIAN UNIVERSITY",NA,NA,1212,745,467,417,128,289,0.388,0.344,0.274,8166,1068
"12219",228875,1992,1,0,"TEXAS CHRISTIAN UNIVERSITY",NA,NA,1261,746,515,506,161,345,0.462,0.401,0.313,8570,1085
"12220",228875,1993,1,0,"TEXAS CHRISTIAN UNIVERSITY",NA,NA,1189,690,499,467,162,305,0.442,0.393,0.325,8970,991
"12221",228875,1995,1,0,"TEXAS CHRISTIAN UNIVERSITY",NA,NA,1325,813,512,511,146,365,0.449,0.386,0.285,10040,1099
"12222",228875,1996,1,0,"TEXAS CHRISTIAN UNIVERSITY",NA,NA,1238,735,503,502,181,321,0.437,0.405,0.36,10510,1008
"12223",228875,1997,1,0,"TEXAS CHRISTIAN UNIVERSITY",NA,NA,1463,885,578,563,167,396,0.448,0.385,0.289,11090,1204
"12224",228875,1998,1,0,"TEXAS CHRISTIAN UNIVERSITY",NA,NA,1397,839,558,587,177,410,0.489,0.42,0.317,11590,1211
"12225",228875,1999,1,0,"TEXAS CHRISTIAN UNIVERSITY",NA,NA,1427,869,558,678,208,470,0.541,0.475,0.373,10950,1202
"12226",228875,2000,1,0,"TEXAS CHRISTIAN UNIVERSITY",NA,NA,1493,902,591,671,210,461,0.511,0.449,0.355,11700,1219
"12227",228875,2001,1,0,"TEXAS CHRISTIAN UNIVERSITY",NA,NA,1514,894,620,761,251,510,0.571,0.503,0.405,15000,1241
"12228",228875,2002,1,0,"TEXAS CHRISTIAN UNIVERSITY",NA,NA,1450,904,546,719,207,512,0.566,0.496,0.379,16300,1172
"12229",228875,2003,1,0,"TEXAS CHRISTIAN UNIVERSITY",NA,NA,1598,1005,593,877,273,604,0.601,0.549,0.46,17590,1269
"12230",228875,2004,1,0,"TEXAS CHRISTIAN UNIVERSITY",NA,NA,1605,988,617,866,276,590,0.597,0.54,0.447,19700,1319
"12231",228875,2005,1,0,"Texas Christian University",NA,NA,1610,977,633,875,284,591,0.605,0.543,0.449,21280,1268
"12232",228875,2006,1,0,"Texas Christian University",NA,NA,1654,985,669,950,328,622,0.631,0.574,0.49,22980,1264
"12233",228875,2007,1,0,"Texas Christian University",NA,NA,1642,965,677,961,348,613,0.635,0.585,0.514,24820,1244
"12234",228875,2008,1,0,"Texas Christian University",NA,NA,1628,996,632,954,309,645,0.648,0.586,0.489,26900,1222
"12235",228875,2009,1,0,"Texas Christian University",NA,NA,1818,1142,676,1068,348,720,0.63,0.587,0.515,28250,1381
"12236",228875,2010,1,0,"Texas Christian University",NA,NA,1824,1104,720,1141,397,744,0.674,0.626,0.551,30000,1400
"12237",228981,1991,1,0,"TEXAS LUTHERAN COLLEGE",NA,NA,241,156,85,63,20,43,0.276,0.261,0.235,6340,171
"12238",228981,1992,1,0,"TEXAS LUTHERAN COLLEGE",NA,NA,251,148,103,65,22,43,0.291,0.259,0.214,6840,190
"12239",228981,1993,1,0,"TEXAS LUTHERAN COLLEGE",NA,NA,213,134,79,65,24,41,0.306,0.305,0.304,7460,163
"12240",228981,1995,1,0,"TEXAS LUTHERAN COLLEGE",NA,NA,213,142,71,78,20,58,0.409,0.366,0.282,8626,165
"12241",228981,1996,1,0,"TEXAS LUTHERAN COLLEGE",NA,NA,210,132,78,79,23,56,0.424,0.376,0.295,9450,156
"12242",228981,1997,1,0,"TEXAS LUTHERAN UNIVERSITY",NA,NA,312,186,126,118,38,80,0.43,0.378,0.302,10370,228
"12243",228981,1998,1,0,"TEXAS LUTHERAN UNIVERSITY",NA,NA,366,180,186,101,34,67,0.372,0.276,0.183,10876,250
"12244",228981,1999,1,0,"TEXAS LUTHERAN UNIVERSITY",NA,NA,383,170,213,112,45,67,0.394,0.292,0.211,11374,275
"12245",228981,2000,1,0,"TEXAS LUTHERAN UNIVERSITY",NA,NA,330,175,155,125,48,77,0.44,0.379,0.31,12500,242
"12246",228981,2001,1,0,"TEXAS LUTHERAN UNIVERSITY",NA,NA,376,208,168,133,42,91,0.438,0.354,0.25,13440,282
"12247",228981,2002,1,0,"TEXAS LUTHERAN UNIVERSITY",NA,NA,371,181,190,111,34,77,0.425,0.299,0.179,14450,267
"12248",228981,2003,1,0,"TEXAS LUTHERAN UNIVERSITY",NA,NA,375,212,163,117,38,79,0.373,0.312,0.233,15470,256
"12249",228981,2004,1,0,"TEXAS LUTHERAN UNIVERSITY",NA,NA,399,202,197,105,40,65,0.322,0.263,0.203,16480,270
"12250",228981,2005,1,0,"Texas Lutheran University",NA,NA,379,182,197,106,35,71,0.39,0.28,0.178,17600,275
"12251",228981,2006,1,0,"Texas Lutheran University",NA,NA,387,197,190,105,39,66,0.335,0.271,0.205,18720,261
"12252",228981,2007,1,0,"Texas Lutheran University",NA,NA,365,177,188,114,39,75,0.424,0.312,0.207,19940,228
"12253",228981,2008,1,0,"Texas Lutheran University",NA,NA,396,191,205,123,44,79,0.414,0.311,0.215,20840,233
"12254",228981,2009,1,0,"Texas Lutheran University",NA,NA,345,171,174,104,43,61,0.357,0.301,0.247,21780,198
"12255",228981,2010,1,0,"Texas Lutheran University",NA,NA,338,159,179,102,39,63,0.396,0.302,0.218,22760,173
"12256",229018,1991,1,0,"UNIVERSITY OF TEXAS OF THE PERMIAN BASIN",NA,NA,46,26,20,5,4,1,0.038,0.109,0.2,1311,34
"12257",229018,1992,1,0,"UNIVERSITY OF TEXAS OF THE PERMIAN BASIN",NA,NA,71,46,25,6,3,3,0.065,0.085,0.12,1275,43
"12258",229018,1993,1,0,"THE UNIVERSITY OF TEXAS OF THE PERMIAN BASIN",NA,NA,78,41,37,8,3,5,0.122,0.103,0.081,1462,49
"12259",229018,1995,1,0,"THE UNIVERSITY OF TEXAS OF THE PERMIAN BASIN",NA,NA,100,61,39,10,3,7,0.115,0.1,0.077,1830,56
"12260",229018,1996,1,0,"THE UNIVERSITY OF TEXAS OF THE PERMIAN BASIN",NA,NA,108,58,50,10,6,4,0.069,0.093,0.12,1638,56
"12261",229018,1997,1,0,"THE UNIVERSITY OF TEXAS OF THE PERMIAN BASIN",NA,NA,113,60,53,17,2,15,0.25,0.15,0.038,2106,66
"12262",229018,1998,1,0,"THE UNIVERSITY OF TEXAS OF THE PERMIAN BASIN",NA,NA,112,69,43,19,7,12,0.174,0.17,0.163,2280,54
"12263",229018,1999,1,0,"THE UNIVERSITY OF TEXAS OF THE PERMIAN BASIN",NA,NA,97,65,32,15,5,10,0.154,0.155,0.156,912,62
"12264",229018,2000,1,0,"THE UNIVERSITY OF TEXAS OF THE PERMIAN BASIN",NA,NA,144,86,58,23,8,15,0.174,0.16,0.138,960,67
"12265",229018,2001,1,0,"THE UNIVERSITY OF TEXAS OF THE PERMIAN BASIN",NA,NA,165,104,61,36,9,27,0.26,0.218,0.148,1800,88
"12266",229018,2002,1,0,"THE UNIVERSITY OF TEXAS OF THE PERMIAN BASIN",NA,NA,216,126,90,31,9,22,0.175,0.144,0.1,1920,123
"12267",229018,2003,1,0,"THE UNIVERSITY OF TEXAS OF THE PERMIAN BASIN",NA,NA,292,160,132,52,19,33,0.206,0.178,0.144,2064,145
"12268",229018,2004,1,0,"THE UNIVERSITY OF TEXAS OF THE PERMIAN BASIN",NA,NA,258,136,122,39,16,23,0.169,0.151,0.131,2400,147
"12269",229018,2005,1,0,"The University of Texas of the Permian Basin",NA,NA,300,173,127,53,18,35,0.202,0.177,0.142,2616,134
"12270",229018,2006,1,0,"The University of Texas of the Permian Basin",NA,NA,315,178,137,55,18,37,0.208,0.175,0.131,2832,144
"12271",229018,2007,1,0,"The University of Texas of the Permian Basin",NA,NA,372,198,174,48,15,33,0.167,0.129,0.086,3096,170
"12272",229018,2008,1,0,"The University of Texas of the Permian Basin",NA,NA,332,176,156,65,19,46,0.261,0.196,0.122,3264,158
"12273",229018,2009,1,0,"The University of Texas of the Permian Basin",NA,NA,326,176,150,72,29,43,0.244,0.221,0.193,3504,135
"12274",229018,2010,1,0,"The University of Texas of the Permian Basin",NA,NA,341,180,161,71,29,42,0.233,0.208,0.18,3600,156
"12275",229027,1991,1,0,"UNIVERSITY OF TEXAS AT SAN ANTONIO",NA,NA,1479,799,680,69,27,42,0.053,0.047,0.04,1482,817
"12276",229027,1992,1,0,"UNIVERSITY OF TEXAS AT SAN ANTONIO",NA,NA,1558,834,724,120,38,82,0.098,0.077,0.052,2086,872
"12277",229027,1993,1,0,"THE UNIVERSITY OF TEXAS AT SAN ANTONIO",NA,NA,1591,855,736,84,43,41,0.048,0.053,0.058,2298,823
"12278",229027,1995,1,0,"THE UNIVERSITY OF TEXAS AT SAN ANTONIO",NA,NA,1528,821,707,79,20,59,0.072,0.052,0.028,2542,750
"12279",229027,1996,1,0,"THE UNIVERSITY OF TEXAS AT SAN ANTONIO",NA,NA,1679,852,827,93,39,54,0.063,0.055,0.047,2393,740
"12280",229027,1997,1,0,"THE UNIVERSITY OF TEXAS AT SAN ANTONIO",NA,NA,1749,938,811,109,30,79,0.084,0.062,0.037,2110,740
"12281",229027,1998,1,0,"THE UNIVERSITY OF TEXAS AT SAN ANTONIO",NA,NA,2067,1099,968,152,38,114,0.104,0.074,0.039,2336,881
"12282",229027,1999,1,0,"THE UNIVERSITY OF TEXAS AT SAN ANTONIO",NA,NA,1665,882,783,105,32,73,0.083,0.063,0.041,1728,615
"12283",229027,2000,1,0,"THE UNIVERSITY OF TEXAS AT SAN ANTONIO",NA,NA,1727,894,833,121,47,74,0.083,0.07,0.056,1920,710
"12284",229027,2001,1,0,"THE UNIVERSITY OF TEXAS AT SAN ANTONIO",NA,NA,1910,977,933,137,60,77,0.079,0.072,0.064,2016,751
"12285",229027,2002,1,0,"THE UNIVERSITY OF TEXAS AT SAN ANTONIO",NA,NA,3001,1619,1382,234,76,158,0.098,0.078,0.055,2112,1153
"12286",229027,2003,1,0,"THE UNIVERSITY OF TEXAS AT SAN ANTONIO",NA,NA,4091,2070,2021,310,107,203,0.098,0.076,0.053,2208,1697
"12287",229027,2004,1,0,"THE UNIVERSITY OF TEXAS AT SAN ANTONIO",NA,NA,4193,2129,2064,315,103,212,0.1,0.075,0.05,2976,1723
"12288",229027,2005,1,0,"The University of Texas at San Antonio",NA,NA,4360,2240,2120,348,127,221,0.099,0.08,0.06,3174,1735
"12289",229027,2006,1,0,"The University of Texas at San Antonio",NA,NA,4687,2389,2298,424,155,269,0.113,0.09,0.067,3414,2054
"12290",229027,2007,1,0,"The University of Texas at San Antonio",NA,NA,4833,2309,2524,465,179,286,0.124,0.096,0.071,3624,2043
"12291",229027,2008,1,0,"The University of Texas at San Antonio",NA,NA,4758,2432,2326,512,198,314,0.129,0.108,0.085,3840,1885
"12292",229027,2009,1,0,"The University of Texas at San Antonio",NA,NA,4559,2281,2278,507,180,327,0.143,0.111,0.079,4100,1684
"12293",229027,2010,1,0,"The University of Texas at San Antonio",NA,NA,4811,2243,2568,610,248,362,0.161,0.127,0.097,4362,1562
"12294",229115,1991,1,0,"TEXAS TECH UNIVERSITY",NA,NA,2838,1439,1399,468,167,301,0.209,0.165,0.119,1498,2356
"12295",229115,1992,1,0,"TEXAS TECH UNIVERSITY",NA,NA,2823,1418,1405,528,195,333,0.235,0.187,0.139,1489,2326
"12296",229115,1993,1,0,"TEXAS TECH UNIVERSITY",NA,NA,3073,1525,1548,520,196,324,0.212,0.169,0.127,1550,2567
"12297",229115,1995,1,0,"TEXAS TECH UNIVERSITY",NA,NA,3461,1764,1697,747,260,487,0.276,0.216,0.153,2200,2876
"12298",229115,1996,1,0,"TEXAS TECH UNIVERSITY",NA,NA,3632,1860,1772,746,252,494,0.266,0.205,0.142,2496,3037
"12299",229115,1997,1,0,"TEXAS TECH UNIVERSITY",NA,NA,3221,1625,1596,764,302,462,0.284,0.237,0.189,2747,2749
"12300",229115,1998,1,0,"TEXAS TECH UNIVERSITY",NA,NA,3149,1581,1568,804,283,521,0.33,0.255,0.18,2971,2674
"12301",229115,1999,1,0,"TEXAS TECH UNIVERSITY",NA,NA,3403,1725,1678,785,248,537,0.311,0.231,0.148,1140,2892
"12302",229115,2000,1,0,"TEXAS TECH UNIVERSITY",NA,NA,3998,1982,2016,1005,359,646,0.326,0.251,0.178,2400,3346
"12303",229115,2001,1,0,"TEXAS TECH UNIVERSITY",NA,NA,4075,1967,2108,1133,438,695,0.353,0.278,0.208,2520,3450
"12304",229115,2002,1,0,"TEXAS TECH UNIVERSITY",NA,NA,4283,2066,2217,1302,551,751,0.364,0.304,0.249,2640,3560
"12305",229115,2003,1,0,"TEXAS TECH UNIVERSITY",NA,NA,4312,2039,2273,1372,547,825,0.405,0.318,0.241,2208,3597
"12306",229115,2004,1,0,"TEXAS TECH UNIVERSITY",NA,NA,3833,1894,1939,1419,554,865,0.457,0.37,0.286,2976,3137
"12307",229115,2005,1,0,"Texas Tech University",NA,NA,3743,1829,1914,1323,530,793,0.434,0.353,0.277,3096,3021
"12308",229115,2006,1,0,"Texas Tech University",NA,NA,3862,1844,2018,1427,601,826,0.448,0.369,0.298,3240,3076
"12309",229115,2007,1,0,"Texas Tech University",NA,NA,4439,2065,2374,1455,600,855,0.414,0.328,0.253,3448,3430
"12310",229115,2008,1,0,"Texas Tech University",NA,NA,4338,2056,2282,1413,560,853,0.415,0.326,0.245,3448,3251
"12311",229115,2009,1,0,"Texas Tech University",NA,NA,4514,2185,2329,1582,641,941,0.431,0.35,0.275,3900,3234
"12312",229115,2010,1,0,"Texas Tech University",NA,NA,4759,2290,2469,1623,645,978,0.427,0.341,0.261,4296,3198
"12313",229780,1991,1,0,"WAYLAND BAPTIST UNIVERSITY",NA,NA,133,79,54,28,9,19,0.241,0.211,0.167,5464,95
"12314",229780,1992,1,0,"WAYLAND BAPTIST UNIVERSITY",NA,NA,133,84,49,20,7,13,0.155,0.15,0.143,5626,100
"12315",229780,1993,1,0,"WAYLAND BAPTIST UNIVERSITY",NA,NA,166,106,60,26,10,16,0.151,0.157,0.167,5626,105
"12316",229780,1995,1,0,"WAYLAND BAPTIST UNIVERSITY",NA,NA,167,102,65,26,7,19,0.186,0.156,0.108,6110,100
"12317",229780,1996,1,0,"WAYLAND BAPTIST UNIVERSITY",NA,NA,228,134,94,41,10,31,0.231,0.18,0.106,6395,159
"12318",229780,1997,1,0,"WAYLAND BAPTIST UNIVERSITY",NA,NA,241,132,109,58,21,37,0.28,0.241,0.193,6674,185
"12319",229780,1998,1,0,"WAYLAND BAPTIST UNIVERSITY",NA,NA,244,120,124,37,9,28,0.233,0.152,0.073,7108,169
"12320",229780,1999,1,0,"WAYLAND BAPTIST UNIVERSITY",NA,NA,210,108,102,39,15,24,0.222,0.186,0.147,7050,105
"12321",229780,2000,1,0,"WAYLAND BAPTIST UNIVERSITY",NA,NA,216,120,96,30,6,24,0.2,0.139,0.062,7500,156
"12322",229780,2001,1,0,"WAYLAND BAPTIST UNIVERSITY",NA,NA,204,111,93,50,17,33,0.297,0.245,0.183,7800,62
"12323",229780,2002,1,0,"WAYLAND BAPTIST UNIVERSITY",NA,NA,182,104,78,41,13,28,0.269,0.225,0.167,8100,79
"12324",229780,2003,1,0,"WAYLAND BAPTIST UNIVERSITY",NA,NA,205,112,93,41,13,28,0.25,0.2,0.14,8100,105
"12325",229780,2004,1,0,"WAYLAND BAPTIST UNIVERSITY",NA,NA,212,109,103,59,26,33,0.303,0.278,0.252,8850,131
"12326",229780,2005,1,0,"Wayland Baptist University",NA,NA,222,124,98,44,11,33,0.266,0.198,0.112,9450,148
"12327",229780,2006,1,0,"Wayland Baptist University",NA,NA,211,103,108,46,21,25,0.243,0.218,0.194,10200,149
"12328",229780,2007,1,0,"Wayland Baptist University",NA,NA,247,129,118,53,20,33,0.256,0.215,0.169,10650,137
"12329",229780,2008,1,0,"Wayland Baptist University",NA,NA,197,88,109,23,9,14,0.159,0.117,0.083,11400,115
"12330",229780,2009,1,0,"Wayland Baptist University",NA,NA,214,103,111,38,11,27,0.262,0.178,0.099,9480,110
"12331",229780,2010,1,0,"Wayland Baptist University",NA,NA,242,112,130,25,10,15,0.134,0.103,0.077,9960,106
"12332",229814,1991,1,0,"WEST TEXAS STATE UNIVERSITY",NA,NA,767,434,333,76,16,60,0.138,0.099,0.048,1154,625
"12333",229814,1992,1,0,"WEST TEXAS STATE UNIVERSITY",NA,NA,848,421,427,98,27,71,0.169,0.116,0.063,1353,714
"12334",229814,1993,1,0,"WEST TEXAS STATE UNIVERSITY",NA,NA,986,472,514,93,25,68,0.144,0.094,0.049,1444,776
"12335",229814,1995,1,0,"WEST TEXAS A & M UNIVERSITY",NA,NA,901,506,395,108,35,73,0.144,0.12,0.089,1645,749
"12336",229814,1996,1,0,"WEST TEXAS A & M UNIVERSITY",NA,NA,849,411,438,167,69,98,0.238,0.197,0.158,1853,702
"12337",229814,1997,1,0,"WEST TEXAS A & M UNIVERSITY",NA,NA,854,414,440,105,33,72,0.174,0.123,0.075,2068,709
"12338",229814,1998,1,0,"WEST TEXAS A & M UNIVERSITY",NA,NA,884,465,419,140,42,98,0.211,0.158,0.1,2205,742
"12339",229814,1999,1,0,"WEST TEXAS A & M UNIVERSITY",NA,NA,986,506,480,126,34,92,0.182,0.128,0.071,1755,797
"12340",229814,2000,1,0,"WEST TEXAS A & M UNIVERSITY",NA,NA,867,471,396,121,40,81,0.172,0.14,0.101,1875,661
"12341",229814,2001,1,0,"WEST TEXAS A & M UNIVERSITY",NA,NA,759,419,340,109,24,85,0.203,0.144,0.071,1668,594
"12342",229814,2002,1,0,"WEST TEXAS A & M UNIVERSITY",NA,NA,798,425,373,138,38,100,0.235,0.173,0.102,1740,606
"12343",229814,2003,1,0,"WEST TEXAS A & M UNIVERSITY",NA,NA,774,404,370,125,31,94,0.233,0.161,0.084,1956,595
"12344",229814,2004,1,0,"WEST TEXAS A & M UNIVERSITY",NA,NA,790,424,366,151,42,109,0.257,0.191,0.115,2064,589
"12345",229814,2005,1,0,"West Texas A & M University",NA,NA,768,409,359,171,66,105,0.257,0.223,0.184,2208,530
"12346",229814,2006,1,0,"West Texas A & M University",NA,NA,920,489,431,223,73,150,0.307,0.242,0.169,2568,624
"12347",229814,2007,1,0,"West Texas A & M University",NA,NA,923,480,443,227,79,148,0.308,0.246,0.178,3216,617
"12348",229814,2008,1,0,"West Texas A & M University",NA,NA,1149,599,550,259,83,176,0.294,0.225,0.151,3636,792
"12349",229814,2009,1,0,"West Texas A & M University",NA,NA,1193,603,590,260,78,182,0.302,0.218,0.132,4028,772
"12350",229814,2010,1,0,"West Texas A & M University",NA,NA,1227,637,590,336,102,234,0.367,0.274,0.173,4070,764
"12351",230603,1991,0,1,"SOUTHERN UTAH UNIVERSITY",1998,0,550,370,180,59,11,48,0.13,0.107,0.061,1419,523
"12352",230603,1992,0,1,"SOUTHERN UTAH UNIVERSITY",1998,0,649,421,228,84,18,66,0.157,0.129,0.079,1497,617
"12353",230603,1993,0,1,"SOUTHERN UTAH UNIVERSITY",1998,0,588,416,172,83,11,72,0.173,0.141,0.064,1599,569
"12354",230603,1995,0,1,"SOUTHERN UTAH UNIVERSITY",1998,0,643,471,172,90,16,74,0.157,0.14,0.093,1779,620
"12355",230603,1996,0,1,"SOUTHERN UTAH UNIVERSITY",1998,0,626,443,183,69,19,50,0.113,0.11,0.104,1800,595
"12356",230603,1997,0,1,"SOUTHERN UTAH UNIVERSITY",1998,0,717,530,187,113,18,95,0.179,0.158,0.096,1854,681
"12357",230603,1998,1,0,"SOUTHERN UTAH UNIVERSITY",1998,1,667,487,180,113,7,106,0.218,0.169,0.039,1909,631
"12358",230603,1999,1,0,"SOUTHERN UTAH UNIVERSITY",1998,1,629,456,173,103,9,94,0.206,0.164,0.052,1524,598
"12359",230603,2000,1,0,"SOUTHERN UTAH UNIVERSITY",1998,1,513,414,99,98,12,86,0.208,0.191,0.121,1612,468
"12360",230603,2001,1,0,"SOUTHERN UTAH UNIVERSITY",1998,1,562,443,119,113,18,95,0.214,0.201,0.151,1732,509
"12361",230603,2002,1,0,"SOUTHERN UTAH UNIVERSITY",1998,1,528,383,145,106,12,94,0.245,0.201,0.083,1888,478
"12362",230603,2003,1,0,"SOUTHERN UTAH UNIVERSITY",1998,1,478,338,140,103,17,86,0.254,0.215,0.121,2332,429
"12363",230603,2004,1,0,"SOUTHERN UTAH UNIVERSITY",1998,1,656,445,211,130,18,112,0.252,0.198,0.085,2588,581
"12364",230603,2005,1,0,"Southern Utah University",1998,1,784,527,257,137,30,107,0.203,0.175,0.117,2834,666
"12365",230603,2006,1,0,"Southern Utah University",1998,1,832,594,238,164,23,141,0.237,0.197,0.097,3060,713
"12366",230603,2007,1,0,"Southern Utah University",1998,1,865,579,286,185,39,146,0.252,0.214,0.136,3274,724
"12367",230603,2008,1,0,"Southern Utah University",1998,1,836,574,262,169,29,140,0.244,0.202,0.111,3502,733
"12368",230603,2009,1,0,"Southern Utah University",1998,1,1101,742,359,193,42,151,0.204,0.175,0.117,3730,921
"12369",230603,2010,1,0,"Southern Utah University",1998,1,1103,768,335,232,43,189,0.246,0.21,0.128,4196,928
"12370",230728,1991,0,1,"UTAH STATE UNIVERSITY",1998,0,1359,857,502,1,1,0,0,0.001,0.002,1680,1210
"12371",230728,1992,0,1,"UTAH STATE UNIVERSITY",1998,0,1237,847,390,186,31,155,0.183,0.15,0.079,1821,1088
"12372",230728,1993,0,1,"UTAH STATE UNIVERSITY",1998,0,1321,850,471,212,42,170,0.2,0.16,0.089,1896,1162
"12373",230728,1995,0,1,"UTAH STATE UNIVERSITY",1998,0,1175,803,372,251,43,208,0.259,0.214,0.116,1992,1091
"12374",230728,1996,0,1,"UTAH STATE UNIVERSITY",1998,0,967,685,282,267,41,226,0.33,0.276,0.145,1971,882
"12375",230728,1997,0,1,"UTAH STATE UNIVERSITY",1998,0,1465,1029,436,304,60,244,0.237,0.208,0.138,2174,1364
"12376",230728,1998,1,0,"UTAH STATE UNIVERSITY",1998,1,1764,1229,535,328,43,285,0.232,0.186,0.08,2245,1589
"12377",230728,1999,1,0,"UTAH STATE UNIVERSITY",1998,1,1521,1047,474,320,67,253,0.242,0.21,0.141,1871,1381
"12378",230728,2000,1,0,"UTAH STATE UNIVERSITY",1998,1,1632,1116,516,357,76,281,0.252,0.219,0.147,1947,1418
"12379",230728,2001,1,0,"UTAH STATE UNIVERSITY",1998,1,1892,1270,622,384,72,312,0.246,0.203,0.116,2123,1639
"12380",230728,2002,1,0,"UTAH STATE UNIVERSITY",1998,1,1497,1010,487,423,81,342,0.339,0.283,0.166,2388,1359
"12381",230728,2003,1,0,"UTAH STATE UNIVERSITY",1998,1,1829,1229,600,491,86,405,0.33,0.268,0.143,2615,1647
"12382",230728,2004,1,0,"UTAH STATE UNIVERSITY",1998,1,1591,1048,543,433,70,363,0.346,0.272,0.129,2850,1448
"12383",230728,2005,1,0,"Utah State University",1998,1,1618,1065,553,415,75,340,0.319,0.256,0.136,3128,1365
"12384",230728,2006,1,0,"Utah State University",1998,1,2429,1574,855,498,102,396,0.252,0.205,0.119,3378,2064
"12385",230728,2007,1,0,"Utah State University",1998,1,2654,1697,957,544,113,431,0.254,0.205,0.118,3615,2176
"12386",230728,2008,1,0,"Utah State University",1998,1,2580,1646,934,484,83,401,0.244,0.188,0.089,3832,2110
"12387",230728,2009,1,0,"Utah State University",1998,1,2664,1663,1001,508,100,408,0.245,0.191,0.1,4043,2176
"12388",230728,2010,1,0,"Utah State University",1998,1,2941,1882,1059,548,113,435,0.231,0.186,0.107,4047,2439
"12389",230764,1991,0,1,"UNIVERSITY OF UTAH",1998,0,1924,914,1010,268,107,161,0.176,0.139,0.106,1981,1664
"12390",230764,1992,0,1,"UNIVERSITY OF UTAH",1998,0,2026,996,1030,304,119,185,0.186,0.15,0.116,2104,1728
"12391",230764,1993,0,1,"UNIVERSITY OF UTAH",1998,0,1794,1004,790,202,59,143,0.142,0.113,0.075,2298,1447
"12392",230764,1995,0,1,"UNIVERSITY OF UTAH",1998,0,1356,837,519,284,73,211,0.252,0.209,0.141,2508,1156
"12393",230764,1996,0,1,"UNIVERSITY OF UTAH",1998,0,1800,1019,781,436,155,281,0.276,0.242,0.198,2514,1486
"12394",230764,1997,0,1,"UNIVERSITY OF UTAH",1998,0,1962,1039,923,407,133,274,0.264,0.207,0.144,2601,1633
"12395",230764,1998,1,0,"UNIVERSITY OF UTAH",1998,1,1702,991,711,363,116,247,0.249,0.213,0.163,2711,1370
"12396",230764,1999,1,0,"UNIVERSITY OF UTAH",1998,1,1921,921,1000,295,109,186,0.202,0.154,0.109,2278,1526
"12397",230764,2000,1,0,"UNIVERSITY OF UTAH",1998,1,2067,1029,1038,441,155,286,0.278,0.213,0.149,2371,1686
"12398",230764,2001,1,0,"UNIVERSITY OF UTAH",1998,1,1877,1038,839,390,135,255,0.246,0.208,0.161,2517,1480
"12399",230764,2002,1,0,"UNIVERSITY OF UTAH",1998,1,1962,1109,853,391,127,264,0.238,0.199,0.149,2742,1610
"12400",230764,2003,1,0,"UNIVERSITY OF UTAH",1998,1,1870,1073,797,405,129,276,0.257,0.217,0.162,3057,1453
"12401",230764,2004,1,0,"UNIVERSITY OF UTAH",1998,1,1997,1133,864,453,152,301,0.266,0.227,0.176,3364,1559
"12402",230764,2005,1,0,"University of Utah",1998,1,1997,1106,891,415,138,277,0.25,0.208,0.155,3628,1572
"12403",230764,2006,1,0,"University of Utah",1998,1,2037,1167,870,457,149,308,0.264,0.224,0.171,3972,1575
"12404",230764,2007,1,0,"University of Utah",1998,1,1953,1082,871,469,170,299,0.276,0.24,0.195,4270,1488
"12405",230764,2008,1,0,"University of Utah",1998,1,1908,1054,854,465,171,294,0.279,0.244,0.2,4525,1427
"12406",230764,2009,1,0,"University of Utah",1998,1,2102,1177,925,597,205,392,0.333,0.284,0.222,4956,1583
"12407",230764,2010,1,0,"University of Utah",1998,1,2269,1217,1052,663,237,426,0.35,0.292,0.225,5426,1629
"12408",230782,1991,0,1,"WEBER STATE UNIVERSITY",1998,0,1403,810,593,100,32,68,0.084,0.071,0.054,1458,1264
"12409",230782,1992,0,1,"WEBER STATE UNIVERSITY",1998,0,1211,729,482,52,15,37,0.051,0.043,0.031,1542,1050
"12410",230782,1993,0,1,"WEBER STATE UNIVERSITY",1998,0,1219,829,390,81,23,58,0.07,0.066,0.059,1638,1070
"12411",230782,1995,0,1,"WEBER STATE UNIVERSITY",1998,0,1338,889,449,109,23,86,0.097,0.081,0.051,1854,1142
"12412",230782,1996,0,1,"WEBER STATE UNIVERSITY",1998,0,1237,833,404,136,25,111,0.133,0.11,0.062,1863,1078
"12413",230782,1997,0,1,"WEBER STATE UNIVERSITY",1998,0,1503,978,525,152,37,115,0.118,0.101,0.07,1935,1298
"12414",230782,1998,1,0,"WEBER STATE UNIVERSITY",1998,1,1453,935,518,147,36,111,0.119,0.101,0.069,1986,854
"12415",230782,1999,1,0,"WEBER STATE UNIVERSITY",1998,1,1619,1001,618,158,47,111,0.111,0.098,0.076,1606,1220
"12416",230782,2000,1,0,"WEBER STATE UNIVERSITY",1998,1,1663,1000,663,135,39,96,0.096,0.081,0.059,1670,1214
"12417",230782,2001,1,0,"WEBER STATE UNIVERSITY",1998,1,1509,897,612,47,18,29,0.032,0.031,0.029,1786,1136
"12418",230782,2002,1,0,"WEBER STATE UNIVERSITY",1998,1,1675,1019,656,79,16,63,0.062,0.047,0.024,1946,1321
"12419",230782,2003,1,0,"WEBER STATE UNIVERSITY",1998,1,1688,944,744,90,31,59,0.062,0.053,0.042,2130,1225
"12420",230782,2004,1,0,"WEBER STATE UNIVERSITY",1998,1,1559,882,677,94,28,66,0.075,0.06,0.041,2344,749
"12421",230782,2005,1,0,"Weber State University",1998,1,1626,879,747,68,23,45,0.051,0.042,0.031,2573,962
"12422",230782,2006,1,0,"Weber State University",1998,1,1289,755,534,114,28,86,0.114,0.088,0.052,2793,792
"12423",230782,2007,1,0,"Weber State University",1998,1,1364,783,581,110,27,83,0.106,0.081,0.046,2988,881
"12424",230782,2008,1,0,"Weber State University",1998,1,1549,853,696,136,41,95,0.111,0.088,0.059,3153,1044
"12425",230782,2009,1,0,"Weber State University",1998,1,1845,1011,834,140,43,97,0.096,0.076,0.052,3365,1243
"12426",230782,2010,1,0,"Weber State University",1998,1,2041,1193,848,196,64,132,0.111,0.096,0.075,3559,1431
"12427",231059,1991,1,0,"SAINT MICHAEL'S COLLEGE",NA,NA,485,253,232,329,145,184,0.727,0.678,0.625,11165,467
"12428",231059,1992,1,0,"SAINT MICHAEL'S COLLEGE",NA,NA,414,211,203,277,121,156,0.739,0.669,0.596,11900,390
"12429",231059,1993,1,0,"SAINT MICHAELS COLLEGE",NA,NA,454,238,216,291,128,163,0.685,0.641,0.593,12430,442
"12430",231059,1995,1,0,"SAINT MICHAELS COLLEGE",NA,NA,529,301,228,383,160,223,0.741,0.724,0.702,13810,507
"12431",231059,1996,1,0,"SAINT MICHAELS COLLEGE",NA,NA,486,284,202,335,138,197,0.694,0.689,0.683,14640,461
"12432",231059,1997,1,0,"SAINT MICHAELS COLLEGE",NA,NA,528,279,249,358,158,200,0.717,0.678,0.635,15744,509
"12433",231059,1998,1,0,"SAINT MICHAELS COLLEGE",NA,NA,518,278,240,378,166,212,0.763,0.73,0.692,16310,503
"12434",231059,1999,1,0,"SAINT MICHAELS COLLEGE",NA,NA,501,269,232,342,145,197,0.732,0.683,0.625,17500,481
"12435",231059,2000,1,0,"SAINT MICHAELS COLLEGE",NA,NA,521,283,238,366,149,217,0.767,0.702,0.626,18615,500
"12436",231059,2001,1,0,"SAINT MICHAELS COLLEGE",NA,NA,518,286,232,380,150,230,0.804,0.734,0.647,19500,486
"12437",231059,2002,1,0,"SAINT MICHAELS COLLEGE",NA,NA,527,301,226,406,172,234,0.777,0.77,0.761,21010,498
"12438",231059,2003,1,0,"SAINT MICHAELS COLLEGE",NA,NA,512,263,249,362,158,204,0.776,0.707,0.635,22220,481
"12439",231059,2004,1,0,"SAINT MICHAELS COLLEGE",NA,NA,518,280,238,378,165,213,0.761,0.73,0.693,25325,497
"12440",231059,2005,1,0,"Saint Michaels College",NA,NA,592,331,261,454,188,266,0.804,0.767,0.72,26550,562
"12441",231059,2006,1,0,"Saint Michaels College",NA,NA,576,333,243,446,192,254,0.763,0.774,0.79,28280,546
"12442",231059,2007,1,0,"Saint Michaels College",NA,NA,524,280,244,364,154,210,0.75,0.695,0.631,29695,493
"12443",231059,2008,1,0,"Saint Michaels College",NA,NA,543,277,266,396,180,216,0.78,0.729,0.677,31675,516
"12444",231059,2009,1,0,"Saint Michael's College",NA,NA,470,230,240,322,146,176,0.765,0.685,0.608,32940,431
"12445",231059,2010,1,0,"Saint Michael's College",NA,NA,546,294,252,401,168,233,0.792,0.734,0.667,34555,490
"12446",231174,1991,1,0,"UNIVERSITY OF VERMONT",NA,NA,1821,929,892,884,385,499,0.537,0.485,0.432,5312,1715
"12447",231174,1992,1,0,"UNIVERSITY OF VERMONT AND ST AGRICULTURAL COLLEGE",NA,NA,1796,978,818,944,378,566,0.579,0.526,0.462,6166,1721
"12448",231174,1993,1,0,"UNIVERSITY OF VERMONT AND STATE AGRICULTURAL COLL",NA,NA,1706,955,751,828,319,509,0.533,0.485,0.425,6400,1612
"12449",231174,1995,1,0,"UNIVERSITY OF VERMONT AND STATE AGRICULTURAL COLL",NA,NA,1853,1037,816,853,338,515,0.497,0.46,0.414,6909,1749
"12450",231174,1996,1,0,"UNIVERSITY OF VERMONT AND STATE AGRICULTURAL COLL",NA,NA,1779,971,808,915,374,541,0.557,0.514,0.463,7726,1690
"12451",231174,1997,1,0,"UNIVERSITY OF VERMONT AND STATE AGRICULTURAL COLL",NA,NA,1823,1005,818,959,381,578,0.575,0.526,0.466,7550,1733
"12452",231174,1998,1,0,"UNIVERSITY OF VERMONT AND STATE AGRICULTURAL COLL",NA,NA,1758,994,764,872,336,536,0.539,0.496,0.44,7888,1656
"12453",231174,1999,1,0,"UNIVERSITY OF VERMONT AND STATE AGRICULTURAL COLL",NA,NA,1808,984,824,875,351,524,0.532,0.484,0.426,7464,1713
"12454",231174,2000,1,0,"UNIVERSITY OF VERMONT AND STATE AGRICULTURAL COLL",NA,NA,1765,988,777,917,344,573,0.58,0.52,0.443,7692,1654
"12455",231174,2001,1,0,"UNIVERSITY OF VERMONT AND STATE AGRICULTURAL COLL",NA,NA,1835,1052,783,1017,381,636,0.605,0.554,0.487,8040,1694
"12456",231174,2002,1,0,"UNIVERSITY OF VERMONT AND STATE AGRICULTURAL COLL",NA,NA,1828,1005,823,1000,415,585,0.582,0.547,0.504,8320,1709
"12457",231174,2003,1,0,"UNIVERSITY OF VERMONT AND STATE AGRICULTURAL COLL",NA,NA,1916,1089,827,1087,439,648,0.595,0.567,0.531,8696,1773
"12458",231174,2004,1,0,"UNIVERSITY OF VERMONT AND STATE AGRICULTURAL COLL",NA,NA,1953,1079,874,1188,476,712,0.66,0.608,0.545,9088,1792
"12459",231174,2005,1,0,"University of Vermont",NA,NA,2378,1287,1091,1367,568,799,0.621,0.575,0.521,9452,2193
"12460",231174,2006,1,0,"University of Vermont",NA,NA,2175,1251,924,1417,551,866,0.692,0.651,0.596,9832,2024
"12461",231174,2007,1,0,"University of Vermont",NA,NA,2432,1346,1086,1577,650,927,0.689,0.648,0.599,10422,2259
"12462",231174,2008,1,0,"University of Vermont",NA,NA,2453,1457,996,1611,617,994,0.682,0.657,0.619,11048,2233
"12463",231174,2009,1,0,"University of Vermont",NA,NA,2607,1482,1125,1733,691,1042,0.703,0.665,0.614,11712,2281
"12464",231174,2010,1,0,"University of Vermont",NA,NA,2452,1425,1027,1523,576,947,0.665,0.621,0.561,12180,2145
"12465",231420,1991,1,0,"AVERETT COLLEGE",NA,NA,106,67,39,7,2,5,0.075,0.066,0.051,8750,91
"12466",231420,1992,1,0,"AVERETT COLLEGE",NA,NA,104,62,42,25,6,19,0.306,0.24,0.143,9090,76
"12467",231420,1993,1,0,"AVERETT COLLEGE",NA,NA,168,101,67,56,17,39,0.386,0.333,0.254,9710,135
"12468",231420,1995,1,0,"AVERETT COLLEGE",NA,NA,147,79,68,35,13,22,0.278,0.238,0.191,10800,118
"12469",231420,1996,1,0,"AVERETT COLLEGE",NA,NA,149,81,68,42,20,22,0.272,0.282,0.294,11450,107
"12470",231420,1997,1,0,"AVERETT COLLEGE",NA,NA,160,91,69,43,16,27,0.297,0.269,0.232,12100,115
"12471",231420,1998,1,0,"AVERETT COLLEGE",NA,NA,145,78,67,31,18,13,0.167,0.214,0.269,12985,119
"12472",231420,1999,1,0,"AVERETT COLLEGE",NA,NA,204,123,81,72,22,50,0.406,0.353,0.272,13145,161
"12473",231420,2000,1,0,"AVERETT COLLEGE",NA,NA,192,64,128,44,17,27,0.422,0.229,0.133,13740,139
"12474",231420,2001,1,0,"AVERETT UNIVERSITY",NA,NA,175,81,94,48,12,36,0.444,0.274,0.128,14490,129
"12475",231420,2002,1,0,"AVERETT UNIVERSITY",NA,NA,187,90,97,59,20,39,0.433,0.316,0.206,15800,133
"12476",231420,2003,1,0,"AVERETT UNIVERSITY",NA,NA,219,83,136,78,34,44,0.53,0.356,0.25,16600,144
"12477",231420,2004,1,0,"AVERETT UNIVERSITY",NA,NA,191,68,123,53,25,28,0.412,0.277,0.203,17430,127
"12478",231420,2005,1,0,"Averett University",NA,NA,229,84,145,59,33,26,0.31,0.258,0.228,18040,158
"12479",231420,2006,1,0,"Averett University",NA,NA,160,60,100,45,19,26,0.433,0.281,0.19,18762,117
"12480",231420,2007,1,0,"Averett University",NA,NA,238,70,168,43,23,20,0.286,0.181,0.137,19512,131
"12481",231420,2008,1,0,"Averett University",NA,NA,234,88,146,53,17,36,0.409,0.226,0.116,20300,111
"12482",231420,2009,1,0,"Averett University",NA,NA,222,78,144,52,27,25,0.32,0.234,0.188,21112,115
"12483",231420,2010,1,0,"Averett University",NA,NA,264,98,166,89,36,53,0.541,0.337,0.217,21956,137
"12484",231554,1991,1,0,"BLUEFIELD COLLEGE",NA,NA,126,61,65,35,15,20,0.328,0.278,0.231,5400,117
"12485",231554,1992,1,0,"BLUEFIELD COLLEGE",NA,NA,150,72,78,49,29,20,0.278,0.327,0.372,5940,131
"12486",231554,1993,1,0,"BLUEFIELD COLLEGE",NA,NA,210,119,91,88,36,52,0.437,0.419,0.396,6500,196
"12487",231554,1995,1,0,"BLUEFIELD COLLEGE",NA,NA,139,68,71,47,22,25,0.368,0.338,0.31,7770,135
"12488",231554,1996,1,0,"BLUEFIELD COLLEGE",NA,NA,109,56,53,39,20,19,0.339,0.358,0.377,8200,103
"12489",231554,1997,1,0,"BLUEFIELD COLLEGE",NA,NA,130,64,66,44,19,25,0.391,0.338,0.288,9100,119
"12490",231554,1998,1,0,"BLUEFIELD COLLEGE",NA,NA,129,69,60,4,1,3,0.044,0.031,0.017,7030,119
"12491",231554,1999,1,0,"BLUEFIELD COLLEGE",NA,NA,144,79,65,43,18,25,0.316,0.299,0.277,6900,129
"12492",231554,2000,1,0,"BLUEFIELD COLLEGE",NA,NA,107,54,53,26,13,13,0.241,0.243,0.245,7900,94
"12493",231554,2001,1,0,"BLUEFIELD COLLEGE",NA,NA,162,91,71,53,21,32,0.352,0.327,0.296,8690,137
"12494",231554,2002,1,0,"BLUEFIELD COLLEGE",NA,NA,131,62,69,36,17,19,0.306,0.275,0.246,9345,113
"12495",231554,2003,1,0,"BLUEFIELD COLLEGE",NA,NA,83,50,33,27,10,17,0.34,0.325,0.303,9715,73
"12496",231554,2004,1,0,"BLUEFIELD COLLEGE",NA,NA,135,82,53,38,14,24,0.293,0.281,0.264,10105,123
"12497",231554,2005,1,0,"Bluefield College",NA,NA,103,57,46,32,15,17,0.298,0.311,0.326,10860,90
"12498",231554,2006,1,0,"Bluefield College",NA,NA,106,59,47,19,5,14,0.237,0.179,0.106,11675,90
"12499",231554,2007,1,0,"Bluefield College",NA,NA,89,49,40,34,10,24,0.49,0.382,0.25,12550,82
"12500",231554,2008,1,0,"Bluefield College",NA,NA,80,47,33,29,8,21,0.447,0.362,0.242,15000,52
"12501",231554,2009,1,0,"Bluefield College",NA,NA,115,64,51,36,11,25,0.391,0.313,0.216,17250,75
"12502",231554,2010,1,0,"Bluefield College",NA,NA,112,58,54,28,8,20,0.345,0.25,0.148,17990,77
"12503",231624,1991,1,0,"COLLEGE OF WILLIAM AND MARY",NA,NA,1222,609,613,920,413,507,0.833,0.753,0.674,3730,1024
"12504",231624,1992,1,0,"COLLEGE OF WILLIAM AND MARY",NA,NA,1202,680,522,954,386,568,0.835,0.794,0.739,4046,978
"12505",231624,1993,1,0,"COLLEGE OF WILLIAM AND MARY",NA,NA,1201,690,511,913,360,553,0.801,0.76,0.705,4414,994
"12506",231624,1995,1,0,"COLLEGE OF WILLIAM AND MARY",NA,NA,1369,850,519,1086,378,708,0.833,0.793,0.728,4738,1126
"12507",231624,1996,1,0,"COLLEGE OF WILLIAM AND MARY",NA,NA,1328,789,539,1053,381,672,0.852,0.793,0.707,4906,1135
"12508",231624,1997,1,0,"COLLEGE OF WILLIAM AND MARY",NA,NA,1327,802,525,1063,381,682,0.85,0.801,0.726,5032,1110
"12509",231624,1998,1,0,"COLLEGE OF WILLIAM AND MARY",NA,NA,1290,701,589,1007,412,595,0.849,0.781,0.699,5178,1085
"12510",231624,1999,1,0,"COLLEGE OF WILLIAM AND MARY",NA,NA,1298,736,562,1052,418,634,0.861,0.81,0.744,2302,1099
"12511",231624,2000,1,0,"COLLEGE OF WILLIAM AND MARY",NA,NA,1347,782,565,1118,425,693,0.886,0.83,0.752,2302,1121
"12512",231624,2001,1,0,"COLLEGE OF WILLIAM AND MARY",NA,NA,1358,793,565,1140,441,699,0.882,0.839,0.781,2302,1119
"12513",231624,2002,1,0,"COLLEGE OF WILLIAM AND MARY",NA,NA,1314,721,593,1082,456,626,0.868,0.823,0.769,2510,1069
"12514",231624,2003,1,0,"COLLEGE OF WILLIAM AND MARY",NA,NA,1319,736,583,1098,439,659,0.895,0.832,0.753,3760,860
"12515",231624,2004,1,0,"COLLEGE OF WILLIAM AND MARY",NA,NA,1335,683,652,1097,494,603,0.883,0.822,0.758,4330,870
"12516",231624,2005,1,0,"College of William and Mary",NA,NA,1339,714,625,1134,489,645,0.903,0.847,0.782,4730,954
"12517",231624,2006,1,0,"College of William and Mary",NA,NA,1341,693,648,1107,497,610,0.88,0.826,0.767,5180,856
"12518",231624,2007,1,0,"College of William and Mary",NA,NA,1341,729,612,1114,474,640,0.878,0.831,0.775,5549,760
"12519",231624,2008,1,0,"College of William and Mary",NA,NA,1381,780,601,1146,462,684,0.877,0.83,0.769,6090,715
"12520",231624,2009,1,0,"College of William and Mary",NA,NA,1384,728,656,1133,503,630,0.865,0.819,0.767,6388,712
"12521",231624,2010,1,0,"College of William and Mary",NA,NA,1396,791,605,1180,483,697,0.881,0.845,0.798,7523,868
"12522",231712,1991,1,0,"CHRISTOPHER NEWPORT COLLEGE",NA,NA,443,287,156,44,14,30,0.104,0.099,0.09,2285,355
"12523",231712,1992,1,0,"CHRISTOPHER NEWPORT UNIVERSITY",NA,NA,478,300,178,44,10,34,0.113,0.092,0.056,2860,387
"12524",231712,1993,1,0,"CHRISTOPHER NEWPORT UNIVERSITY",NA,NA,428,266,162,29,7,22,0.083,0.068,0.043,3196,345
"12525",231712,1995,1,0,"CHRISTOPHER NEWPORT UNIVERSITY",NA,NA,534,320,214,59,18,41,0.128,0.11,0.084,3350,426
"12526",231712,1996,1,0,"CHRISTOPHER NEWPORT UNIVERSITY",NA,NA,517,304,213,65,16,49,0.161,0.126,0.075,3326,393
"12527",231712,1997,1,0,"CHRISTOPHER NEWPORT UNIVERSITY",NA,NA,665,398,267,88,29,59,0.148,0.132,0.109,3466,504
"12528",231712,1998,1,0,"CHRISTOPHER NEWPORT UNIVERSITY",NA,NA,693,414,279,121,35,86,0.208,0.175,0.125,3474,569
"12529",231712,1999,1,0,"CHRISTOPHER NEWPORT UNIVERSITY",NA,NA,808,485,323,148,44,104,0.214,0.183,0.136,1888,648
"12530",231712,2000,1,0,"CHRISTOPHER NEWPORT UNIVERSITY",NA,NA,999,587,412,262,73,189,0.322,0.262,0.177,1888,827
"12531",231712,2001,1,0,"CHRISTOPHER NEWPORT UNIVERSITY",NA,NA,1042,595,447,318,100,218,0.366,0.305,0.224,1888,883
"12532",231712,2002,1,0,"CHRISTOPHER NEWPORT UNIVERSITY",NA,NA,1176,660,516,363,128,235,0.356,0.309,0.248,2058,1041
"12533",231712,2003,1,0,"CHRISTOPHER NEWPORT UNIVERSITY",NA,NA,1205,619,586,475,176,299,0.483,0.394,0.3,2814,1042
"12534",231712,2004,1,0,"CHRISTOPHER NEWPORT UNIVERSITY",NA,NA,1174,638,536,498,151,347,0.544,0.424,0.282,3152,1003
"12535",231712,2005,1,0,"Christopher Newport University",NA,NA,1245,667,578,578,203,375,0.562,0.464,0.351,3442,257
"12536",231712,2006,1,0,"Christopher Newport University",NA,NA,1172,644,528,594,203,391,0.607,0.507,0.384,3784,976
"12537",231712,2007,1,0,"Christopher Newport University",NA,NA,1241,706,535,618,200,418,0.592,0.498,0.374,4012,1017
"12538",231712,2008,1,0,"Christopher Newport University",NA,NA,1134,640,494,624,207,417,0.652,0.55,0.419,4172,897
"12539",231712,2009,1,0,"Christopher Newport University",NA,NA,1212,719,493,689,235,454,0.631,0.568,0.477,4380,962
"12540",231712,2010,1,0,"Christopher Newport University",NA,NA,1150,673,477,723,250,473,0.703,0.629,0.524,5280,890
"12541",232025,1991,1,0,"EMORY AND HENRY COLLEGE",NA,NA,143,78,65,82,36,46,0.59,0.573,0.554,7270,138
"12542",232025,1992,1,0,"EMORY AND HENRY COLLEGE",NA,NA,188,79,109,61,25,36,0.456,0.324,0.229,7820,175
"12543",232025,1993,1,0,"EMORY AND HENRY COLLEGE",NA,NA,230,120,110,91,30,61,0.508,0.396,0.273,8546,211
"12544",232025,1995,1,0,"EMORY AND HENRY COLLEGE",NA,NA,221,107,114,103,47,56,0.523,0.466,0.412,9990,200
"12545",232025,1996,1,0,"EMORY AND HENRY COLLEGE",NA,NA,256,121,135,123,52,71,0.587,0.48,0.385,10938,235
"12546",232025,1997,1,0,"EMORY AND HENRY COLLEGE",NA,NA,197,98,99,92,35,57,0.582,0.467,0.354,11572,190
"12547",232025,1998,1,0,"EMORY AND HENRY COLLEGE",NA,NA,290,144,146,120,43,77,0.535,0.414,0.295,11978,263
"12548",232025,1999,1,0,"EMORY AND HENRY COLLEGE",NA,NA,271,129,142,117,50,67,0.519,0.432,0.352,12596,243
"12549",232025,2000,1,0,"EMORY AND HENRY COLLEGE",NA,NA,251,127,124,126,53,73,0.575,0.502,0.427,12950,231
"12550",232025,2001,1,0,"EMORY AND HENRY COLLEGE",NA,NA,267,130,137,113,48,65,0.5,0.423,0.35,13900,240
"12551",232025,2002,1,0,"EMORY AND HENRY COLLEGE",NA,NA,235,130,105,118,48,70,0.538,0.502,0.457,14600,220
"12552",232025,2003,1,0,"EMORY AND HENRY COLLEGE",NA,NA,223,106,117,96,43,53,0.5,0.43,0.368,15700,205
"12553",232025,2004,1,0,"EMORY AND HENRY COLLEGE",NA,NA,260,142,118,125,48,77,0.542,0.481,0.407,16490,234
"12554",232025,2005,1,0,"Emory and Henry College",NA,NA,338,155,183,177,80,97,0.626,0.524,0.437,19530,304
"12555",232025,2006,1,0,"Emory and Henry College",NA,NA,267,115,152,84,36,48,0.417,0.315,0.237,20860,227
"12556",232025,2007,1,0,"Emory and Henry College",NA,NA,240,103,137,80,37,43,0.418,0.333,0.27,22320,201
"12557",232025,2008,1,0,"Emory and Henry College",NA,NA,241,123,118,87,31,56,0.455,0.361,0.263,23860,193
"12558",232025,2009,1,0,"Emory and Henry College",NA,NA,283,115,168,108,52,56,0.487,0.382,0.31,24880,217
"12559",232025,2010,1,0,"Emory and Henry College",NA,NA,248,124,124,84,34,50,0.403,0.339,0.274,26000,193
"12560",232043,1991,1,0,"EASTERN MENNONITE COLLEGE AND SEMINARY",NA,NA,201,129,72,95,29,66,0.512,0.473,0.403,7900,182
"12561",232043,1992,1,0,"EASTERN MENNONITE COLLEGE AND SEMINARY",NA,NA,205,117,88,87,31,56,0.479,0.424,0.352,8600,181
"12562",232043,1993,1,0,"EASTERN MENNONITE COLLEGE AND SEMINARY",NA,NA,229,130,99,108,42,66,0.508,0.472,0.424,9100,205
"12563",232043,1995,1,0,"EASTERN MENNONITE UNIVERSITY",NA,NA,206,144,62,96,27,69,0.479,0.466,0.435,10400,179
"12564",232043,1996,1,0,"EASTERN MENNONITE UNIVERSITY",NA,NA,228,143,85,90,26,64,0.448,0.395,0.306,11130,203
"12565",232043,1997,1,0,"EASTERN MENNONITE UNIVERSITY",NA,NA,242,138,104,109,44,65,0.471,0.45,0.423,12000,208
"12566",232043,1998,1,0,"EASTERN MENNONITE UNIVERSITY",NA,NA,229,130,99,107,43,64,0.492,0.467,0.434,12600,206
"12567",232043,1999,1,0,"EASTERN MENNONITE UNIVERSITY",NA,NA,218,131,87,111,36,75,0.573,0.509,0.414,13434,179
"12568",232043,2000,1,0,"EASTERN MENNONITE UNIVERSITY",NA,NA,220,137,83,106,35,71,0.518,0.482,0.422,14110,185
"12569",232043,2001,1,0,"EASTERN MENNONITE UNIVERSITY",NA,NA,208,124,84,115,44,71,0.573,0.553,0.524,15254,171
"12570",232043,2002,1,0,"EASTERN MENNONITE UNIVERSITY",NA,NA,208,120,88,113,46,67,0.558,0.543,0.523,16324,181
"12571",232043,2003,1,0,"EASTERN MENNONITE UNIVERSITY",NA,NA,195,121,74,94,32,62,0.512,0.482,0.432,17304,159
"12572",232043,2004,1,0,"EASTERN MENNONITE UNIVERSITY",NA,NA,207,134,73,91,33,58,0.433,0.44,0.452,18174,151
"12573",232043,2005,1,0,"Eastern Mennonite University",NA,NA,202,123,79,116,40,76,0.618,0.574,0.506,19500,159
"12574",232043,2006,1,0,"Eastern Mennonite University",NA,NA,205,119,86,93,31,62,0.521,0.454,0.36,20612,156
"12575",232043,2007,1,0,"Eastern Mennonite University",NA,NA,203,121,82,100,34,66,0.545,0.493,0.415,21860,162
"12576",232043,2008,1,0,"Eastern Mennonite University",NA,NA,183,103,80,90,35,55,0.534,0.492,0.438,23180,146
"12577",232043,2009,1,0,"Eastern Mennonite University",NA,NA,218,135,83,110,40,70,0.519,0.505,0.482,24120,168
"12578",232043,2010,1,0,"Eastern Mennonite University",NA,NA,206,122,84,96,32,64,0.525,0.466,0.381,25060,148
"12579",232089,1991,1,0,"FERRUM COLLEGE",NA,NA,339,122,217,58,29,29,0.238,0.171,0.134,7400,292
"12580",232089,1992,1,0,"FERRUM COLLEGE",NA,NA,337,130,207,78,46,32,0.246,0.231,0.222,8120,283
"12581",232089,1993,1,0,"FERRUM COLLEGE",NA,NA,332,131,201,68,29,39,0.298,0.205,0.144,8800,282
"12582",232089,1995,1,0,"FERRUM COLLEGE",NA,NA,297,109,188,66,28,38,0.349,0.222,0.149,9950,243
"12583",232089,1996,1,0,"FERRUM COLLEGE",NA,NA,309,111,198,59,24,35,0.315,0.191,0.121,10200,250
"12584",232089,1997,1,0,"FERRUM COLLEGE",NA,NA,240,102,138,72,35,37,0.363,0.3,0.254,10750,181
"12585",232089,1998,1,0,"FERRUM COLLEGE",NA,NA,305,128,177,60,29,31,0.242,0.197,0.164,10750,233
"12586",232089,1999,1,0,"FERRUM COLLEGE",NA,NA,309,104,205,56,26,30,0.289,0.181,0.127,10990,225
"12587",232089,2000,1,0,"FERRUM COLLEGE",NA,NA,281,102,179,47,23,24,0.235,0.167,0.128,11900,181
"12588",232089,2001,1,0,"FERRUM COLLEGE",NA,NA,269,104,165,51,20,31,0.298,0.19,0.121,12950,189
"12589",232089,2002,1,0,"FERRUM COLLEGE",NA,NA,288,97,191,69,32,37,0.381,0.24,0.168,14390,187
"12590",232089,2003,1,0,"FERRUM COLLEGE",NA,NA,301,106,195,71,37,34,0.321,0.236,0.19,15640,187
"12591",232089,2004,1,0,"FERRUM COLLEGE",NA,NA,287,114,173,53,21,32,0.281,0.185,0.121,16840,167
"12592",232089,2005,1,0,"Ferrum College",NA,NA,330,110,220,53,18,35,0.318,0.161,0.082,17990,202
"12593",232089,2006,1,0,"Ferrum College",NA,NA,417,156,261,126,65,61,0.391,0.302,0.249,19490,235
"12594",232089,2007,1,0,"Ferrum College",NA,NA,525,228,297,103,42,61,0.268,0.196,0.141,20885,295
"12595",232089,2008,1,0,"Ferrum College",NA,NA,581,253,328,80,26,54,0.213,0.138,0.079,22500,306
"12596",232089,2009,1,0,"Ferrum College",NA,NA,531,262,269,106,45,61,0.233,0.2,0.167,23520,245
"12597",232089,2010,1,0,"Ferrum College",NA,NA,565,243,322,106,49,57,0.235,0.188,0.152,24900,275
"12598",232186,1991,1,0,"GEORGE MASON UNIVERSITY",NA,NA,1678,927,751,348,106,242,0.261,0.207,0.141,2988,1096
"12599",232186,1992,1,0,"GEORGE MASON UNIVERSITY",NA,NA,1732,981,751,467,146,321,0.327,0.27,0.194,3336,1148
"12600",232186,1993,1,0,"GEORGE MASON UNIVERSITY",NA,NA,1670,934,736,442,140,302,0.323,0.265,0.19,3888,1115
"12601",232186,1995,1,0,"GEORGE MASON UNIVERSITY",NA,NA,1852,1065,787,486,145,341,0.32,0.262,0.184,4212,1136
"12602",232186,1996,1,0,"GEORGE MASON UNIVERSITY",NA,NA,1875,1040,835,480,150,330,0.317,0.256,0.18,4248,1187
"12603",232186,1997,1,0,"GEORGE MASON UNIVERSITY",NA,NA,1930,1072,858,437,140,297,0.277,0.226,0.163,4296,1194
"12604",232186,1998,1,0,"GEORGE MASON UNIVERSITY",NA,NA,2022,1112,910,540,164,376,0.338,0.267,0.18,4344,1258
"12605",232186,1999,1,0,"GEORGE MASON UNIVERSITY",NA,NA,2030,1129,901,534,161,373,0.33,0.263,0.179,2376,1248
"12606",232186,2000,1,0,"GEORGE MASON UNIVERSITY",NA,NA,2097,1132,965,650,194,456,0.403,0.31,0.201,2376,1363
"12607",232186,2001,1,0,"GEORGE MASON UNIVERSITY",NA,NA,2068,1136,932,631,191,440,0.387,0.305,0.205,2376,1293
"12608",232186,2002,1,0,"GEORGE MASON UNIVERSITY",NA,NA,2161,1180,981,770,254,516,0.437,0.356,0.259,2976,1429
"12609",232186,2003,1,0,"GEORGE MASON UNIVERSITY",NA,NA,2191,1166,1025,847,284,563,0.483,0.387,0.277,3630,1452
"12610",232186,2004,1,0,"GEORGE MASON UNIVERSITY",NA,NA,2210,1203,1007,869,311,558,0.464,0.393,0.309,3942,1125
"12611",232186,2005,1,0,"George Mason University",NA,NA,2454,1339,1115,999,348,651,0.486,0.407,0.312,4260,1284
"12612",232186,2006,1,0,"George Mason University",NA,NA,2390,1335,1055,992,355,637,0.477,0.415,0.336,4752,1276
"12613",232186,2007,1,0,"George Mason University",NA,NA,2174,1222,952,942,316,626,0.512,0.433,0.332,5035,1010
"12614",232186,2008,1,0,"George Mason University",NA,NA,2476,1328,1148,1099,406,693,0.522,0.444,0.354,5526,1252
"12615",232186,2009,1,0,"George Mason University",NA,NA,2627,1367,1260,1198,446,752,0.55,0.456,0.354,5840,1334
"12616",232186,2010,1,0,"George Mason University",NA,NA,2577,1324,1253,1198,462,736,0.556,0.465,0.369,6320,1439
"12617",232265,1991,1,0,"HAMPTON UNIVERSITY",NA,NA,1188,718,470,445,112,333,0.464,0.375,0.238,6550,5
"12618",232265,1992,1,0,"HAMPTON UNIVERSITY",NA,NA,1139,675,464,364,80,284,0.421,0.32,0.172,7006,8
"12619",232265,1993,1,0,"HAMPTON UNIVERSITY",NA,NA,1427,879,548,410,85,325,0.37,0.287,0.155,7356,6
"12620",232265,1995,1,0,"HAMPTON UNIVERSITY",NA,NA,1272,780,492,418,98,320,0.41,0.329,0.199,8362,3
"12621",232265,1996,1,0,"HAMPTON UNIVERSITY",NA,NA,917,591,326,358,70,288,0.487,0.39,0.215,8948,4
"12622",232265,1997,1,0,"HAMPTON UNIVERSITY",NA,NA,1218,765,453,459,119,340,0.444,0.377,0.263,9596,8
"12623",232265,1998,1,0,"HAMPTON UNIVERSITY",NA,NA,1153,715,438,461,105,356,0.498,0.4,0.24,10076,10
"12624",232265,1999,1,0,"HAMPTON UNIVERSITY",NA,NA,1190,728,462,422,102,320,0.44,0.355,0.221,9490,30
"12625",232265,2000,1,0,"HAMPTON UNIVERSITY",NA,NA,828,527,301,327,79,248,0.471,0.395,0.262,9968,18
"12626",232265,2001,1,0,"HAMPTON UNIVERSITY",NA,NA,1189,748,441,450,106,344,0.46,0.378,0.24,10464,15
"12627",232265,2002,1,0,"HAMPTON UNIVERSITY",NA,NA,1017,644,373,384,90,294,0.456,0.378,0.241,10990,11
"12628",232265,2003,1,0,"HAMPTON UNIVERSITY",NA,NA,1379,873,506,506,131,375,0.43,0.367,0.259,11540,17
"12629",232265,2004,1,0,"HAMPTON UNIVERSITY",NA,NA,1345,863,482,514,131,383,0.444,0.382,0.272,12116,13
"12630",232265,2005,1,0,"Hampton University",NA,NA,1099,701,398,445,114,331,0.472,0.405,0.286,12722,6
"12631",232265,2006,1,0,"Hampton University",NA,NA,1098,700,398,447,119,328,0.469,0.407,0.299,13358,7
"12632",232265,2007,1,0,"Hampton University",NA,NA,1179,757,422,585,163,422,0.557,0.496,0.386,14026,10
"12633",232265,2008,1,0,"Hampton University",NA,NA,1190,792,398,489,120,369,0.466,0.411,0.302,14728,10
"12634",232265,2009,1,0,"Hampton University",NA,NA,1017,632,385,135,135,0,0,0.133,0.351,15464,9
"12635",232265,2010,1,0,"Hampton University",NA,NA,978,605,373,351,87,264,0.436,0.359,0.233,16238,16
"12636",232423,1991,1,0,"JAMES MADISON UNIVERSITY",NA,NA,2121,1223,898,1105,381,724,0.592,0.521,0.424,3298,1805
"12637",232423,1992,1,0,"JAMES MADISON UNIVERSITY",NA,NA,2038,1171,867,1075,361,714,0.61,0.527,0.416,3576,1731
"12638",232423,1993,1,0,"JAMES MADISON UNIVERSITY",NA,NA,2079,1170,909,1239,453,786,0.672,0.596,0.498,3798,1788
"12639",232423,1995,1,0,"JAMES MADISON UNIVERSITY",NA,NA,2537,1484,1053,1548,523,1025,0.691,0.61,0.497,4014,2181
"12640",232423,1996,1,0,"JAMES MADISON UNIVERSITY",NA,NA,3258,1878,1380,1958,704,1254,0.668,0.601,0.51,4104,2890
"12641",232423,1997,1,0,"JAMES MADISON UNIVERSITY",NA,NA,3059,1791,1268,1855,643,1212,0.677,0.606,0.507,4148,2634
"12642",232423,1998,1,0,"JAMES MADISON UNIVERSITY",NA,NA,2971,1788,1183,1830,546,1284,0.718,0.616,0.462,4256,2623
"12643",232423,1999,1,0,"JAMES MADISON UNIVERSITY",NA,NA,3040,1855,1185,1887,610,1277,0.688,0.621,0.515,1550,2692
"12644",232423,2000,1,0,"JAMES MADISON UNIVERSITY",NA,NA,3223,1981,1242,2089,684,1405,0.709,0.648,0.551,1550,2766
"12645",232423,2001,1,0,"JAMES MADISON UNIVERSITY",NA,NA,3244,2004,1240,2103,696,1407,0.702,0.648,0.561,1550,2734
"12646",232423,2002,1,0,"JAMES MADISON UNIVERSITY",NA,NA,3283,2116,1167,2220,690,1530,0.723,0.676,0.591,1690,2804
"12647",232423,2003,1,0,"JAMES MADISON UNIVERSITY",NA,NA,3386,2167,1219,2220,697,1523,0.703,0.656,0.572,2382,2931
"12648",232423,2004,1,0,"JAMES MADISON UNIVERSITY",NA,NA,3281,2112,1169,2216,690,1526,0.723,0.675,0.59,2752,2785
"12649",232423,2005,1,0,"James Madison University",NA,NA,3796,2421,1375,2465,803,1662,0.687,0.649,0.584,2998,2883
"12650",232423,2006,1,0,"James Madison University",NA,NA,3745,2431,1314,2357,713,1644,0.676,0.629,0.543,3228,2998
"12651",232423,2007,1,0,"James Madison University",NA,NA,3864,2401,1463,2520,829,1691,0.704,0.652,0.567,3420,3193
"12652",232423,2008,1,0,"James Madison University",NA,NA,3956,2425,1531,2577,876,1701,0.701,0.651,0.572,3556,3162
"12653",232423,2009,1,0,"James Madison University",NA,NA,3948,2488,1460,2625,823,1802,0.724,0.665,0.564,3734,3216
"12654",232423,2010,1,0,"James Madison University",NA,NA,3995,2482,1513,2599,838,1761,0.71,0.651,0.554,4182,3185
"12655",232557,1991,1,0,"LIBERTY UNIVERSITY",NA,NA,849,451,398,146,53,93,0.206,0.172,0.133,5850,737
"12656",232557,1992,1,0,"LIBERTY UNIVERSITY",NA,NA,766,369,397,156,81,75,0.203,0.204,0.204,6150,660
"12657",232557,1993,1,0,"LIBERTY UNIVERSITY",NA,NA,1407,691,716,204,81,123,0.178,0.145,0.113,6600,1168
"12658",232557,1995,1,0,"LIBERTY UNIVERSITY",NA,NA,1165,600,565,224,70,154,0.257,0.192,0.124,7350,992
"12659",232557,1996,1,0,"LIBERTY UNIVERSITY",NA,NA,1253,635,618,253,91,162,0.255,0.202,0.147,7680,1032
"12660",232557,1997,1,0,"LIBERTY UNIVERSITY",NA,NA,995,531,464,279,101,178,0.335,0.28,0.218,8050,799
"12661",232557,1998,1,0,"LIBERTY UNIVERSITY",NA,NA,1020,479,541,327,126,201,0.42,0.321,0.233,8500,910
"12662",232557,1999,1,0,"LIBERTY UNIVERSITY",NA,NA,1074,557,517,268,103,165,0.296,0.25,0.199,8550,841
"12663",232557,2000,1,0,"LIBERTY UNIVERSITY",NA,NA,1216,657,559,431,167,264,0.402,0.354,0.299,8550,997
"12664",232557,2001,1,0,"LIBERTY UNIVERSITY",NA,NA,1129,602,527,381,146,235,0.39,0.337,0.277,9000,963
"12665",232557,2002,1,0,"LIBERTY UNIVERSITY",NA,NA,1530,812,718,393,154,239,0.294,0.257,0.214,9840,1177
"12666",232557,2003,1,0,"LIBERTY UNIVERSITY",NA,NA,1811,1024,787,506,190,316,0.309,0.279,0.241,11520,1358
"12667",232557,2004,1,0,"LIBERTY UNIVERSITY",NA,NA,2173,1178,995,647,251,396,0.336,0.298,0.252,12600,1644
"12668",232557,2005,1,0,"Liberty University",NA,NA,1915,982,933,488,204,284,0.289,0.255,0.219,13700,1373
"12669",232557,2006,1,0,"Liberty University",NA,NA,2028,1022,1006,489,209,280,0.274,0.241,0.208,14400,1365
"12670",232557,2007,1,0,"Liberty University",NA,NA,2715,1474,1241,715,278,437,0.296,0.263,0.224,14850,1820
"12671",232557,2008,1,0,"Liberty University",NA,NA,3063,1663,1400,857,314,543,0.326,0.28,0.224,15444,1873
"12672",232557,2009,1,0,"Liberty University",NA,NA,3871,2113,1758,1154,439,715,0.338,0.298,0.25,15992,2201
"12673",232557,2010,1,0,"Liberty University",NA,NA,3438,1874,1564,1005,410,595,0.318,0.292,0.262,16792,2026
"12674",232566,1991,1,0,"LONGWOOD COLLEGE",NA,NA,634,465,169,223,43,180,0.387,0.352,0.254,3190,568
"12675",232566,1992,1,0,"LONGWOOD COLLEGE",NA,NA,687,473,214,268,50,218,0.461,0.39,0.234,3664,608
"12676",232566,1993,1,0,"LONGWOOD COLLEGE",NA,NA,724,509,215,275,40,235,0.462,0.38,0.186,4106,647
"12677",232566,1995,1,0,"LONGWOOD COLLEGE",NA,NA,671,445,226,283,57,226,0.508,0.422,0.252,4370,599
"12678",232566,1996,1,0,"LONGWOOD COLLEGE",NA,NA,657,447,210,242,53,189,0.423,0.368,0.252,4370,559
"12679",232566,1997,1,0,"LONGWOOD COLLEGE",NA,NA,728,513,215,303,67,236,0.46,0.416,0.312,4416,637
"12680",232566,1998,1,0,"LONGWOOD COLLEGE",NA,NA,812,539,273,362,91,271,0.503,0.446,0.333,4528,709
"12681",232566,1999,1,0,"LONGWOOD COLLEGE",NA,NA,815,534,281,391,101,290,0.543,0.48,0.359,2020,708
"12682",232566,2000,1,0,"LONGWOOD COLLEGE",NA,NA,895,611,284,412,105,307,0.503,0.46,0.37,1995,771
"12683",232566,2001,1,0,"LONGWOOD COLLEGE",NA,NA,891,611,280,410,103,307,0.503,0.46,0.368,1970,776
"12684",232566,2002,1,0,"LONGWOOD UNIVERSITY",NA,NA,860,593,267,410,101,309,0.521,0.477,0.378,2148,770
"12685",232566,2003,1,0,"LONGWOOD UNIVERSITY",NA,NA,872,576,296,340,91,249,0.432,0.39,0.307,3046,763
"12686",232566,2004,1,0,"LONGWOOD UNIVERSITY",NA,NA,972,631,341,386,111,275,0.436,0.397,0.326,3320,872
"12687",232566,2005,1,0,"Longwood University",NA,NA,938,632,306,379,88,291,0.46,0.404,0.288,3586,809
"12688",232566,2006,1,0,"Longwood University",NA,NA,985,627,358,411,111,300,0.479,0.417,0.31,3960,872
"12689",232566,2007,1,0,"Longwood University",NA,NA,984,650,334,412,107,305,0.469,0.419,0.32,4249,848
"12690",232566,2008,1,0,"Longwood University",NA,NA,1043,700,343,467,104,363,0.519,0.448,0.303,4509,889
"12691",232566,2009,1,0,"Longwood University",NA,NA,934,631,303,414,96,318,0.504,0.443,0.317,4680,754
"12692",232566,2010,1,0,"Longwood University",NA,NA,970,667,303,454,93,361,0.541,0.468,0.307,5370,801
"12693",232609,1991,1,0,"LYNCHBURG COLLEGE",NA,NA,327,200,127,142,47,95,0.475,0.434,0.37,10300,286
"12694",232609,1992,1,0,"LYNCHBURG COLLEGE",NA,NA,416,248,168,177,52,125,0.504,0.425,0.31,10900,357
"12695",232609,1993,1,0,"LYNCHBURG COLLEGE",NA,NA,361,221,140,120,36,84,0.38,0.332,0.257,11600,316
"12696",232609,1995,1,0,"LYNCHBURG COLLEGE",NA,NA,262,181,81,142,42,100,0.552,0.542,0.519,14080,230
"12697",232609,1996,1,0,"LYNCHBURG COLLEGE",NA,NA,287,169,118,151,51,100,0.592,0.526,0.432,14720,235
"12698",232609,1997,1,0,"LYNCHBURG COLLEGE",NA,NA,477,275,202,220,72,148,0.538,0.461,0.356,15490,407
"12699",232609,1998,1,0,"LYNCHBURG COLLEGE",NA,NA,433,267,166,218,65,153,0.573,0.503,0.392,16290,377
"12700",232609,1999,1,0,"LYNCHBURG COLLEGE",NA,NA,473,277,196,222,73,149,0.538,0.469,0.372,17120,426
"12701",232609,2000,1,0,"LYNCHBURG COLLEGE",NA,NA,438,252,186,188,70,118,0.468,0.429,0.376,17980,373
"12702",232609,2001,1,0,"LYNCHBURG COLLEGE",NA,NA,475,278,197,219,67,152,0.547,0.461,0.34,18880,424
"12703",232609,2002,1,0,"LYNCHBURG COLLEGE",NA,NA,438,246,192,220,72,148,0.602,0.502,0.375,20040,371
"12704",232609,2003,1,0,"LYNCHBURG COLLEGE",NA,NA,589,342,247,316,116,200,0.585,0.537,0.47,21270,479
"12705",232609,2004,1,0,"LYNCHBURG COLLEGE",NA,NA,568,328,240,275,87,188,0.573,0.484,0.362,22640,459
"12706",232609,2005,1,0,"Lynchburg College",NA,NA,553,321,232,246,84,162,0.505,0.445,0.362,23700,378
"12707",232609,2006,1,0,"Lynchburg College",NA,NA,552,305,247,259,88,171,0.561,0.469,0.356,24860,333
"12708",232609,2007,1,0,"Lynchburg College",NA,NA,598,324,274,274,95,179,0.552,0.458,0.347,26360,407
"12709",232609,2008,1,0,"Lynchburg College",NA,NA,593,336,257,252,85,167,0.497,0.425,0.331,27160,480
"12710",232609,2009,1,0,"Lynchburg College",NA,NA,592,348,244,278,91,187,0.537,0.47,0.373,27980,481
"12711",232609,2010,1,0,"Lynchburg College",NA,NA,571,328,243,275,89,186,0.567,0.482,0.366,28960,455
"12712",232681,1991,1,0,"MARY WASHINGTON COLLEGE",NA,NA,712,496,216,458,123,335,0.675,0.643,0.569,2618,620
"12713",232681,1992,1,0,"MARY WASHINGTON COLLEGE",NA,NA,698,474,224,448,132,316,0.667,0.642,0.589,2896,623
"12714",232681,1993,1,0,"MARY WASHINGTON COLLEGE",NA,NA,750,477,273,486,161,325,0.681,0.648,0.59,3066,662
"12715",232681,1995,1,0,"MARY WASHINGTON COLLEGE",NA,NA,758,497,261,443,138,305,0.614,0.584,0.529,3300,654
"12716",232681,1996,1,0,"MARY WASHINGTON COLLEGE",NA,NA,729,504,225,450,112,338,0.671,0.617,0.498,3318,655
"12717",232681,1997,1,0,"MARY WASHINGTON COLLEGE",NA,NA,808,547,261,479,129,350,0.64,0.593,0.494,3556,731
"12718",232681,1998,1,0,"MARY WASHINGTON COLLEGE",NA,NA,812,557,255,530,156,374,0.672,0.653,0.612,3674,741
"12719",232681,1999,1,0,"MARY WASHINGTON COLLEGE",NA,NA,834,619,215,583,142,441,0.712,0.699,0.66,1550,753
"12720",232681,2000,1,0,"MARY WASHINGTON COLLEGE",NA,NA,873,609,264,622,175,447,0.734,0.712,0.663,1550,779
"12721",232681,2001,1,0,"MARY WASHINGTON COLLEGE",NA,NA,840,574,266,570,158,412,0.718,0.679,0.594,1550,742
"12722",232681,2002,1,0,"MARY WASHINGTON COLLEGE",NA,NA,862,618,244,607,164,443,0.717,0.704,0.672,1690,760
"12723",232681,2003,1,0,"MARY WASHINGTON COLLEGE",NA,NA,879,572,307,590,181,409,0.715,0.671,0.59,2344,791
"12724",232681,2004,1,0,"UNIVERSITY OF MARY WASHINGTON",NA,NA,869,569,300,590,183,407,0.715,0.679,0.61,2544,779
"12725",232681,2005,1,0,"University of Mary Washington",NA,NA,877,581,296,552,159,393,0.676,0.629,0.537,2806,644
"12726",232681,2006,1,0,"University of Mary Washington",NA,NA,909,614,295,625,180,445,0.725,0.688,0.61,3072,619
"12727",232681,2007,1,0,"University of Mary Washington",NA,NA,951,649,302,626,175,451,0.695,0.658,0.579,3256,600
"12728",232681,2008,1,0,"University of Mary Washington",NA,NA,848,553,295,539,160,379,0.685,0.636,0.542,3386,586
"12729",232681,2009,1,0,"University of Mary Washington",NA,NA,925,600,325,543,156,387,0.645,0.587,0.48,3554,521
"12730",232681,2010,1,0,"University of Mary Washington",NA,NA,950,612,338,586,179,407,0.665,0.617,0.53,3984,503
"12731",232706,1991,1,0,"MARYMOUNT UNIVERSITY",NA,NA,211,159,52,81,21,60,0.377,0.384,0.404,9707,151
"12732",232706,1992,1,0,"MARYMOUNT UNIVERSITY",NA,NA,212,165,47,77,19,58,0.352,0.363,0.404,10192,155
"12733",232706,1993,1,0,"MARYMOUNT UNIVERSITY",NA,NA,175,130,45,66,10,56,0.431,0.377,0.222,10804,128
"12734",232706,1995,1,0,"MARYMOUNT UNIVERSITY",NA,NA,167,122,45,82,22,60,0.492,0.491,0.489,11900,114
"12735",232706,1996,1,0,"MARYMOUNT UNIVERSITY",NA,NA,212,145,67,102,27,75,0.517,0.481,0.403,12400,136
"12736",232706,1997,1,0,"MARYMOUNT UNIVERSITY",NA,NA,261,190,71,111,28,83,0.437,0.425,0.394,12770,186
"12737",232706,1998,1,0,"MARYMOUNT UNIVERSITY",NA,NA,262,177,85,100,24,76,0.429,0.382,0.282,13300,164
"12738",232706,1999,1,0,"MARYMOUNT UNIVERSITY",NA,NA,302,220,82,116,26,90,0.409,0.384,0.317,13750,185
"12739",232706,2000,1,0,"MARYMOUNT UNIVERSITY",NA,NA,309,230,79,120,21,99,0.43,0.388,0.266,14300,166
"12740",232706,2001,1,0,"MARYMOUNT UNIVERSITY",NA,NA,354,241,113,123,29,94,0.39,0.347,0.257,14850,187
"12741",232706,2002,1,0,"MARYMOUNT UNIVERSITY",NA,NA,361,261,100,128,25,103,0.395,0.355,0.25,15600,170
"12742",232706,2003,1,0,"MARYMOUNT UNIVERSITY",NA,NA,379,290,89,158,30,128,0.441,0.417,0.337,16300,193
"12743",232706,2004,1,0,"MARYMOUNT UNIVERSITY",NA,NA,414,310,104,180,45,135,0.436,0.435,0.433,16952,222
"12744",232706,2005,1,0,"Marymount University",NA,NA,422,310,112,152,34,118,0.381,0.36,0.304,17970,208
"12745",232706,2006,1,0,"Marymount University",NA,NA,365,268,97,136,28,108,0.403,0.373,0.289,19048,173
"12746",232706,2007,1,0,"Marymount University",NA,NA,396,288,108,176,35,141,0.49,0.444,0.324,20190,198
"12747",232706,2008,1,0,"Marymount University",NA,NA,404,294,110,141,25,116,0.395,0.349,0.227,21300,173
"12748",232706,2009,1,0,"Marymount University",NA,NA,383,274,109,131,31,100,0.365,0.342,0.284,22370,161
"12749",232706,2010,1,0,"Marymount University",NA,NA,415,295,120,151,36,115,0.39,0.364,0.3,23160,153
"12750",232937,1991,1,0,"NORFOLK STATE UNIVERSITY",NA,NA,1543,920,623,95,24,71,0.077,0.062,0.039,2330,33
"12751",232937,1992,1,0,"NORFOLK STATE UNIVERSITY",NA,NA,1492,893,599,76,24,52,0.058,0.051,0.04,2530,47
"12752",232937,1993,1,0,"NORFOLK STATE UNIVERSITY",NA,NA,1324,759,565,70,24,46,0.061,0.053,0.042,2710,27
"12753",232937,1995,1,0,"NORFOLK STATE UNIVERSITY",NA,NA,1257,706,551,91,24,67,0.095,0.072,0.044,2865,33
"12754",232937,1996,1,0,"NORFOLK STATE UNIVERSITY",NA,NA,1329,809,520,124,34,90,0.111,0.093,0.065,2865,34
"12755",232937,1997,1,0,"NORFOLK STATE UNIVERSITY",NA,NA,1132,700,432,104,30,74,0.106,0.092,0.069,3000,23
"12756",232937,1998,1,0,"NORFOLK STATE UNIVERSITY",NA,NA,1092,680,412,95,26,69,0.102,0.087,0.063,3335,22
"12757",232937,1999,1,0,"NORFOLK STATE UNIVERSITY",NA,NA,1111,687,424,118,27,91,0.132,0.106,0.064,1350,28
"12758",232937,2000,1,0,"NORFOLK STATE UNIVERSITY",NA,NA,1262,808,454,141,52,89,0.11,0.112,0.115,1326,17
"12759",232937,2001,1,0,"NORFOLK STATE UNIVERSITY",NA,NA,1067,655,412,113,25,88,0.134,0.106,0.061,1530,22
"12760",232937,2002,1,0,"NORFOLK STATE UNIVERSITY",NA,NA,1091,634,457,133,35,98,0.155,0.122,0.077,1658,21
"12761",232937,2003,1,0,"NORFOLK STATE UNIVERSITY",NA,NA,1080,593,487,123,41,82,0.138,0.114,0.084,1920,29
"12762",232937,2004,1,0,"NORFOLK STATE UNIVERSITY",NA,NA,970,580,390,103,20,83,0.143,0.106,0.051,2220,32
"12763",232937,2005,1,0,"Norfolk State University",NA,NA,957,551,406,138,39,99,0.18,0.144,0.096,2370,21
"12764",232937,2006,1,0,"Norfolk State University",NA,NA,1023,638,385,130,34,96,0.151,0.127,0.088,2580,23
"12765",232937,2007,1,0,"Norfolk State University",NA,NA,938,571,367,179,46,133,0.233,0.191,0.125,2700,18
"12766",232937,2008,1,0,"Norfolk State University",NA,NA,1143,657,486,182,53,129,0.196,0.159,0.109,2781,24
"12767",232937,2009,1,0,"Norfolk State University",NA,NA,1160,654,506,183,63,120,0.184,0.158,0.125,2952,32
"12768",232937,2010,1,0,"Norfolk State University",NA,NA,902,528,374,185,67,118,0.224,0.205,0.179,3159,30
"12769",232982,1991,1,0,"OLD DOMINION UNIVERSITY",NA,NA,1363,685,678,161,48,113,0.165,0.118,0.071,2848,1017
"12770",232982,1992,1,0,"OLD DOMINION UNIVERSITY",NA,NA,1491,764,727,158,50,108,0.141,0.106,0.069,2828,1080
"12771",232982,1993,1,0,"OLD DOMINION UNIVERSITY",NA,NA,1173,580,593,137,39,98,0.169,0.117,0.066,3098,825
"12772",232982,1995,1,0,"OLD DOMINION UNIVERSITY",NA,NA,1514,827,687,149,30,119,0.144,0.098,0.044,3288,978
"12773",232982,1996,1,0,"OLD DOMINION UNIVERSITY",NA,NA,1478,803,675,210,60,150,0.187,0.142,0.089,3312,926
"12774",232982,1997,1,0,"OLD DOMINION UNIVERSITY",NA,NA,1464,791,673,207,54,153,0.193,0.141,0.08,3428,896
"12775",232982,1998,1,0,"OLD DOMINION UNIVERSITY",NA,NA,1561,904,657,324,82,242,0.268,0.208,0.125,3476,930
"12776",232982,1999,1,0,"OLD DOMINION UNIVERSITY",NA,NA,1500,833,667,327,103,224,0.269,0.218,0.154,2184,875
"12777",232982,2000,1,0,"OLD DOMINION UNIVERSITY",NA,NA,1407,798,609,321,93,228,0.286,0.228,0.153,1747,798
"12778",232982,2001,1,0,"OLD DOMINION UNIVERSITY",NA,NA,1502,821,681,340,116,224,0.273,0.226,0.17,1747,856
"12779",232982,2002,1,0,"OLD DOMINION UNIVERSITY",NA,NA,1701,902,799,373,139,234,0.259,0.219,0.174,1891,958
"12780",232982,2003,1,0,"OLD DOMINION UNIVERSITY",NA,NA,2001,1139,862,457,136,321,0.282,0.228,0.158,2364,1159
"12781",232982,2004,1,0,"OLD DOMINION UNIVERSITY",NA,NA,1917,1053,864,474,136,338,0.321,0.247,0.157,2569,1093
"12782",232982,2005,1,0,"Old Dominion University",NA,NA,2054,1160,894,474,145,329,0.284,0.231,0.162,2785,459
"12783",232982,2006,1,0,"Old Dominion University",NA,NA,2059,1108,951,507,159,348,0.314,0.246,0.167,3051,555
"12784",232982,2007,1,0,"Old Dominion University",NA,NA,2513,1327,1186,581,200,381,0.287,0.231,0.169,3219,1420
"12785",232982,2008,1,0,"Old Dominion University",NA,NA,2757,1381,1376,652,233,419,0.303,0.236,0.169,3348,1567
"12786",232982,2009,1,0,"Old Dominion University",NA,NA,2691,1346,1345,698,263,435,0.323,0.259,0.196,3516,1533
"12787",232982,2010,1,0,"Old Dominion University",NA,NA,2579,1280,1299,666,252,414,0.323,0.258,0.194,3763,1360
"12788",233277,1991,1,0,"RADFORD UNIVERSITY",NA,NA,1857,1122,735,365,88,277,0.247,0.197,0.12,2430,1706
"12789",233277,1992,1,0,"RADFORD UNIVERSITY",NA,NA,1807,1128,679,445,99,346,0.307,0.246,0.146,2746,1651
"12790",233277,1993,1,0,"RADFORD UNIVERSITY",NA,NA,1736,1088,648,460,128,332,0.305,0.265,0.198,2924,1580
"12791",233277,1995,1,0,"RADFORD UNIVERSITY",NA,NA,1381,833,548,425,121,304,0.365,0.308,0.221,3114,1252
"12792",233277,1996,1,0,"RADFORD UNIVERSITY",NA,NA,1419,867,552,476,141,335,0.386,0.335,0.255,3146,1274
"12793",233277,1997,1,0,"RADFORD UNIVERSITY",NA,NA,1619,1048,571,551,145,406,0.387,0.34,0.254,3180,1443
"12794",233277,1998,1,0,"RADFORD UNIVERSITY",NA,NA,1518,1011,507,569,154,415,0.41,0.375,0.304,3238,1356
"12795",233277,1999,1,0,"RADFORD UNIVERSITY",NA,NA,1655,1075,580,610,164,446,0.415,0.369,0.283,1629,1462
"12796",233277,2000,1,0,"RADFORD UNIVERSITY",NA,NA,1753,1081,672,610,191,419,0.388,0.348,0.284,1629,1563
"12797",233277,2001,1,0,"RADFORD UNIVERSITY",NA,NA,1875,1155,720,674,200,474,0.41,0.359,0.278,1629,1679
"12798",233277,2002,1,0,"RADFORD UNIVERSITY",NA,NA,1813,1109,704,754,244,510,0.46,0.416,0.347,1774,1590
"12799",233277,2003,1,0,"RADFORD UNIVERSITY",NA,NA,1800,1097,703,719,214,505,0.46,0.399,0.304,2476,1614
"12800",233277,2004,1,0,"RADFORD UNIVERSITY",NA,NA,1828,1135,693,708,209,499,0.44,0.387,0.302,2974,1604
"12801",233277,2005,1,0,"Radford University",NA,NA,1890,1101,789,725,254,471,0.428,0.384,0.322,3235,1647
"12802",233277,2006,1,0,"Radford University",NA,NA,1730,1045,685,730,252,478,0.457,0.422,0.368,3720,1507
"12803",233277,2007,1,0,"Radford University",NA,NA,1840,1055,785,758,273,485,0.46,0.412,0.348,4026,1611
"12804",233277,2008,1,0,"Radford University",NA,NA,1871,1119,752,809,261,548,0.49,0.432,0.347,4187,1573
"12805",233277,2009,1,0,"Radford University",NA,NA,1444,838,606,637,217,420,0.501,0.441,0.358,4396,1249
"12806",233277,2010,1,0,"Radford University",NA,NA,1836,1068,768,783,259,524,0.491,0.426,0.337,5012,1557
"12807",233374,1991,1,0,"UNIVERSITY OF RICHMOND",NA,NA,805,409,396,623,294,329,0.804,0.774,0.742,11695,753
"12808",233374,1992,1,0,"UNIVERSITY OF RICHMOND",NA,NA,749,361,388,576,294,282,0.781,0.769,0.758,12620,689
"12809",233374,1993,1,0,"UNIVERSITY OF RICHMOND",NA,NA,728,383,345,559,251,308,0.804,0.768,0.728,13540,664
"12810",233374,1995,1,0,"UNIVERSITY OF RICHMOND",NA,NA,762,398,364,581,251,330,0.829,0.762,0.69,15500,671
"12811",233374,1996,1,0,"UNIVERSITY OF RICHMOND",NA,NA,793,399,394,610,284,326,0.817,0.769,0.721,16570,698
"12812",233374,1997,1,0,"UNIVERSITY OF RICHMOND",NA,NA,750,367,383,548,258,290,0.79,0.731,0.674,17570,660
"12813",233374,1998,1,0,"UNIVERSITY OF RICHMOND",NA,NA,739,358,381,576,281,295,0.824,0.779,0.738,18595,633
"12814",233374,1999,1,0,"UNIVERSITY OF RICHMOND",NA,NA,854,465,389,647,273,374,0.804,0.758,0.702,19340,773
"12815",233374,2000,1,0,"UNIVERSITY OF RICHMOND",NA,NA,723,366,357,574,278,296,0.809,0.794,0.779,20140,632
"12816",233374,2001,1,0,"UNIVERSITY OF RICHMOND",NA,NA,790,430,360,640,277,363,0.844,0.81,0.769,21700,696
"12817",233374,2002,1,0,"UNIVERSITY OF RICHMOND",NA,NA,775,422,353,634,279,355,0.841,0.818,0.79,22995,668
"12818",233374,2003,1,0,"UNIVERSITY OF RICHMOND",NA,NA,835,440,395,688,313,375,0.852,0.824,0.792,24170,730
"12819",233374,2004,1,0,"UNIVERSITY OF RICHMOND",NA,NA,763,391,372,620,298,322,0.824,0.813,0.801,26520,640
"12820",233374,2005,1,0,"University of Richmond",NA,NA,775,401,374,593,268,325,0.81,0.765,0.717,29250,577
"12821",233374,2006,1,0,"University of Richmond",NA,NA,757,387,370,585,267,318,0.822,0.773,0.722,32870,540
"12822",233374,2007,1,0,"University of Richmond",NA,NA,801,427,374,653,295,358,0.838,0.815,0.789,35718,605
"12823",233374,2008,1,0,"University of Richmond",NA,NA,737,412,325,591,255,336,0.816,0.802,0.785,38850,485
"12824",233374,2009,1,0,"University of Richmond",NA,NA,918,546,372,758,293,465,0.852,0.826,0.788,40010,505
"12825",233374,2010,1,0,"University of Richmond",NA,NA,816,452,364,685,286,399,0.883,0.839,0.786,41610,506
"12826",233426,1991,1,0,"ROANOKE COLLEGE",NA,NA,421,267,154,188,58,130,0.487,0.447,0.377,11250,403
"12827",233426,1992,1,0,"ROANOKE COLLEGE",NA,NA,422,259,163,222,65,157,0.606,0.526,0.399,12000,395
"12828",233426,1993,1,0,"ROANOKE COLLEGE",NA,NA,438,275,163,242,67,175,0.636,0.553,0.411,12625,415
"12829",233426,1995,1,0,"ROANOKE COLLEGE",NA,NA,431,247,184,223,77,146,0.591,0.517,0.418,14100,405
"12830",233426,1996,1,0,"ROANOKE COLLEGE",NA,NA,437,278,159,263,84,179,0.644,0.602,0.528,14750,408
"12831",233426,1997,1,0,"ROANOKE COLLEGE",NA,NA,438,248,190,225,70,155,0.625,0.514,0.368,15380,407
"12832",233426,1998,1,0,"ROANOKE COLLEGE",NA,NA,426,272,154,222,68,154,0.566,0.521,0.442,16035,400
"12833",233426,1999,1,0,"ROANOKE COLLEGE",NA,NA,450,274,176,257,88,169,0.617,0.571,0.5,16655,428
"12834",233426,2000,1,0,"ROANOKE COLLEGE",NA,NA,444,274,170,259,80,179,0.653,0.583,0.471,17320,403
"12835",233426,2001,1,0,"ROANOKE COLLEGE",NA,NA,498,311,187,283,96,187,0.601,0.568,0.513,18186,452
"12836",233426,2002,1,0,"ROANOKE COLLEGE",NA,NA,460,274,186,256,95,161,0.588,0.557,0.511,19186,417
"12837",233426,2003,1,0,"ROANOKE COLLEGE",NA,NA,519,282,237,301,130,171,0.606,0.58,0.549,20355,477
"12838",233426,2004,1,0,"ROANOKE COLLEGE",NA,NA,483,288,195,314,114,200,0.694,0.65,0.585,21504,434
"12839",233426,2005,1,0,"Roanoke College",NA,NA,534,310,224,316,120,196,0.632,0.592,0.536,22848,464
"12840",233426,2006,1,0,"Roanoke College",NA,NA,503,296,207,285,104,181,0.612,0.567,0.502,24048,433
"12841",233426,2007,1,0,"Roanoke College",NA,NA,565,335,230,327,115,212,0.633,0.579,0.5,25550,471
"12842",233426,2008,1,0,"Roanoke College",NA,NA,529,284,245,302,115,187,0.658,0.571,0.469,27210,458
"12843",233426,2009,1,0,"Roanoke College",NA,NA,560,325,235,327,123,204,0.628,0.584,0.523,28734,480
"12844",233426,2010,1,0,"Roanoke College",NA,NA,564,323,241,321,115,206,0.638,0.569,0.477,30314,503
"12845",233541,1991,1,0,"SHENANDOAH UNIVERSITY",NA,NA,180,104,76,35,10,25,0.24,0.194,0.132,8100,153
"12846",233541,1992,1,0,"SHENANDOAH UNIVERSITY",NA,NA,221,141,80,46,16,30,0.213,0.208,0.2,8750,186
"12847",233541,1993,1,0,"SHENANDOAH UNIVERSITY",NA,NA,185,88,97,47,17,30,0.341,0.254,0.175,9800,164
"12848",233541,1995,1,0,"SHENANDOAH UNIVERSITY",NA,NA,212,118,94,53,16,37,0.314,0.25,0.17,11470,179
"12849",233541,1996,1,0,"SHENANDOAH UNIVERSITY",NA,NA,251,149,102,59,14,45,0.302,0.235,0.137,13700,214
"12850",233541,1997,1,0,"SHENANDOAH UNIVERSITY",NA,NA,257,159,98,61,17,44,0.277,0.237,0.173,14400,223
"12851",233541,1998,1,0,"SHENANDOAH UNIVERSITY",NA,NA,288,178,110,80,19,61,0.343,0.278,0.173,15080,251
"12852",233541,1999,1,0,"SHENANDOAH UNIVERSITY",NA,NA,292,163,129,87,36,51,0.313,0.298,0.279,15700,249
"12853",233541,2000,1,0,"SHENANDOAH UNIVERSITY",NA,NA,377,187,190,105,35,70,0.374,0.279,0.184,16300,303
"12854",233541,2001,1,0,"SHENANDOAH UNIVERSITY",NA,NA,308,158,150,106,40,66,0.418,0.344,0.267,17000,268
"12855",233541,2002,1,0,"SHENANDOAH UNIVERSITY",NA,NA,323,163,160,115,42,73,0.448,0.356,0.262,17510,267
"12856",233541,2003,1,0,"SHENANDOAH UNIVERSITY",NA,NA,328,185,143,106,34,72,0.389,0.323,0.238,18310,317
"12857",233541,2004,1,0,"SHENANDOAH UNIVERSITY",NA,NA,325,160,165,98,39,59,0.369,0.302,0.236,19090,301
"12858",233541,2005,1,0,"Shenandoah University",NA,NA,369,211,158,123,44,79,0.374,0.333,0.278,19900,158
"12859",233541,2006,1,0,"Shenandoah University",NA,NA,304,157,147,75,29,46,0.293,0.247,0.197,21090,50
"12860",233541,2007,1,0,"Shenandoah University",NA,NA,397,205,192,135,49,86,0.42,0.34,0.255,22040,287
"12861",233541,2008,1,0,"Shenandoah University",NA,NA,399,200,199,145,52,93,0.465,0.363,0.261,22740,292
"12862",233541,2009,1,0,"Shenandoah University",NA,NA,443,235,208,155,46,109,0.464,0.35,0.221,23850,320
"12863",233541,2010,1,0,"Shenandoah University",NA,NA,414,228,186,164,57,107,0.469,0.396,0.306,24780,297
"12864",233897,1991,1,0,"UNIVERSITY OF VIRGINIA CLINCH VALLEY COLLEGE",NA,NA,326,155,171,52,16,36,0.232,0.16,0.094,2300,303
"12865",233897,1992,1,0,"UNIVERSITY OF VIRGINIA CLINCH VALLEY COLLEGE",NA,NA,232,110,122,41,14,27,0.246,0.177,0.115,2650,219
"12866",233897,1993,1,0,"UNIVERSITY OF VIRGINIA-CLINCH VALLEY COLLEGE",NA,NA,253,110,143,53,22,31,0.282,0.209,0.154,2988,229
"12867",233897,1995,1,0,"UNIVERSITY OF VIRGINIA-CLINCH VALLEY COLLEGE",NA,NA,269,141,128,67,27,40,0.284,0.249,0.211,3200,255
"12868",233897,1996,1,0,"UNIVERSITY OF VIRGINIA-CLINCH VALLEY COLLEGE",NA,NA,247,132,115,69,31,38,0.288,0.279,0.27,3258,234
"12869",233897,1997,1,0,"UNIVERSITY OF VIRGINIA-CLINCH VALLEY COLLEGE",NA,NA,303,155,148,80,28,52,0.335,0.264,0.189,3348,279
"12870",233897,1998,1,0,"UNIVERSITY OF VIRGINIA-CLINCH VALLEY COLLEGE",NA,NA,297,146,151,57,18,39,0.267,0.192,0.119,3520,268
"12871",233897,1999,1,0,"UNIVERSITY OF VIRGINIA'S COLLEGE AT WISE",NA,NA,299,151,148,76,36,40,0.265,0.254,0.243,1930,274
"12872",233897,2000,1,0,"UNIVERSITY OF VIRGINIA'S COLLEGE AT WISE",NA,NA,277,137,140,74,22,52,0.38,0.267,0.157,1930,252
"12873",233897,2001,1,0,"UNIVERSITY OF VIRGINIA'S COLLEGE AT WISE",NA,NA,325,154,171,80,36,44,0.286,0.246,0.211,1885,280
"12874",233897,2002,1,0,"UNIVERSITY OF VIRGINIA'S COLLEGE AT WISE",NA,NA,345,181,164,100,34,66,0.365,0.29,0.207,2055,315
"12875",233897,2003,1,0,"THE UNIVERSITY OF VIRGINIA'S COLLEGE AT WISE",NA,NA,349,177,172,109,39,70,0.395,0.312,0.227,2630,296
"12876",233897,2004,1,0,"THE UNIVERSITY OF VIRGINIA'S COLLEGE AT WISE",NA,NA,373,180,193,130,61,69,0.383,0.349,0.316,2788,336
"12877",233897,2005,1,0,"The University of Virginia's College at Wise",NA,NA,366,186,180,94,27,67,0.36,0.257,0.15,2984,314
"12878",233897,2006,1,0,"The University of Virginia's College at Wise",NA,NA,401,187,214,98,45,53,0.283,0.244,0.21,3252,349
"12879",233897,2007,1,0,"The University of Virginia's College at Wise",NA,NA,401,184,217,97,41,56,0.304,0.242,0.189,3422,332
"12880",233897,2008,1,0,"The University of Virginia's College at Wise",NA,NA,427,194,233,98,42,56,0.289,0.23,0.18,3482,350
"12881",233897,2009,1,0,"The University of Virginia's College at Wise",NA,NA,397,172,225,87,40,47,0.273,0.219,0.178,3586,314
"12882",233897,2010,1,0,"The University of Virginia's College at Wise",NA,NA,399,197,202,92,33,59,0.3,0.231,0.163,3910,323
"12883",233921,1991,1,0,"VIRGINIA POLYTECHNIC INSTITUTE AND STATE UNIV",NA,NA,4407,1878,2529,1566,697,869,0.463,0.355,0.276,3304,3760
"12884",233921,1992,1,0,"VIRGINIA POLYTECHNIC INSTITUTE AND STATE UNIV",NA,NA,3851,1639,2212,1386,603,783,0.478,0.36,0.273,3538,3259
"12885",233921,1993,1,0,"VIRGINIA POLYTECHNIC INSTITUTE AND STATE UNIV",NA,NA,4270,1776,2494,1459,620,839,0.472,0.342,0.249,3812,3631
"12886",233921,1995,1,0,"VIRGINIA POLYTECHNIC INSTITUTE AND STATE UNIV",NA,NA,4687,2050,2637,1819,745,1074,0.524,0.388,0.283,4087,4074
"12887",233921,1996,1,0,"VIRGINIA POLYTECHNIC INSTITUTE AND STATE UNIV",NA,NA,5057,2061,2996,2120,970,1150,0.558,0.419,0.324,4131,4377
"12888",233921,1997,1,0,"VIRGINIA POLYTECHNIC INSTITUTE AND STATE UNIV",NA,NA,4522,1818,2704,1903,869,1034,0.569,0.421,0.321,4147,3910
"12889",233921,1998,1,0,"VIRGINIA POLYTECHNIC INSTITUTE AND STATE UNIV",NA,NA,4638,1941,2697,1999,855,1144,0.589,0.431,0.317,4305,3978
"12890",233921,1999,1,0,"VIRGINIA POLYTECHNIC INSTITUTE AND STATE UNIV",NA,NA,4653,1957,2696,2177,996,1181,0.604,0.468,0.369,2792,4020
"12891",233921,2000,1,0,"VIRGINIA POLYTECHNIC INSTITUTE AND STATE UNIV",NA,NA,4586,2024,2562,2339,1047,1292,0.638,0.51,0.409,2792,3878
"12892",233921,2001,1,0,"VIRGINIA POLYTECHNIC INSTITUTE AND STATE UNIV",NA,NA,5020,2063,2957,2511,1228,1283,0.622,0.5,0.415,2792,3868
"12893",233921,2002,1,0,"VIRGINIA POLYTECHNIC INSTITUTE AND STATE UNIV",NA,NA,4714,2002,2712,2437,1151,1286,0.642,0.517,0.424,3044,3579
"12894",233921,2003,1,0,"VIRGINIA POLYTECHNIC INSTITUTE AND STATE UNIV",NA,NA,4923,2092,2831,2588,1213,1375,0.657,0.526,0.428,4190,3635
"12895",233921,2004,1,0,"VIRGINIA POLYTECHNIC INSTITUTE AND STATE UNIV",NA,NA,4923,2042,2881,2599,1252,1347,0.66,0.528,0.435,4513,3613
"12896",233921,2005,1,0,"Virginia Polytechnic Institute and State University",NA,NA,5026,2190,2836,2797,1296,1501,0.685,0.557,0.457,4959,3697
"12897",233921,2006,1,0,"Virginia Polytechnic Institute and State University",NA,NA,5078,2273,2805,2953,1367,1586,0.698,0.582,0.487,5450,3423
"12898",233921,2007,1,0,"Virginia Polytechnic Institute and State University",NA,NA,5112,2264,2848,3063,1430,1633,0.721,0.599,0.502,5772,3852
"12899",233921,2008,1,0,"Virginia Polytechnic Institute and State University",NA,NA,5449,2449,3000,3306,1509,1797,0.734,0.607,0.503,6332,4219
"12900",233921,2009,1,0,"Virginia Polytechnic Institute and State University",NA,NA,5036,2266,2770,3075,1446,1629,0.719,0.611,0.522,6639,3885
"12901",233921,2010,1,0,"Virginia Polytechnic Institute and State University",NA,NA,5193,2158,3035,3130,1587,1543,0.715,0.603,0.523,7309,4007
"12902",234030,1991,1,0,"VIRGINIA COMMONWEALTH UNIVERSITY",NA,NA,1318,799,519,216,65,151,0.189,0.164,0.125,3069,896
"12903",234030,1992,1,0,"VIRGINIA COMMONWEALTH UNIVERSITY",NA,NA,1460,877,583,270,92,178,0.203,0.185,0.158,3529,994
"12904",234030,1993,1,0,"VIRGINIA COMMONWEALTH UNIVERSITY",NA,NA,1466,874,592,281,80,201,0.23,0.192,0.135,3747,1001
"12905",234030,1995,1,0,"VIRGINIA COMMONWEALTH UNIVERSITY",NA,NA,1655,963,692,320,104,216,0.224,0.193,0.15,4030,1001
"12906",234030,1996,1,0,"VIRGINIA COMMONWEALTH UNIVERSITY",NA,NA,1875,1146,729,352,103,249,0.217,0.188,0.141,4071,1102
"12907",234030,1997,1,0,"VIRGINIA COMMONWEALTH UNIVERSITY",NA,NA,2175,1301,874,337,106,231,0.178,0.155,0.121,4111,1313
"12908",234030,1998,1,0,"VIRGINIA COMMONWEALTH UNIVERSITY",NA,NA,2141,1257,884,364,117,247,0.196,0.17,0.132,4182,1359
"12909",234030,1999,1,0,"VIRGINIA COMMONWEALTH UNIVERSITY",NA,NA,2408,1427,981,499,164,335,0.235,0.207,0.167,2492,1476
"12910",234030,2000,1,0,"VIRGINIA COMMONWEALTH UNIVERSITY",NA,NA,2670,1608,1062,522,161,361,0.224,0.196,0.152,2492,1684
"12911",234030,2001,1,0,"VIRGINIA COMMONWEALTH UNIVERSITY",NA,NA,2675,1563,1112,547,170,377,0.241,0.204,0.153,2492,1682
"12912",234030,2002,1,0,"VIRGINIA COMMONWEALTH UNIVERSITY",NA,NA,3014,1810,1204,711,237,474,0.262,0.236,0.197,2716,1893
"12913",234030,2003,1,0,"VIRGINIA COMMONWEALTH UNIVERSITY",NA,NA,3230,1912,1318,779,218,561,0.293,0.241,0.165,3600,2006
"12914",234030,2004,1,0,"VIRGINIA COMMONWEALTH UNIVERSITY",NA,NA,3271,1960,1311,749,220,529,0.27,0.229,0.168,3780,2051
"12915",234030,2005,1,0,"Virginia Commonwealth University",NA,NA,3432,2052,1380,904,306,598,0.291,0.263,0.222,4012,1937
"12916",234030,2006,1,0,"Virginia Commonwealth University",NA,NA,3445,1986,1459,1018,346,672,0.338,0.296,0.237,4270,1811
"12917",234030,2007,1,0,"Virginia Commonwealth University",NA,NA,3802,2159,1643,1129,405,724,0.335,0.297,0.247,4525,1942
"12918",234030,2008,1,0,"Virginia Commonwealth University",NA,NA,3640,2128,1512,1227,429,798,0.375,0.337,0.284,4992,1858
"12919",234030,2009,1,0,"Virginia Commonwealth University",NA,NA,3588,2094,1494,1318,475,843,0.403,0.367,0.318,5253,1814
"12920",234030,2010,1,0,"Virginia Commonwealth University",NA,NA,3533,2086,1447,1256,445,811,0.389,0.356,0.308,6953,1809
"12921",234085,1991,1,0,"VIRGINIA MILITARY INSTITUTE",NA,NA,351,0,351,127,127,0,NA,0.362,0.362,4325,289
"12922",234085,1992,1,0,"VIRGINIA MILITARY INSTITUTE",NA,NA,349,0,349,174,174,0,NA,0.499,0.499,4640,296
"12923",234085,1993,1,0,"VIRGINIA MILITARY INSTITUTE",NA,NA,278,0,278,131,131,0,NA,0.471,0.471,4940,226
"12924",234085,1995,1,0,"VIRGINIA MILITARY INSTITUTE",NA,NA,335,0,335,182,182,0,NA,0.543,0.543,5820,283
"12925",234085,1996,1,0,"VIRGINIA MILITARY INSTITUTE",NA,NA,339,0,339,170,170,0,NA,0.501,0.501,6050,306
"12926",234085,1997,1,0,"VIRGINIA MILITARY INSTITUTE",NA,NA,394,20,374,201,188,13,0.65,0.51,0.503,6380,322
"12927",234085,1998,1,0,"VIRGINIA MILITARY INSTITUTE",NA,NA,375,23,352,180,174,6,0.261,0.48,0.494,6490,322
"12928",234085,1999,1,0,"VIRGINIA MILITARY INSTITUTE",NA,NA,369,24,345,194,180,14,0.583,0.526,0.522,2924,304
"12929",234085,2000,1,0,"VIRGINIA MILITARY INSTITUTE",NA,NA,349,22,327,204,189,15,0.682,0.585,0.578,2924,310
"12930",234085,2001,1,0,"VIRGINIA MILITARY INSTITUTE",NA,NA,372,17,355,205,196,9,0.529,0.551,0.552,2924,310
"12931",234085,2002,1,0,"VIRGINIA MILITARY INSTITUTE",NA,NA,356,24,332,209,197,12,0.5,0.587,0.593,3124,310
"12932",234085,2003,1,0,"VIRGINIA MILITARY INSTITUTE",NA,NA,384,36,348,246,223,23,0.639,0.641,0.641,3856,330
"12933",234085,2004,1,0,"VIRGINIA MILITARY INSTITUTE",NA,NA,363,24,339,216,205,11,0.458,0.595,0.605,4050,315
"12934",234085,2005,1,0,"Virginia Military Institute",NA,NA,363,40,323,209,187,22,0.55,0.576,0.579,4382,307
"12935",234085,2006,1,0,"Virginia Military Institute",NA,NA,387,34,353,216,200,16,0.471,0.558,0.567,4776,330
"12936",234085,2007,1,0,"Virginia Military Institute",NA,NA,410,36,374,240,221,19,0.528,0.585,0.591,5062,334
"12937",234085,2008,1,0,"Virginia Military Institute",NA,NA,391,33,358,210,192,18,0.545,0.537,0.536,5262,314
"12938",234085,2009,1,0,"Virginia Military Institute",NA,NA,429,42,387,261,237,24,0.571,0.608,0.612,5500,360
"12939",234085,2010,1,0,"Virginia Military Institute",NA,NA,440,51,389,64,27,37,0.726,0.145,0.069,6024,384
"12940",234155,1991,1,0,"VIRGINIA STATE UNIVERSITY",NA,NA,1161,692,469,107,12,95,0.137,0.092,0.026,2668,11
"12941",234155,1992,1,0,"VIRGINIA STATE UNIVERSITY",NA,NA,911,496,415,46,11,35,0.071,0.05,0.027,2913,13
"12942",234155,1993,1,0,"VIRGINIA STATE UNIVERSITY",NA,NA,695,409,286,88,33,55,0.134,0.127,0.115,3050,12
"12943",234155,1995,1,0,"VIRGINIA STATE UNIVERSITY",NA,NA,734,431,303,131,35,96,0.223,0.178,0.116,3256,10
"12944",234155,1996,1,0,"VIRGINIA STATE UNIVERSITY",NA,NA,782,465,317,186,47,139,0.299,0.238,0.148,3291,6
"12945",234155,1997,1,0,"VIRGINIA STATE UNIVERSITY",NA,NA,865,493,372,170,48,122,0.248,0.197,0.129,3307,11
"12946",234155,1998,1,0,"VIRGINIA STATE UNIVERSITY",NA,NA,871,526,345,192,48,144,0.274,0.22,0.139,3439,11
"12947",234155,1999,1,0,"VIRGINIA STATE UNIVERSITY",NA,NA,937,543,394,185,48,137,0.252,0.197,0.122,1588,3
"12948",234155,2000,1,0,"VIRGINIA STATE UNIVERSITY",NA,NA,885,498,387,187,45,142,0.285,0.211,0.116,1588,7
"12949",234155,2001,1,0,"VIRGINIA STATE UNIVERSITY",NA,NA,1085,618,467,252,61,191,0.309,0.232,0.131,1588,9
"12950",234155,2002,1,0,"VIRGINIA STATE UNIVERSITY",NA,NA,1129,650,479,237,60,177,0.272,0.21,0.125,1780,9
"12951",234155,2003,1,0,"VIRGINIA STATE UNIVERSITY",NA,NA,959,563,396,240,62,178,0.316,0.25,0.157,2412,7
"12952",234155,2004,1,0,"VIRGINIA STATE UNIVERSITY",NA,NA,1025,656,369,250,54,196,0.299,0.244,0.146,2150,7
"12953",234155,2005,1,0,"Virginia State University",NA,NA,1176,775,401,234,48,186,0.24,0.199,0.12,2317,11
"12954",234155,2006,1,0,"Virginia State University",NA,NA,869,540,329,209,54,155,0.287,0.241,0.164,3007,5
"12955",234155,2007,1,0,"Virginia State University",NA,NA,1185,796,389,259,58,201,0.252,0.219,0.149,3186,9
"12956",234155,2008,1,0,"Virginia State University",NA,NA,1323,832,491,302,64,238,0.286,0.228,0.13,3313,22
"12957",234155,2009,1,0,"Virginia State University",NA,NA,1225,806,419,353,93,260,0.323,0.288,0.222,3584,14
"12958",234155,2010,1,0,"Virginia State University",NA,NA,1282,802,480,307,64,243,0.303,0.239,0.133,3886,16
"12959",234164,1991,1,0,"VIRGINIA UNION UNIVERSITY",NA,NA,382,196,186,53,9,44,0.224,0.139,0.048,6153,0
"12960",234164,1992,1,0,"VIRGINIA UNION UNIVERSITY",NA,NA,449,238,211,45,12,33,0.139,0.1,0.057,6557,0
"12961",234164,1993,1,0,"VIRGINIA UNION UNIVERSITY",NA,NA,435,240,195,49,15,34,0.142,0.113,0.077,7061,0
"12962",234164,1995,1,0,"VIRGINIA UNION UNIVERSITY",NA,NA,441,234,207,2,0,2,0.009,0.005,0,8219,1
"12963",234164,1996,1,0,"VIRGINIA UNION UNIVERSITY",NA,NA,380,211,169,75,16,59,0.28,0.197,0.095,8590,5
"12964",234164,1997,1,0,"VIRGINIA UNION UNIVERSITY",NA,NA,304,155,149,3,1,2,0.013,0.01,0.007,8980,1
"12965",234164,1998,1,0,"VIRGINIA UNION UNIVERSITY",NA,NA,313,191,122,61,15,46,0.241,0.195,0.123,9110,0
"12966",234164,1999,1,0,"VIRGINIA UNION UNIVERSITY",NA,NA,268,167,101,50,8,42,0.252,0.187,0.079,8780,0
"12967",234164,2000,1,0,"VIRGINIA UNION UNIVERSITY",NA,NA,456,265,191,69,16,53,0.2,0.151,0.084,8780,3
"12968",234164,2001,1,0,"VIRGINIA UNION UNIVERSITY",NA,NA,534,316,218,68,12,56,0.177,0.127,0.055,9640,3
"12969",234164,2002,1,0,"VIRGINIA UNION UNIVERSITY",NA,NA,437,259,178,74,14,60,0.232,0.169,0.079,16082,3
"12970",234164,2003,1,0,"VIRGINIA UNION UNIVERSITY",NA,NA,512,318,194,99,16,83,0.261,0.193,0.082,10460,5
"12971",234164,2004,1,0,"VIRGINIA UNION UNIVERSITY",NA,NA,431,247,184,78,17,61,0.247,0.181,0.092,11090,4
"12972",234164,2005,1,0,"Virginia Union University",NA,NA,356,197,159,57,14,43,0.218,0.16,0.088,11600,4
"12973",234164,2006,1,0,"Virginia Union University",NA,NA,325,160,165,58,13,45,0.281,0.178,0.079,11948,1
"12974",234164,2007,1,0,"Virginia Union University",NA,NA,375,209,166,81,17,64,0.306,0.216,0.102,12188,2
"12975",234164,2008,1,0,"Virginia Union University",NA,NA,345,170,175,48,20,28,0.165,0.139,0.114,12432,0
"12976",234164,2009,1,0,"Virginia Union University",NA,NA,554,303,251,99,34,65,0.214,0.179,0.135,12680,0
"12977",234164,2010,1,0,"Virginia Union University",NA,NA,460,260,200,76,26,50,0.192,0.165,0.13,13314,0
"12978",235097,1991,0,1,"EASTERN WASHINGTON UNIVERSITY",9999,0,730,421,309,114,40,74,0.176,0.156,0.129,1698,611
"12979",235097,1992,0,1,"EASTERN WASHINGTON UNIVERSITY",9999,0,753,480,273,124,38,86,0.179,0.165,0.139,1785,615
"12980",235097,1993,0,1,"EASTERN WASHINGTON UNIVERSITY",9999,0,725,424,301,131,45,86,0.203,0.181,0.15,2091,581
"12981",235097,1995,0,1,"EASTERN WASHINGTON UNIVERSITY",9999,0,687,464,223,109,18,91,0.196,0.159,0.081,2463,546
"12982",235097,1996,0,1,"EASTERN WASHINGTON UNIVERSITY",9999,0,639,399,240,114,29,85,0.213,0.178,0.121,2445,506
"12983",235097,1997,0,1,"EASTERN WASHINGTON UNIVERSITY",9999,0,624,367,257,86,21,65,0.177,0.138,0.082,2520,512
"12984",235097,1998,0,1,"EASTERN WASHINGTON UNIVERSITY",9999,0,816,486,330,148,34,114,0.235,0.181,0.103,2622,637
"12985",235097,1999,0,1,"EASTERN WASHINGTON UNIVERSITY",9999,0,1072,652,420,164,45,119,0.182,0.153,0.107,2700,851
"12986",235097,2000,0,1,"EASTERN WASHINGTON UNIVERSITY",9999,0,1085,642,443,227,64,163,0.254,0.209,0.144,2790,876
"12987",235097,2001,0,1,"EASTERN WASHINGTON UNIVERSITY",9999,0,1179,694,485,256,98,158,0.228,0.217,0.202,2964,939
"12988",235097,2002,0,1,"EASTERN WASHINGTON UNIVERSITY",9999,0,1265,768,497,274,84,190,0.247,0.217,0.169,3357,1003
"12989",235097,2003,0,1,"EASTERN WASHINGTON UNIVERSITY",9999,0,1374,843,531,295,81,214,0.254,0.215,0.153,3582,948
"12990",235097,2004,0,1,"EASTERN WASHINGTON UNIVERSITY",9999,0,1403,813,590,297,102,195,0.24,0.212,0.173,3822,999
"12991",235097,2005,0,1,"Eastern Washington University",9999,0,1610,992,618,340,120,220,0.222,0.211,0.194,4044,1124
"12992",235097,2006,0,1,"Eastern Washington University",9999,0,1412,855,557,280,84,196,0.229,0.198,0.151,4278,941
"12993",235097,2007,0,1,"Eastern Washington University",9999,0,1313,770,543,243,81,162,0.21,0.185,0.149,4805,897
"12994",235097,2008,0,1,"Eastern Washington University",9999,0,1488,859,629,295,110,185,0.215,0.198,0.175,4701,1019
"12995",235097,2009,0,1,"Eastern Washington University",9999,0,1459,848,611,298,98,200,0.236,0.204,0.16,5340,940
"12996",235097,2010,0,1,"Eastern Washington University",9999,0,1524,887,637,324,109,215,0.242,0.213,0.171,6063,1035
"12997",235167,1991,0,1,"EVERGREEN STATE COLLEGE",9999,0,445,263,182,173,59,114,0.434,0.389,0.324,1758,348
"12998",235167,1992,0,1,"EVERGREEN STATE COLLEGE",9999,0,399,239,160,116,39,77,0.322,0.291,0.244,1785,313
"12999",235167,1993,0,1,"EVERGREEN STATE COLLEGE",9999,0,435,253,182,158,63,95,0.376,0.363,0.346,1971,335
"13000",235167,1995,0,1,"EVERGREEN STATE COLLEGE",9999,0,536,318,218,224,88,136,0.428,0.418,0.404,2442,396
"13001",235167,1996,0,1,"EVERGREEN STATE COLLEGE",9999,0,530,308,222,200,74,126,0.409,0.377,0.333,2544,407
"13002",235167,1997,0,1,"EVERGREEN STATE COLLEGE",9999,0,494,271,223,186,71,115,0.424,0.377,0.318,2573,340
"13003",235167,1998,0,1,"EVERGREEN STATE COLLEGE",9999,0,475,280,195,185,65,120,0.429,0.389,0.333,2637,348
"13004",235167,1999,0,1,"EVERGREEN STATE COLLEGE",9999,0,456,256,200,190,69,121,0.473,0.417,0.345,2757,323
"13005",235167,2000,0,1,"EVERGREEN STATE COLLEGE",9999,0,468,254,214,208,81,127,0.5,0.444,0.379,2856,333
"13006",235167,2001,0,1,"EVERGREEN STATE COLLEGE",9999,0,460,236,224,206,93,113,0.479,0.448,0.415,3024,347
"13007",235167,2002,0,1,"EVERGREEN STATE COLLEGE",9999,0,486,236,250,250,133,117,0.496,0.514,0.532,3441,361
"13008",235167,2003,0,1,"EVERGREEN STATE COLLEGE",9999,0,454,246,208,193,98,95,0.386,0.425,0.471,3651,308
"13009",235167,2004,0,1,"EVERGREEN STATE COLLEGE",9999,0,479,250,229,185,87,98,0.392,0.386,0.38,3900,333
"13010",235167,2005,0,1,"The Evergreen State College",9999,0,590,296,294,243,114,129,0.436,0.412,0.388,4128,429
"13011",235167,2006,0,1,"The Evergreen State College",9999,0,577,300,277,227,103,124,0.413,0.393,0.372,4371,414
"13012",235167,2007,0,1,"The Evergreen State College",9999,0,677,347,330,288,138,150,0.432,0.425,0.418,4590,488
"13013",235167,2008,0,1,"The Evergreen State College",9999,0,658,321,337,302,146,156,0.486,0.459,0.433,4797,498
"13014",235167,2009,0,1,"The Evergreen State College",9999,0,576,284,292,234,112,122,0.43,0.406,0.384,5412,408
"13015",235167,2010,0,1,"The Evergreen State College",9999,0,612,332,280,265,118,147,0.443,0.433,0.421,6108,431
"13016",236230,1991,1,0,"PACIFIC LUTHERAN UNIVERSITY",NA,NA,489,291,198,215,63,152,0.522,0.44,0.318,11075,432
"13017",236230,1992,1,0,"PACIFIC LUTHERAN UNIVERSITY",NA,NA,500,295,205,214,69,145,0.492,0.428,0.337,11968,441
"13018",236230,1993,1,0,"PACIFIC LUTHERAN UNIVERSITY",NA,NA,499,269,230,228,90,138,0.513,0.457,0.391,12672,437
"13019",236230,1995,1,0,"PACIFIC LUTHERAN UNIVERSITY",NA,NA,667,394,273,264,81,183,0.464,0.396,0.297,13856,571
"13020",236230,1996,1,0,"PACIFIC LUTHERAN UNIVERSITY",NA,NA,610,359,251,284,97,187,0.521,0.466,0.386,14560,523
"13021",236230,1997,1,0,"PACIFIC LUTHERAN UNIVERSITY",NA,NA,660,394,266,303,87,216,0.548,0.459,0.327,15316,551
"13022",236230,1998,1,0,"PACIFIC LUTHERAN UNIVERSITY",NA,NA,652,414,238,272,77,195,0.471,0.417,0.324,15680,541
"13023",236230,1999,1,0,"PACIFIC LUTHERAN UNIVERSITY",NA,NA,562,370,192,241,77,164,0.443,0.429,0.401,16224,455
"13024",236230,2000,1,0,"PACIFIC LUTHERAN UNIVERSITY",NA,NA,580,355,225,293,94,199,0.561,0.505,0.418,16800,495
"13025",236230,2001,1,0,"PACIFIC LUTHERAN UNIVERSITY",NA,NA,578,348,230,287,89,198,0.569,0.497,0.387,17728,483
"13026",236230,2002,1,0,"PACIFIC LUTHERAN UNIVERSITY",NA,NA,625,400,225,325,98,227,0.568,0.52,0.436,18500,508
"13027",236230,2003,1,0,"PACIFIC LUTHERAN UNIVERSITY",NA,NA,693,426,267,361,118,243,0.57,0.521,0.442,19610,556
"13028",236230,2004,1,0,"PACIFIC LUTHERAN UNIVERSITY",NA,NA,697,462,235,327,96,231,0.5,0.469,0.409,20790,540
"13029",236230,2005,1,0,"Pacific Lutheran University",NA,NA,687,432,255,340,106,234,0.542,0.495,0.416,22040,550
"13030",236230,2006,1,0,"Pacific Lutheran University",NA,NA,668,418,250,401,142,259,0.62,0.6,0.568,23450,517
"13031",236230,2007,1,0,"Pacific Lutheran University",NA,NA,714,453,261,394,134,260,0.574,0.552,0.513,25088,533
"13032",236230,2008,1,0,"Pacific Lutheran University",NA,NA,712,444,268,372,115,257,0.579,0.522,0.429,26800,553
"13033",236230,2009,1,0,"Pacific Lutheran University",NA,NA,712,436,276,373,123,250,0.573,0.524,0.446,28100,557
"13034",236230,2010,1,0,"Pacific Lutheran University",NA,NA,687,415,272,398,141,257,0.619,0.579,0.518,29200,512
"13035",236328,1991,1,0,"UNIVERSITY OF PUGET SOUND",NA,NA,696,395,301,401,162,239,0.605,0.576,0.538,12690,531
"13036",236328,1992,1,0,"UNIVERSITY OF PUGET SOUND",NA,NA,725,446,279,433,166,267,0.599,0.597,0.595,13780,557
"13037",236328,1993,1,0,"UNIVERSITY OF PUGET SOUND",NA,NA,687,402,285,402,159,243,0.605,0.585,0.558,15220,518
"13038",236328,1995,1,0,"UNIVERSITY OF PUGET SOUND",NA,NA,656,374,282,404,162,242,0.647,0.616,0.574,17310,494
"13039",236328,1996,1,0,"UNIVERSITY OF PUGET SOUND",NA,NA,740,445,295,459,171,288,0.647,0.62,0.58,18030,525
"13040",236328,1997,1,0,"UNIVERSITY OF PUGET SOUND",NA,NA,642,390,252,430,155,275,0.705,0.67,0.615,18940,492
"13041",236328,1998,1,0,"UNIVERSITY OF PUGET SOUND",NA,NA,680,417,263,446,151,295,0.707,0.656,0.574,19795,525
"13042",236328,1999,1,0,"UNIVERSITY OF PUGET SOUND",NA,NA,682,413,269,443,170,273,0.661,0.65,0.632,20450,528
"13043",236328,2000,1,0,"UNIVERSITY OF PUGET SOUND",NA,NA,647,408,239,442,155,287,0.703,0.683,0.649,21270,474
"13044",236328,2001,1,0,"UNIVERSITY OF PUGET SOUND",NA,NA,702,423,279,477,182,295,0.697,0.679,0.652,22350,562
"13045",236328,2002,1,0,"UNIVERSITY OF PUGET SOUND",NA,NA,666,399,267,459,173,286,0.717,0.689,0.648,23780,531
"13046",236328,2003,1,0,"UNIVERSITY OF PUGET SOUND",NA,NA,639,358,281,438,164,274,0.765,0.685,0.584,25190,483
"13047",236328,2004,1,0,"UNIVERSITY OF PUGET SOUND",NA,NA,671,390,281,471,190,281,0.721,0.702,0.676,26700,513
"13048",236328,2005,1,0,"University of Puget Sound",NA,NA,669,385,284,446,180,266,0.691,0.667,0.634,28270,497
"13049",236328,2006,1,0,"University of Puget Sound",NA,NA,677,406,271,464,173,291,0.717,0.685,0.638,29870,522
"13050",236328,2007,1,0,"University of Puget Sound",NA,NA,641,393,248,437,157,280,0.713,0.682,0.633,31700,473
"13051",236328,2008,1,0,"University of Puget Sound",NA,NA,676,377,299,459,187,272,0.722,0.679,0.625,33780,540
"13052",236328,2009,1,0,"University of Puget Sound",NA,NA,719,419,300,517,198,319,0.761,0.719,0.66,35440,547
"13053",236328,2010,1,0,"University of Puget Sound",NA,NA,625,355,270,436,168,268,0.755,0.698,0.622,37030,495
"13054",236577,1991,0,1,"SEATTLE PACIFIC UNIVERSITY",9999,0,370,253,117,95,27,68,0.269,0.257,0.231,10581,311
"13055",236577,1992,0,1,"SEATTLE PACIFIC UNIVERSITY",9999,0,380,253,127,103,24,79,0.312,0.271,0.189,11301,316
"13056",236577,1993,0,1,"SEATTLE PACIFIC UNIVERSITY",9999,0,395,263,132,117,42,75,0.285,0.296,0.318,11979,346
"13057",236577,1995,0,1,"SEATTLE PACIFIC UNIVERSITY",9999,0,397,254,143,138,58,80,0.315,0.348,0.406,13479,340
"13058",236577,1996,0,1,"SEATTLE PACIFIC UNIVERSITY",9999,0,465,323,142,173,52,121,0.375,0.372,0.366,13680,421
"13059",236577,1997,0,1,"SEATTLE PACIFIC UNIVERSITY",9999,0,584,392,192,233,63,170,0.434,0.399,0.328,14130,496
"13060",236577,1998,0,1,"SEATTLE PACIFIC UNIVERSITY",9999,0,582,376,206,232,75,157,0.418,0.399,0.364,14541,506
"13061",236577,1999,0,1,"SEATTLE PACIFIC UNIVERSITY",9999,0,567,392,175,272,79,193,0.492,0.48,0.451,14924,490
"13062",236577,2000,0,1,"SEATTLE PACIFIC UNIVERSITY",9999,0,612,413,199,293,90,203,0.492,0.479,0.452,15381,532
"13063",236577,2001,0,1,"SEATTLE PACIFIC UNIVERSITY",9999,0,645,433,212,327,95,232,0.536,0.507,0.448,16335,565
"13064",236577,2002,0,1,"SEATTLE PACIFIC UNIVERSITY",9999,0,601,412,189,302,94,208,0.505,0.502,0.497,17592,519
"13065",236577,2003,0,1,"SEATTLE PACIFIC UNIVERSITY",9999,0,683,485,198,410,105,305,0.629,0.6,0.53,18822,599
"13066",236577,2004,0,1,"SEATTLE PACIFIC UNIVERSITY",9999,0,633,414,219,341,115,226,0.546,0.539,0.525,20139,497
"13067",236577,2005,0,1,"Seattle Pacific University",9999,0,710,490,220,425,123,302,0.616,0.599,0.559,21447,596
"13068",236577,2006,0,1,"Seattle Pacific University",9999,0,622,413,209,350,111,239,0.579,0.563,0.531,23055,514
"13069",236577,2007,0,1,"Seattle Pacific University",9999,0,716,499,217,390,110,280,0.561,0.545,0.507,24783,548
"13070",236577,2008,0,1,"Seattle Pacific University",9999,0,712,492,220,431,122,309,0.628,0.605,0.555,26457,563
"13071",236577,2009,0,1,"Seattle Pacific University",9999,0,682,489,193,361,93,268,0.548,0.529,0.482,27450,484
"13072",236577,2010,0,1,"Seattle Pacific University",9999,0,726,501,225,405,120,285,0.569,0.558,0.533,28602,549
"13073",236595,1991,0,1,"SEATTLE UNIVERSITY",9999,0,390,229,161,133,51,82,0.358,0.341,0.317,10710,218
"13074",236595,1992,0,1,"SEATTLE UNIVERSITY",9999,0,439,236,203,161,74,87,0.369,0.367,0.365,11520,231
"13075",236595,1993,0,1,"SEATTLE UNIVERSITY",9999,0,489,276,213,165,61,104,0.377,0.337,0.286,12150,309
"13076",236595,1995,0,1,"SEATTLE UNIVERSITY",9999,0,426,245,181,165,56,109,0.445,0.387,0.309,13635,235
"13077",236595,1996,0,1,"SEATTLE UNIVERSITY",9999,0,576,358,218,245,78,167,0.466,0.425,0.358,14265,319
"13078",236595,1997,0,1,"SEATTLE UNIVERSITY",9999,0,499,288,211,220,78,142,0.493,0.441,0.37,14805,278
"13079",236595,1998,0,1,"SEATTLE UNIVERSITY",9999,0,626,369,257,287,114,173,0.469,0.458,0.444,15255,335
"13080",236595,1999,0,1,"SEATTLE UNIVERSITY",9999,0,578,351,227,256,92,164,0.467,0.443,0.405,16110,300
"13081",236595,2000,0,1,"SEATTLE UNIVERSITY",9999,0,664,428,236,338,104,234,0.547,0.509,0.441,17010,353
"13082",236595,2001,0,1,"SEATTLE UNIVERSITY",9999,0,643,412,231,321,101,220,0.534,0.499,0.437,17865,358
"13083",236595,2002,0,1,"SEATTLE UNIVERSITY",9999,0,633,387,246,324,110,214,0.553,0.512,0.447,18885,341
"13084",236595,2003,0,1,"SEATTLE UNIVERSITY",9999,0,619,418,201,323,75,248,0.593,0.522,0.373,20070,330
"13085",236595,2004,0,1,"SEATTLE UNIVERSITY",9999,0,719,447,272,407,138,269,0.602,0.566,0.507,21285,404
"13086",236595,2005,0,1,"Seattle University",9999,0,739,454,285,422,156,266,0.586,0.571,0.547,22905,425
"13087",236595,2006,0,1,"Seattle University",9999,0,731,463,268,455,165,290,0.626,0.622,0.616,24615,394
"13088",236595,2007,0,1,"Seattle University",9999,0,736,479,257,432,127,305,0.637,0.587,0.494,26325,399
"13089",236595,2008,0,1,"Seattle University",9999,0,881,557,324,530,170,360,0.646,0.602,0.525,28260,522
"13090",236595,2009,0,1,"Seattle University",9999,0,730,459,271,468,156,312,0.68,0.641,0.576,29340,375
"13091",236595,2010,0,1,"Seattle University",9999,0,1037,660,377,667,232,435,0.659,0.643,0.615,30825,566
"13092",236896,1991,0,1,"WALLA WALLA COLLEGE",9999,0,282,132,150,55,26,29,0.22,0.195,0.173,9089,231
"13093",236896,1992,0,1,"WALLA WALLA COLLEGE",9999,0,267,126,141,58,27,31,0.246,0.217,0.191,9666,205
"13094",236896,1993,0,1,"WALLA WALLA COLLEGE",9999,0,263,138,125,70,29,41,0.297,0.266,0.232,10200,219
"13095",236896,1995,0,1,"WALLA WALLA COLLEGE",9999,0,288,145,143,57,22,35,0.241,0.198,0.154,12140,262
"13096",236896,1996,0,1,"WALLA WALLA COLLEGE",9999,0,292,144,148,40,18,22,0.153,0.137,0.122,12033,263
"13097",236896,1997,0,1,"WALLA WALLA COLLEGE",9999,0,283,142,141,62,29,33,0.232,0.219,0.206,12588,244
"13098",236896,1998,0,1,"WALLA WALLA COLLEGE",9999,0,305,165,140,60,27,33,0.2,0.197,0.193,13854,274
"13099",236896,1999,0,1,"WALLA WALLA COLLEGE",9999,0,323,158,165,64,28,36,0.228,0.198,0.17,14601,275
"13100",236896,2000,0,1,"WALLA WALLA COLLEGE",9999,0,338,160,178,62,25,37,0.231,0.183,0.14,15303,289
"13101",236896,2001,0,1,"WALLA WALLA COLLEGE",9999,0,285,149,136,63,26,37,0.248,0.221,0.191,16107,248
"13102",236896,2002,0,1,"WALLA WALLA COLLEGE",9999,0,336,172,164,61,29,32,0.186,0.182,0.177,16134,282
"13103",236896,2003,0,1,"WALLA WALLA COLLEGE",9999,0,326,157,169,66,31,35,0.223,0.202,0.183,16860,265
"13104",236896,2004,0,1,"WALLA WALLA COLLEGE",9999,0,352,173,179,83,33,50,0.289,0.236,0.184,17655,279
"13105",236896,2005,0,1,"Walla Walla College",9999,0,292,132,160,62,34,28,0.212,0.212,0.212,18696,229
"13106",236896,2006,0,1,"Walla Walla College",9999,0,323,164,159,62,28,34,0.207,0.192,0.176,19725,238
"13107",236896,2007,0,1,"Walla Walla University",9999,0,344,162,182,58,25,33,0.204,0.169,0.137,20910,263
"13108",236896,2008,0,1,"Walla Walla University",9999,0,310,158,152,63,24,39,0.247,0.203,0.158,21726,224
"13109",236896,2009,0,1,"Walla Walla University",9999,0,316,157,159,59,20,39,0.248,0.187,0.126,22575,241
"13110",236896,2010,0,1,"Walla Walla University",9999,0,305,151,154,72,35,37,0.245,0.236,0.227,23229,243
"13111",236939,1991,1,0,"WASHINGTON STATE UNIVERSITY",NA,NA,1852,982,870,470,171,299,0.304,0.254,0.197,2178,1544
"13112",236939,1992,1,0,"WASHINGTON STATE UNIVERSITY",NA,NA,2027,1019,1008,527,212,315,0.309,0.26,0.21,2254,1703
"13113",236939,1993,1,0,"WASHINGTON STATE UNIVERSITY",NA,NA,2431,1234,1197,644,235,409,0.331,0.265,0.196,2532,2000
"13114",236939,1995,1,0,"WASHINGTON STATE UNIVERSITY",NA,NA,2512,1217,1295,734,315,419,0.344,0.292,0.243,3022,2022
"13115",236939,1996,1,0,"WASHINGTON STATE UNIVERSITY",NA,NA,2272,1169,1103,694,263,431,0.369,0.305,0.238,3142,1828
"13116",236939,1997,1,0,"WASHINGTON STATE UNIVERSITY",NA,NA,2276,1191,1085,657,235,422,0.354,0.289,0.217,3266,1791
"13117",236939,1998,1,0,"WASHINGTON STATE UNIVERSITY",NA,NA,2934,1526,1408,888,335,553,0.362,0.303,0.238,3396,2353
"13118",236939,1999,1,0,"WASHINGTON STATE UNIVERSITY",NA,NA,2456,1276,1180,791,306,485,0.38,0.322,0.259,3233,2042
"13119",236939,2000,1,0,"WASHINGTON STATE UNIVERSITY",NA,NA,2440,1257,1183,794,277,517,0.411,0.325,0.234,3351,1982
"13120",236939,2001,1,0,"WASHINGTON STATE UNIVERSITY",NA,NA,2575,1369,1206,852,314,538,0.393,0.331,0.26,3574,2044
"13121",236939,2002,1,0,"WASHINGTON STATE UNIVERSITY",NA,NA,2771,1469,1302,1018,372,646,0.44,0.367,0.286,4145,2139
"13122",236939,2003,1,0,"WASHINGTON STATE UNIVERSITY",NA,NA,2997,1613,1384,1204,417,787,0.488,0.402,0.301,4435,2355
"13123",236939,2004,1,0,"WASHINGTON STATE UNIVERSITY",NA,NA,3089,1622,1467,1251,495,756,0.466,0.405,0.337,4745,2398
"13124",236939,2005,1,0,"Washington State University",NA,NA,2855,1418,1437,1072,413,659,0.465,0.375,0.287,5077,2301
"13125",236939,2006,1,0,"Washington State University",NA,NA,2676,1349,1327,1040,417,623,0.462,0.389,0.314,5432,2108
"13126",236939,2007,1,0,"Washington State University",NA,NA,3184,1588,1596,1275,508,767,0.483,0.4,0.318,5812,2468
"13127",236939,2008,1,0,"Washington State University",NA,NA,3391,1744,1647,1408,536,872,0.5,0.415,0.325,6218,2610
"13128",236939,2009,1,0,"Washington State University",NA,NA,3627,1888,1739,1366,549,817,0.433,0.377,0.316,7088,2665
"13129",236939,2010,1,0,"Washington State University",NA,NA,3241,1634,1607,1327,525,802,0.491,0.409,0.327,8080,2276
"13130",236948,1991,0,1,"UNIVERSITY OF WASHINGTON",9999,0,3484,1788,1696,1287,482,805,0.45,0.369,0.284,2178,2295
"13131",236948,1992,0,1,"UNIVERSITY OF WASHINGTON",9999,0,3509,1769,1740,1315,517,798,0.451,0.375,0.297,2253,2282
"13132",236948,1993,0,1,"UNIVERSITY OF WASHINGTON",9999,0,3206,1576,1630,1217,515,702,0.445,0.38,0.316,2532,2084
"13133",236948,1995,0,1,"UNIVERSITY OF WASHINGTON",9999,0,3500,1783,1717,1405,562,843,0.473,0.401,0.327,3019,2182
"13134",236948,1996,0,1,"UNIVERSITY OF WASHINGTON",9999,0,3789,1964,1825,1613,648,965,0.491,0.426,0.355,3250,2227
"13135",236948,1997,0,1,"UNIVERSITY OF WASHINGTON",9999,0,4346,2270,2076,1734,667,1067,0.47,0.399,0.321,3366,2438
"13136",236948,1998,0,1,"UNIVERSITY OF WASHINGTON",9999,0,4038,2076,1962,1716,718,998,0.481,0.425,0.366,3495,2172
"13137",236948,1999,0,1,"UNIVERSITY OF WASHINGTON-SEATTLE CAMPUS",9999,0,4319,2279,2040,1977,790,1187,0.521,0.458,0.387,3251,2303
"13138",236948,2000,0,1,"UNIVERSITY OF WASHINGTON-SEATTLE CAMPUS",9999,0,4765,2495,2270,2271,926,1345,0.539,0.477,0.408,3638,2632
"13139",236948,2001,0,1,"UNIVERSITY OF WASHINGTON-SEATTLE CAMPUS",9999,0,5288,2737,2551,2555,1099,1456,0.532,0.483,0.431,3593,2693
"13140",236948,2002,0,1,"UNIVERSITY OF WASHINGTON-SEATTLE CAMPUS",9999,0,4776,2561,2215,2450,1039,1411,0.551,0.513,0.469,4167,2615
"13141",236948,2003,0,1,"UNIVERSITY OF WASHINGTON-SEATTLE CAMPUS",9999,0,4948,2654,2294,2665,1106,1559,0.587,0.539,0.482,4458,2652
"13142",236948,2004,0,1,"UNIVERSITY OF WASHINGTON-SEATTLE CAMPUS",9999,0,4867,2639,2228,2625,1075,1550,0.587,0.539,0.482,4770,2614
"13143",236948,2005,0,1,"University of Washington-Seattle Campus",9999,0,4892,2622,2270,2883,1209,1674,0.638,0.589,0.533,5103,2641
"13144",236948,2006,0,1,"University of Washington-Seattle Campus",9999,0,5284,2800,2484,2939,1245,1694,0.605,0.556,0.501,5460,2845
"13145",236948,2007,0,1,"University of Washington-Seattle Campus",9999,0,5163,2771,2392,2968,1213,1755,0.633,0.575,0.507,5842,2697
"13146",236948,2008,0,1,"University of Washington-Seattle Campus",9999,0,5377,2896,2481,3296,1351,1945,0.672,0.613,0.545,6250,2762
"13147",236948,2009,0,1,"University of Washington-Seattle Campus",9999,0,5119,2795,2324,3227,1338,1889,0.676,0.63,0.576,7125,2400
"13148",236948,2010,0,1,"University of Washington-Seattle Campus",9999,0,5460,2917,2543,3525,1504,2021,0.693,0.646,0.591,8122,2506
"13149",237011,1991,0,1,"WESTERN WASHINGTON UNIVERSITY",9999,0,1547,921,626,288,86,202,0.219,0.186,0.137,1698,1332
"13150",237011,1992,0,1,"WESTERN WASHINGTON UNIVERSITY",9999,0,1455,883,572,341,98,243,0.275,0.234,0.171,1785,1208
"13151",237011,1993,0,1,"WESTERN WASHINGTON UNIVERSITY",9999,0,1542,941,601,365,91,274,0.291,0.237,0.151,2120,1231
"13152",237011,1995,0,1,"WESTERN WASHINGTON UNIVERSITY",9999,0,1745,1105,640,457,120,337,0.305,0.262,0.188,2523,1379
"13153",237011,1996,0,1,"WESTERN WASHINGTON UNIVERSITY",9999,0,2026,1177,849,507,176,331,0.281,0.25,0.207,2613,1596
"13154",237011,1997,0,1,"WESTERN WASHINGTON UNIVERSITY",9999,0,2068,1266,802,601,176,425,0.336,0.291,0.219,2526,1606
"13155",237011,1998,0,1,"WESTERN WASHINGTON UNIVERSITY",9999,0,2104,1221,883,623,202,421,0.345,0.296,0.229,2622,1629
"13156",237011,1999,0,1,"WESTERN WASHINGTON UNIVERSITY",9999,0,2074,1264,810,623,172,451,0.357,0.3,0.212,2737,1749
"13157",237011,2000,0,1,"WESTERN WASHINGTON UNIVERSITY",9999,0,2351,1427,924,692,212,480,0.336,0.294,0.229,2832,2013
"13158",237011,2001,0,1,"WESTERN WASHINGTON UNIVERSITY",9999,0,2205,1284,921,641,207,434,0.338,0.291,0.225,3015,1755
"13159",237011,2002,0,1,"WESTERN WASHINGTON UNIVERSITY",9999,0,2213,1290,923,761,225,536,0.416,0.344,0.244,3408,1768
"13160",237011,2003,0,1,"WESTERN WASHINGTON UNIVERSITY",9999,0,2194,1266,928,778,233,545,0.43,0.355,0.251,3639,1789
"13161",237011,2004,0,1,"WESTERN WASHINGTON UNIVERSITY",9999,0,2425,1405,1020,876,287,589,0.419,0.361,0.281,3885,1922
"13162",237011,2005,0,1,"Western Washington University",9999,0,2365,1364,1001,943,302,641,0.47,0.399,0.302,4113,1856
"13163",237011,2006,0,1,"Western Washington University",9999,0,2425,1397,1028,850,293,557,0.399,0.351,0.285,4356,1902
"13164",237011,2007,0,1,"Western Washington University",9999,0,2572,1484,1088,970,324,646,0.435,0.377,0.298,4568,1949
"13165",237011,2008,0,1,"Western Washington University",9999,0,2667,1560,1107,1057,328,729,0.467,0.396,0.296,4788,2018
"13166",237011,2009,0,1,"Western Washington University",9999,0,2670,1521,1149,1062,369,693,0.456,0.398,0.321,5397,2015
"13167",237011,2010,0,1,"Western Washington University",9999,0,2722,1614,1108,1077,345,732,0.454,0.396,0.311,6081,2061
"13168",237057,1991,1,0,"WHITMAN COLLEGE",NA,NA,319,167,152,201,82,119,0.713,0.63,0.539,13110,269
"13169",237057,1992,1,0,"WHITMAN COLLEGE",NA,NA,336,167,169,218,104,114,0.683,0.649,0.615,14360,285
"13170",237057,1993,1,0,"WHITMAN COLLEGE",NA,NA,341,196,145,249,102,147,0.75,0.73,0.703,15650,289
"13171",237057,1995,1,0,"WHITMAN COLLEGE",NA,NA,369,189,180,247,119,128,0.677,0.669,0.661,17630,306
"13172",237057,1996,1,0,"WHITMAN COLLEGE",NA,NA,355,207,148,274,111,163,0.787,0.772,0.75,18650,295
"13173",237057,1997,1,0,"WHITMAN COLLEGE",NA,NA,370,223,147,277,97,180,0.807,0.749,0.66,19580,321
"13174",237057,1998,1,0,"WHITMAN COLLEGE",NA,NA,386,204,182,286,132,154,0.755,0.741,0.725,20120,337
"13175",237057,1999,1,0,"WHITMAN COLLEGE",NA,NA,361,209,152,294,120,174,0.833,0.814,0.789,20720,313
"13176",237057,2000,1,0,"WHITMAN COLLEGE",NA,NA,349,220,129,278,99,179,0.814,0.797,0.767,21550,291
"13177",237057,2001,1,0,"WHITMAN COLLEGE",NA,NA,362,195,167,288,126,162,0.831,0.796,0.754,22600,273
"13178",237057,2002,1,0,"WHITMAN COLLEGE",NA,NA,379,230,149,322,126,196,0.852,0.85,0.846,24070,274
"13179",237057,2003,1,0,"WHITMAN COLLEGE",NA,NA,362,182,180,294,144,150,0.824,0.812,0.8,25400,236
"13180",237057,2004,1,0,"WHITMAN COLLEGE",NA,NA,385,222,163,308,124,184,0.829,0.8,0.761,26870,259
"13181",237057,2005,1,0,"Whitman College",NA,NA,360,180,180,288,140,148,0.822,0.8,0.778,28400,231
"13182",237057,2006,1,0,"Whitman College",NA,NA,367,219,148,294,109,185,0.845,0.801,0.736,30530,241
"13183",237057,2007,1,0,"Whitman College",NA,NA,400,239,161,319,124,195,0.816,0.797,0.77,32670,269
"13184",237057,2008,1,0,"Whitman College",NA,NA,401,230,171,328,130,198,0.861,0.818,0.76,34880,276
"13185",237057,2009,1,0,"Whitman College",NA,NA,395,238,157,314,117,197,0.828,0.795,0.745,36620,275
"13186",237057,2010,1,0,"Whitman College",NA,NA,415,237,178,345,141,204,0.861,0.831,0.792,38450,283
"13187",237066,1991,1,0,"WHITWORTH COLLEGE",NA,NA,240,141,99,94,29,65,0.461,0.392,0.293,10300,203
"13188",237066,1992,1,0,"WHITWORTH COLLEGE",NA,NA,266,151,115,113,44,69,0.457,0.425,0.383,11029,218
"13189",237066,1993,1,0,"WHITWORTH COLLEGE",NA,NA,361,206,155,160,59,101,0.49,0.443,0.381,11965,305
"13190",237066,1995,1,0,"WHITWORTH COLLEGE",NA,NA,395,229,166,198,73,125,0.546,0.501,0.44,13410,331
"13191",237066,1996,1,0,"WHITWORTH COLLEGE",NA,NA,315,193,122,177,56,121,0.627,0.562,0.459,14100,252
"13192",237066,1997,1,0,"WHITWORTH COLLEGE",NA,NA,398,212,186,226,103,123,0.58,0.568,0.554,14750,345
"13193",237066,1998,1,0,"WHITWORTH COLLEGE",NA,NA,373,224,149,197,74,123,0.549,0.528,0.497,15370,313
"13194",237066,1999,1,0,"WHITWORTH COLLEGE",NA,NA,406,266,140,233,74,159,0.598,0.574,0.529,15970,358
"13195",237066,2000,1,0,"WHITWORTH COLLEGE",NA,NA,402,234,168,242,86,156,0.667,0.602,0.512,16700,354
"13196",237066,2001,1,0,"WHITWORTH COLLEGE",NA,NA,427,265,162,251,88,163,0.615,0.588,0.543,17800,396
"13197",237066,2002,1,0,"WHITWORTH COLLEGE",NA,NA,433,232,201,261,107,154,0.664,0.603,0.532,18550,373
"13198",237066,2003,1,0,"WHITWORTH COLLEGE",NA,NA,438,259,179,267,105,162,0.625,0.61,0.587,19810,364
"13199",237066,2004,1,0,"WHITWORTH COLLEGE",NA,NA,469,266,203,308,127,181,0.68,0.657,0.626,20980,406
"13200",237066,2005,1,0,"Whitworth College",NA,NA,451,266,185,304,125,179,0.673,0.674,0.676,22400,383
"13201",237066,2006,1,0,"Whitworth College",NA,NA,469,285,184,303,115,188,0.66,0.646,0.625,23850,408
"13202",237066,2007,1,0,"Whitworth University",NA,NA,532,293,239,347,141,206,0.703,0.652,0.59,25382,456
"13203",237066,2008,1,0,"Whitworth University",NA,NA,545,289,256,354,149,205,0.709,0.65,0.582,27100,458
"13204",237066,2009,1,0,"Whitworth University",NA,NA,555,324,231,354,145,209,0.645,0.638,0.628,28320,457
"13205",237066,2010,1,0,"Whitworth University",NA,NA,683,403,280,430,161,269,0.667,0.63,0.575,29890,542
"13206",237215,1991,1,0,"BLUEFIELD STATE COLLEGE",NA,NA,305,163,142,9,2,7,0.043,0.03,0.014,1454,280
"13207",237215,1992,1,0,"BLUEFIELD STATE COLLEGE",NA,NA,371,192,179,9,4,5,0.026,0.024,0.022,1729,336
"13208",237215,1993,1,0,"BLUEFIELD STATE COLLEGE",NA,NA,358,215,143,10,5,5,0.023,0.028,0.035,1832,312
"13209",237215,1995,1,0,"BLUEFIELD STATE COLLEGE",NA,NA,416,243,173,8,5,3,0.012,0.019,0.029,1916,387
"13210",237215,1996,1,0,"BLUEFIELD STATE COLLEGE",NA,NA,384,207,177,4,1,3,0.014,0.01,0.006,2000,368
"13211",237215,1997,1,0,"BLUEFIELD STATE COLLEGE",NA,NA,423,237,186,6,0,6,0.025,0.014,0,2044,391
"13212",237215,1998,1,0,"BLUEFIELD STATE COLLEGE",NA,NA,426,215,211,7,4,3,0.014,0.016,0.019,2110,382
"13213",237215,1999,1,0,"BLUEFIELD STATE COLLEGE",NA,NA,370,225,145,8,3,5,0.022,0.022,0.021,1140,342
"13214",237215,2000,1,0,"BLUEFIELD STATE COLLEGE",NA,NA,443,254,189,30,14,16,0.063,0.068,0.074,2288,401
"13215",237215,2001,1,0,"BLUEFIELD STATE COLLEGE",NA,NA,380,233,147,3,1,2,0.009,0.008,0.007,2288,343
"13216",237215,2002,1,0,"BLUEFIELD STATE COLLEGE",NA,NA,499,265,234,2,2,0,0,0.004,0.009,2598,454
"13217",237215,2003,1,0,"BLUEFIELD STATE COLLEGE",NA,NA,273,155,118,15,7,8,0.052,0.055,0.059,2806,251
"13218",237215,2004,1,0,"BLUEFIELD STATE COLLEGE",NA,NA,244,138,106,14,8,6,0.044,0.057,0.075,3114,211
"13219",237215,2005,1,0,"Bluefield State College",NA,NA,246,133,113,5,3,2,0.015,0.02,0.027,3410,219
"13220",237215,2006,1,0,"Bluefield State College",NA,NA,253,134,119,28,19,9,0.067,0.111,0.16,3648,211
"13221",237215,2007,1,0,"Bluefield State College",NA,NA,296,167,129,18,11,7,0.042,0.061,0.085,3984,252
"13222",237215,2008,1,0,"Bluefield State College",NA,NA,270,156,114,33,15,18,0.115,0.122,0.132,4272,235
"13223",237215,2009,1,0,"Bluefield State College",NA,NA,304,177,127,28,18,10,0.056,0.092,0.142,4596,253
"13224",237215,2010,1,0,"Bluefield State College",NA,NA,289,181,108,22,13,9,0.05,0.076,0.12,4596,254
"13225",237330,1991,1,0,"CONCORD COLLEGE",NA,NA,401,229,172,87,32,55,0.24,0.217,0.186,1602,376
"13226",237330,1992,1,0,"CONCORD COLLEGE",NA,NA,393,233,160,50,9,41,0.176,0.127,0.056,1736,364
"13227",237330,1993,1,0,"CONCORD COLLEGE",NA,NA,487,284,203,71,25,46,0.162,0.146,0.123,1936,452
"13228",237330,1995,1,0,"CONCORD COLLEGE",NA,NA,542,282,260,148,62,86,0.305,0.273,0.238,2150,494
"13229",237330,1996,1,0,"CONCORD COLLEGE",NA,NA,582,301,281,107,34,73,0.242,0.184,0.121,2218,519
"13230",237330,1997,1,0,"CONCORD COLLEGE",NA,NA,726,390,336,121,49,72,0.185,0.167,0.146,2310,662
"13231",237330,1998,1,0,"CONCORD COLLEGE",NA,NA,545,293,252,74,30,44,0.15,0.136,0.119,2388,500
"13232",237330,1999,1,0,"CONCORD COLLEGE",NA,NA,612,317,295,92,37,55,0.174,0.15,0.125,250,560
"13233",237330,2000,1,0,"CONCORD COLLEGE",NA,NA,694,381,313,87,26,61,0.16,0.125,0.083,250,642
"13234",237330,2001,1,0,"CONCORD COLLEGE",NA,NA,646,343,303,199,74,125,0.364,0.308,0.244,250,594
"13235",237330,2002,1,0,"CONCORD COLLEGE",NA,NA,587,273,314,74,34,40,0.147,0.126,0.108,250,534
"13236",237330,2003,1,0,"CONCORD COLLEGE",NA,NA,508,286,222,98,29,69,0.241,0.193,0.131,250,463
"13237",237330,2004,1,0,"CONCORD UNIVERSITY",NA,NA,488,262,226,75,30,45,0.172,0.154,0.133,250,443
"13238",237330,2005,1,0,"Concord University",NA,NA,639,352,287,104,35,69,0.196,0.163,0.122,250,582
"13239",237330,2006,1,0,"Concord University",NA,NA,593,306,287,102,37,65,0.212,0.172,0.129,250,517
"13240",237330,2007,1,0,"Concord University",NA,NA,618,335,283,115,49,66,0.197,0.186,0.173,250,554
"13241",237330,2008,1,0,"Concord University",NA,NA,706,380,326,128,38,90,0.237,0.181,0.117,250,631
"13242",237330,2009,1,0,"Concord University",NA,NA,607,348,259,121,44,77,0.221,0.199,0.17,4974,540
"13243",237330,2010,1,0,"Concord University",NA,NA,568,288,280,105,37,68,0.236,0.185,0.132,4974,490
"13244",237358,1991,1,0,"DAVIS AND ELKINS COLLEGE",NA,NA,141,80,61,13,4,9,0.112,0.092,0.066,7600,123
"13245",237358,1992,1,0,"DAVIS AND ELKINS COLLEGE",NA,NA,201,108,93,49,22,27,0.25,0.244,0.237,8050,186
"13246",237358,1993,1,0,"DAVIS AND ELKINS COLLEGE",NA,NA,167,100,67,24,10,14,0.14,0.144,0.149,8980,160
"13247",237358,1995,1,0,"DAVIS AND ELKINS COLLEGE",NA,NA,180,101,79,35,13,22,0.218,0.194,0.165,10330,171
"13248",237358,1996,1,0,"DAVIS AND ELKINS COLLEGE",NA,NA,120,66,54,27,16,11,0.167,0.225,0.296,10580,107
"13249",237358,1997,1,0,"DAVIS AND ELKINS COLLEGE",NA,NA,95,54,41,6,3,3,0.056,0.063,0.073,11000,88
"13250",237358,1998,1,0,"DAVIS AND ELKINS COLLEGE",NA,NA,152,87,65,66,29,37,0.425,0.434,0.446,11500,139
"13251",237358,1999,1,0,"DAVIS AND ELKINS COLLEGE",NA,NA,129,72,57,34,15,19,0.264,0.264,0.263,12080,115
"13252",237358,2000,1,0,"DAVIS AND ELKINS COLLEGE",NA,NA,133,76,57,39,18,21,0.276,0.293,0.316,12624,116
"13253",237358,2001,1,0,"DAVIS AND ELKINS COLLEGE",NA,NA,123,71,52,31,13,18,0.254,0.252,0.25,13224,105
"13254",237358,2002,1,0,"DAVIS AND ELKINS COLLEGE",NA,NA,122,68,54,29,18,11,0.162,0.238,0.333,13700,103
"13255",237358,2003,1,0,"DAVIS AND ELKINS COLLEGE",NA,NA,104,60,44,27,8,19,0.317,0.26,0.182,14248,84
"13256",237358,2004,1,0,"DAVIS AND ELKINS COLLEGE",NA,NA,142,77,65,57,26,31,0.403,0.401,0.4,15246,118
"13257",237358,2005,1,0,"Davis & Elkins College",NA,NA,109,67,42,25,5,20,0.299,0.229,0.119,16312,93
"13258",237358,2006,1,0,"Davis & Elkins College",NA,NA,119,65,54,30,14,16,0.246,0.252,0.259,17210,89
"13259",237358,2007,1,0,"Davis & Elkins College",NA,NA,120,70,50,21,9,12,0.171,0.175,0.18,18226,87
"13260",237358,2008,1,0,"Davis & Elkins College",NA,NA,129,68,61,35,19,16,0.235,0.271,0.311,19320,90
"13261",237358,2009,1,0,"Davis & Elkins College",NA,NA,234,139,95,60,23,37,0.266,0.256,0.242,19170,163
"13262",237358,2010,1,0,"Davis & Elkins College",NA,NA,253,149,104,64,29,35,0.235,0.253,0.279,20800,161
"13263",237367,1991,1,0,"FAIRMONT STATE COLLEGE",NA,NA,1034,567,467,83,35,48,0.085,0.08,0.075,1424,898
"13264",237367,1992,1,0,"FAIRMONT STATE COLLEGE",NA,NA,1107,578,529,66,18,48,0.083,0.06,0.034,1686,926
"13265",237367,1993,1,0,"FAIRMONT STATE COLLEGE",NA,NA,1053,553,500,93,29,64,0.116,0.088,0.058,1800,1000
"13266",237367,1995,1,0,"FAIRMONT STATE COLLEGE",NA,NA,1123,618,505,96,36,60,0.097,0.085,0.071,1858,999
"13267",237367,1996,1,0,"FAIRMONT STATE COLLEGE",NA,NA,1049,570,479,119,43,76,0.133,0.113,0.09,1918,994
"13268",237367,1997,1,0,"FAIRMONT STATE COLLEGE",NA,NA,540,300,240,115,45,70,0.233,0.213,0.188,2040,514
"13269",237367,1998,1,0,"FAIRMONT STATE COLLEGE",NA,NA,555,311,244,93,27,66,0.212,0.168,0.111,2106,522
"13270",237367,1999,1,0,"FAIRMONT STATE COLLEGE",NA,NA,534,286,248,77,28,49,0.171,0.144,0.113,2284,472
"13271",237367,2000,1,0,"FAIRMONT STATE COLLEGE",NA,NA,589,333,256,87,25,62,0.186,0.148,0.098,2316,534
"13272",237367,2001,1,0,"FAIRMONT STATE COLLEGE",NA,NA,568,320,248,62,18,44,0.138,0.109,0.073,2408,514
"13273",237367,2002,1,0,"FAIRMONT STATE COLLEGE",NA,NA,682,377,305,80,30,50,0.133,0.117,0.098,1200,625
"13274",237367,2003,1,0,"FAIRMONT STATE COLLEGE",NA,NA,631,317,314,85,31,54,0.17,0.135,0.099,3130,563
"13275",237367,2004,1,0,"FAIRMONT STATE UNIVERSITY",NA,NA,602,321,281,90,27,63,0.196,0.15,0.096,3640,557
"13276",237367,2005,1,0,"Fairmont State University",NA,NA,653,367,286,97,35,62,0.169,0.149,0.122,4218,606
"13277",237367,2006,1,0,"Fairmont State University",NA,NA,642,345,297,84,35,49,0.142,0.131,0.118,4522,602
"13278",237367,2007,1,0,"Fairmont State University",NA,NA,632,331,301,87,37,50,0.151,0.138,0.123,4814,581
"13279",237367,2008,1,0,"Fairmont State University",NA,NA,755,370,385,116,52,64,0.173,0.154,0.135,5024,657
"13280",237367,2009,1,0,"Fairmont State University",NA,NA,795,412,383,118,58,60,0.146,0.148,0.151,5172,712
"13281",237367,2010,1,0,"Fairmont State University",NA,NA,766,393,373,103,49,54,0.137,0.134,0.131,5172,675
"13282",237792,1991,1,0,"SHEPHERD COLLEGE",NA,NA,395,208,187,46,16,30,0.144,0.116,0.086,1894,373
"13283",237792,1992,1,0,"SHEPHERD COLLEGE",NA,NA,490,270,220,3,0,3,0.011,0.006,0,1954,464
"13284",237792,1993,1,0,"SHEPHERD COLLEGE",NA,NA,557,310,247,59,17,42,0.136,0.106,0.069,2040,521
"13285",237792,1995,1,0,"SHEPHERD COLLEGE",NA,NA,598,333,265,74,20,54,0.162,0.124,0.075,2064,563
"13286",237792,1996,1,0,"SHEPHERD COLLEGE",NA,NA,617,363,254,97,24,73,0.201,0.157,0.094,2160,571
"13287",237792,1997,1,0,"SHEPHERD COLLEGE",NA,NA,643,341,302,111,43,68,0.199,0.173,0.142,2228,581
"13288",237792,1998,1,0,"SHEPHERD COLLEGE",NA,NA,610,356,254,93,23,70,0.197,0.152,0.091,2298,559
"13289",237792,1999,1,0,"SHEPHERD COLLEGE",NA,NA,674,367,307,91,25,66,0.18,0.135,0.081,250,626
"13290",237792,2000,1,0,"SHEPHERD COLLEGE",NA,NA,669,378,291,101,32,69,0.182,0.151,0.11,250,612
"13291",237792,2001,1,0,"SHEPHERD COLLEGE",NA,NA,647,333,314,71,27,44,0.132,0.11,0.086,250,584
"13292",237792,2002,1,0,"SHEPHERD COLLEGE",NA,NA,705,378,327,92,24,68,0.18,0.13,0.073,250,632
"13293",237792,2003,1,0,"SHEPHERD COLLEGE",NA,NA,768,440,328,134,48,86,0.196,0.174,0.146,250,695
"13294",237792,2004,1,0,"SHEPHERD UNIVERSITY",NA,NA,774,427,347,119,44,75,0.176,0.154,0.127,250,709
"13295",237792,2005,1,0,"Shepherd University",NA,NA,657,352,305,134,52,82,0.233,0.204,0.17,350,593
"13296",237792,2006,1,0,"Shepherd University",NA,NA,688,395,293,135,40,95,0.241,0.196,0.137,350,618
"13297",237792,2007,1,0,"Shepherd University",NA,NA,691,366,325,124,48,76,0.208,0.179,0.148,350,599
"13298",237792,2008,1,0,"Shepherd University",NA,NA,698,395,303,137,42,95,0.241,0.196,0.139,350,562
"13299",237792,2009,1,0,"Shepherd University",NA,NA,786,437,349,169,63,106,0.243,0.215,0.181,350,486
"13300",237792,2010,1,0,"Shepherd University",NA,NA,759,436,323,191,59,132,0.303,0.252,0.183,350,649
"13301",237899,1991,1,0,"WEST VIRGINIA STATE COLLEGE",NA,NA,475,227,248,15,7,8,0.035,0.032,0.028,1578,375
"13302",237899,1992,1,0,"WEST VIRGINIA STATE COLLEGE",NA,NA,400,188,212,17,7,10,0.053,0.043,0.033,1712,299
"13303",237899,1993,1,0,"WEST VIRGINIA STATE COLLEGE",NA,NA,634,308,326,21,8,13,0.042,0.033,0.025,1894,511
"13304",237899,1995,1,0,"WEST VIRGINIA STATE COLLEGE",NA,NA,572,292,280,28,13,15,0.051,0.049,0.046,2050,474
"13305",237899,1996,1,0,"WEST VIRGINIA STATE COLLEGE",NA,NA,529,254,275,28,10,18,0.071,0.053,0.036,2116,418
"13306",237899,1997,1,0,"WEST VIRGINIA STATE COLLEGE",NA,NA,581,288,293,33,13,20,0.069,0.057,0.044,2184,442
"13307",237899,1998,1,0,"WEST VIRGINIA STATE COLLEGE",NA,NA,551,282,269,31,13,18,0.064,0.056,0.048,2254,436
"13308",237899,1999,1,0,"WEST VIRGINIA STATE COLLEGE",NA,NA,555,260,295,31,13,18,0.069,0.056,0.044,2386,437
"13309",237899,2000,1,0,"WEST VIRGINIA STATE COLLEGE",NA,NA,542,277,265,19,6,13,0.047,0.035,0.023,2464,397
"13310",237899,2001,1,0,"WEST VIRGINIA STATE COLLEGE",NA,NA,379,193,186,16,5,11,0.057,0.042,0.027,2562,276
"13311",237899,2002,1,0,"WEST VIRGINIA STATE COLLEGE",NA,NA,351,178,173,28,8,20,0.112,0.08,0.046,2610,271
"13312",237899,2003,1,0,"WEST VIRGINIA STATE COLLEGE",NA,NA,333,187,146,20,6,14,0.075,0.06,0.041,2609,252
"13313",237899,2004,1,0,"WEST VIRGINIA STATE UNIVERSITY",NA,NA,331,175,156,18,8,10,0.057,0.054,0.051,3222,249
"13314",237899,2005,1,0,"West Virginia State University",NA,NA,306,152,154,21,11,10,0.066,0.069,0.071,3528,227
"13315",237899,2006,1,0,"West Virginia State University",NA,NA,341,170,171,24,8,16,0.094,0.07,0.047,3776,231
"13316",237899,2007,1,0,"West Virginia State University",NA,NA,364,170,194,14,5,9,0.053,0.038,0.026,4136,214
"13317",237899,2008,1,0,"West Virginia State University",NA,NA,302,147,155,16,5,11,0.075,0.053,0.032,4346,176
"13318",237899,2009,1,0,"West Virginia State University",NA,NA,246,120,126,28,9,19,0.158,0.114,0.071,4524,163
"13319",237899,2010,1,0,"West Virginia State University",NA,NA,270,128,142,26,9,17,0.133,0.096,0.063,4544,198
"13320",237932,1991,1,0,"WEST LIBERTY STATE COLLEGE",NA,NA,437,227,210,75,25,50,0.22,0.172,0.119,1500,415
"13321",237932,1992,1,0,"WEST LIBERTY STATE COLLEGE",NA,NA,488,263,225,104,29,75,0.285,0.213,0.129,1590,462
"13322",237932,1993,1,0,"WEST LIBERTY STATE COLLEGE",NA,NA,474,238,236,85,32,53,0.223,0.179,0.136,1800,459
"13323",237932,1995,1,0,"WEST LIBERTY STATE COLLEGE",NA,NA,509,273,236,108,27,81,0.297,0.212,0.114,1960,486
"13324",237932,1996,1,0,"WEST LIBERTY STATE COLLEGE",NA,NA,464,250,214,77,20,57,0.228,0.166,0.093,2020,438
"13325",237932,1997,1,0,"WEST LIBERTY STATE COLLEGE",NA,NA,491,257,234,77,21,56,0.218,0.157,0.09,2120,469
"13326",237932,1998,1,0,"WEST LIBERTY STATE COLLEGE",NA,NA,498,268,230,96,35,61,0.228,0.193,0.152,2190,478
"13327",237932,1999,1,0,"WEST LIBERTY STATE COLLEGE",NA,NA,494,245,249,96,31,65,0.265,0.194,0.124,2320,474
"13328",237932,2000,1,0,"WEST LIBERTY STATE COLLEGE",NA,NA,513,275,238,91,29,62,0.226,0.177,0.122,2420,486
"13329",237932,2001,1,0,"WEST LIBERTY STATE COLLEGE",NA,NA,521,298,223,99,40,59,0.198,0.19,0.179,2516,502
"13330",237932,2002,1,0,"WEST LIBERTY STATE COLLEGE",NA,NA,445,253,192,107,23,84,0.332,0.24,0.12,2748,424
"13331",237932,2003,1,0,"WEST LIBERTY STATE COLLEGE",NA,NA,453,248,205,69,16,53,0.214,0.152,0.078,3138,423
"13332",237932,2004,1,0,"WEST LIBERTY STATE COLLEGE",NA,NA,459,238,221,92,35,57,0.24,0.2,0.158,3380,432
"13333",237932,2005,1,0,"West Liberty State College",NA,NA,416,234,182,94,25,69,0.295,0.226,0.137,3686,390
"13334",237932,2006,1,0,"West Liberty State College",NA,NA,476,269,207,84,28,56,0.208,0.176,0.135,3946,432
"13335",237932,2007,1,0,"West Liberty State College",NA,NA,499,264,235,110,27,83,0.314,0.22,0.115,4172,460
"13336",237932,2008,1,0,"West Liberty State College",NA,NA,550,299,251,96,30,66,0.221,0.175,0.12,4464,509
"13337",237932,2009,1,0,"West Liberty University",NA,NA,569,340,229,130,33,97,0.285,0.228,0.144,4880,531
"13338",237932,2010,1,0,"West Liberty University",NA,NA,526,285,241,103,31,72,0.253,0.196,0.129,4880,473
"13339",237969,1991,1,0,"WEST VIRGINIA WESLEYAN COLLEGE",NA,NA,363,195,168,155,44,111,0.569,0.427,0.262,11830,321
"13340",237969,1992,1,0,"WEST VIRGINIA WESLEYAN COLLEGE",NA,NA,467,223,244,173,72,101,0.453,0.37,0.295,12605,416
"13341",237969,1993,1,0,"WEST VIRGINIA WESLEYAN COLLEGE",NA,NA,475,235,240,172,64,108,0.46,0.362,0.267,13400,424
"13342",237969,1995,1,0,"WEST VIRGINIA WESLEYAN COLLEGE",NA,NA,453,240,213,200,77,123,0.512,0.442,0.362,14750,406
"13343",237969,1996,1,0,"WEST VIRGINIA WESLEYAN COLLEGE",NA,NA,377,204,173,161,57,104,0.51,0.427,0.329,14975,330
"13344",237969,1997,1,0,"WEST VIRGINIA WESLEYAN COLLEGE",NA,NA,480,260,220,201,72,129,0.496,0.419,0.327,15275,395
"13345",237969,1998,1,0,"WEST VIRGINIA WESLEYAN COLLEGE",NA,NA,472,247,225,204,74,130,0.526,0.432,0.329,15750,423
"13346",237969,1999,1,0,"WEST VIRGINIA WESLEYAN COLLEGE",NA,NA,472,261,211,211,89,122,0.467,0.447,0.422,16300,424
"13347",237969,2000,1,0,"WEST VIRGINIA WESLEYAN COLLEGE",NA,NA,415,232,183,169,56,113,0.487,0.407,0.306,16800,376
"13348",237969,2001,1,0,"WEST VIRGINIA WESLEYAN COLLEGE",NA,NA,400,202,198,175,65,110,0.545,0.438,0.328,17300,358
"13349",237969,2002,1,0,"WEST VIRGINIA WESLEYAN COLLEGE",NA,NA,500,283,217,224,83,141,0.498,0.448,0.382,17900,450
"13350",237969,2003,1,0,"WEST VIRGINIA WESLEYAN COLLEGE",NA,NA,457,257,200,197,64,133,0.517,0.431,0.32,18450,355
"13351",237969,2004,1,0,"WEST VIRGINIA WESLEYAN COLLEGE",NA,NA,348,181,167,148,59,89,0.492,0.425,0.353,19450,262
"13352",237969,2005,1,0,"West Virginia Wesleyan College",NA,NA,307,161,146,129,38,91,0.565,0.42,0.26,20250,251
"13353",237969,2006,1,0,"West Virginia Wesleyan College",NA,NA,291,167,124,117,39,78,0.467,0.402,0.315,20250,161
"13354",237969,2007,1,0,"West Virginia Wesleyan College",NA,NA,401,203,198,174,71,103,0.507,0.434,0.359,20980,288
"13355",237969,2008,1,0,"West Virginia Wesleyan College",NA,NA,382,208,174,168,63,105,0.505,0.44,0.362,21030,279
"13356",237969,2009,1,0,"West Virginia Wesleyan College",NA,NA,399,197,202,151,61,90,0.457,0.378,0.302,22030,312
"13357",237969,2010,1,0,"West Virginia Wesleyan College",NA,NA,371,196,175,141,43,98,0.5,0.38,0.246,23130,302
"13358",238032,1991,1,0,"WEST VIRGINIA UNIVERSITY",NA,NA,3307,1550,1757,796,325,471,0.304,0.241,0.185,1850,3090
"13359",238032,1992,1,0,"WEST VIRGINIA UNIVERSITY",NA,NA,2978,1444,1534,766,296,470,0.325,0.257,0.193,1928,2736
"13360",238032,1993,1,0,"WEST VIRGINIA UNIVERSITY",NA,NA,2806,1370,1436,658,252,406,0.296,0.234,0.175,2026,2622
"13361",238032,1995,1,0,"WEST VIRGINIA UNIVERSITY",NA,NA,2938,1457,1481,783,324,459,0.315,0.267,0.219,2192,2731
"13362",238032,1996,1,0,"WEST VIRGINIA UNIVERSITY",NA,NA,3065,1499,1566,817,335,482,0.322,0.267,0.214,2262,2850
"13363",238032,1997,1,0,"WEST VIRGINIA UNIVERSITY",NA,NA,3079,1431,1648,794,344,450,0.314,0.258,0.209,2336,2829
"13364",238032,1998,1,0,"WEST VIRGINIA UNIVERSITY",NA,NA,3335,1571,1764,818,348,470,0.299,0.245,0.197,2662,3070
"13365",238032,1999,1,0,"WEST VIRGINIA UNIVERSITY",NA,NA,3523,1641,1882,885,363,522,0.318,0.251,0.193,1332,3199
"13366",238032,2000,1,0,"WEST VIRGINIA UNIVERSITY",NA,NA,3480,1679,1801,889,346,543,0.323,0.255,0.192,1332,3193
"13367",238032,2001,1,0,"WEST VIRGINIA UNIVERSITY",NA,NA,3593,1743,1850,928,381,547,0.314,0.258,0.206,1332,3263
"13368",238032,2002,1,0,"WEST VIRGINIA UNIVERSITY",NA,NA,3917,1841,2076,1161,473,688,0.374,0.296,0.228,3240,3573
"13369",238032,2003,1,0,"WEST VIRGINIA UNIVERSITY",NA,NA,4366,2104,2262,1387,583,804,0.382,0.318,0.258,3548,4070
"13370",238032,2004,1,0,"WEST VIRGINIA UNIVERSITY",NA,NA,4308,2032,2276,1416,571,845,0.416,0.329,0.251,3938,3961
"13371",238032,2005,1,0,"West Virginia University",NA,NA,4524,2126,2398,1457,639,818,0.385,0.322,0.266,4164,4129
"13372",238032,2006,1,0,"West Virginia University",NA,NA,4777,2151,2626,1596,746,850,0.395,0.334,0.284,4476,4354
"13373",238032,2007,1,0,"West Virginia University",NA,NA,4664,2156,2508,1561,696,865,0.401,0.335,0.278,4722,4187
"13374",238032,2008,1,0,"West Virginia University",NA,NA,5083,2300,2783,1656,766,890,0.387,0.326,0.275,5100,4548
"13375",238032,2009,1,0,"West Virginia University",NA,NA,4555,2098,2457,1501,661,840,0.4,0.33,0.269,5304,4058
"13376",238032,2010,1,0,"West Virginia University",NA,NA,5006,2290,2716,1619,755,864,0.377,0.323,0.278,5406,4312
"13377",238333,1991,1,0,"BELOIT COLLEGE",NA,NA,261,147,114,135,50,85,0.578,0.517,0.439,13050,231
"13378",238333,1992,1,0,"BELOIT COLLEGE",NA,NA,306,159,147,171,68,103,0.648,0.559,0.463,14250,259
"13379",238333,1993,1,0,"BELOIT COLLEGE",NA,NA,284,161,123,158,61,97,0.603,0.556,0.496,15430,234
"13380",238333,1995,1,0,"BELOIT COLLEGE",NA,NA,291,163,128,187,74,113,0.693,0.643,0.578,17544,242
"13381",238333,1996,1,0,"BELOIT COLLEGE",NA,NA,284,147,137,175,76,99,0.673,0.616,0.555,18230,224
"13382",238333,1997,1,0,"BELOIT COLLEGE",NA,NA,339,194,145,204,73,131,0.675,0.602,0.503,19050,275
"13383",238333,1998,1,0,"BELOIT COLLEGE",NA,NA,302,180,122,166,58,108,0.6,0.55,0.475,19770,245
"13384",238333,1999,1,0,"BELOIT COLLEGE",NA,NA,303,173,130,196,75,121,0.699,0.647,0.577,20220,244
"13385",238333,2000,1,0,"BELOIT COLLEGE",NA,NA,306,177,129,168,79,89,0.503,0.549,0.612,21330,255
"13386",238333,2001,1,0,"BELOIT COLLEGE",NA,NA,311,189,122,234,86,148,0.783,0.752,0.705,22184,262
"13387",238333,2002,1,0,"BELOIT COLLEGE",NA,NA,303,191,112,210,75,135,0.707,0.693,0.67,23016,266
"13388",238333,2003,1,0,"BELOIT COLLEGE",NA,NA,346,217,129,251,88,163,0.751,0.725,0.682,24166,307
"13389",238333,2004,1,0,"BELOIT COLLEGE",NA,NA,323,176,147,218,97,121,0.688,0.675,0.66,25516,285
"13390",238333,2005,1,0,"Beloit College",NA,NA,326,198,128,216,71,145,0.732,0.663,0.555,26664,277
"13391",238333,2006,1,0,"Beloit College",NA,NA,347,207,140,243,94,149,0.72,0.7,0.671,28130,284
"13392",238333,2007,1,0,"Beloit College",NA,NA,325,183,142,229,99,130,0.71,0.705,0.697,29678,248
"13393",238333,2008,1,0,"Beloit College",NA,NA,337,182,155,240,104,136,0.747,0.712,0.671,31310,222
"13394",238333,2009,1,0,"Beloit College",NA,NA,332,199,133,233,90,143,0.719,0.702,0.677,33188,242
"13395",238333,2010,1,0,"Beloit College",NA,NA,333,191,142,212,89,123,0.644,0.637,0.627,34808,237
"13396",238430,1991,1,0,"CARDINAL STRITCH COLLEGE",NA,NA,125,89,36,24,7,17,0.191,0.192,0.194,6960,98
"13397",238430,1992,1,0,"CARDINAL STRITCH COLLEGE",NA,NA,199,133,66,20,10,10,0.075,0.101,0.152,7360,158
"13398",238430,1993,1,0,"CARDINAL STRITCH COLLEGE",NA,NA,481,327,154,39,12,27,0.083,0.081,0.078,7720,375
"13399",238430,1995,1,0,"CARDINAL STRITCH COLLEGE",NA,NA,139,93,46,20,3,17,0.183,0.144,0.065,8320,114
"13400",238430,1996,1,0,"CARDINAL STRITCH COLLEGE",NA,NA,253,174,79,40,16,24,0.138,0.158,0.203,8960,197
"13401",238430,1997,1,0,"CARDINAL STRITCH UNIVERSITY",NA,NA,226,149,77,55,19,36,0.242,0.243,0.247,10080,164
"13402",238430,1998,1,0,"CARDINAL STRITCH UNIVERSITY",NA,NA,224,140,84,71,28,43,0.307,0.317,0.333,10496,159
"13403",238430,1999,1,0,"CARDINAL STRITCH UNIVERSITY",NA,NA,203,132,71,28,10,18,0.136,0.138,0.141,11000,152
"13404",238430,2000,1,0,"CARDINAL STRITCH UNIVERSITY",NA,NA,207,122,85,129,53,76,0.623,0.623,0.624,11680,155
"13405",238430,2001,1,0,"CARDINAL STRITCH UNIVERSITY",NA,NA,296,215,81,78,29,49,0.228,0.264,0.358,12480,197
"13406",238430,2002,1,0,"CARDINAL STRITCH UNIVERSITY",NA,NA,197,155,42,55,12,43,0.277,0.279,0.286,13280,137
"13407",238430,2003,1,0,"CARDINAL STRITCH UNIVERSITY",NA,NA,205,136,69,28,11,17,0.125,0.137,0.159,14240,135
"13408",238430,2004,1,0,"CARDINAL STRITCH UNIVERSITY",NA,NA,157,120,37,63,8,55,0.458,0.401,0.216,15360,103
"13409",238430,2005,1,0,"Cardinal Stritch University",NA,NA,182,139,43,19,4,15,0.108,0.104,0.093,16130,120
"13410",238430,2006,1,0,"Cardinal Stritch University",NA,NA,245,168,77,19,6,13,0.077,0.078,0.078,17600,125
"13411",238430,2007,1,0,"Cardinal Stritch University",NA,NA,173,115,58,25,6,19,0.165,0.145,0.103,18624,87
"13412",238430,2008,1,0,"Cardinal Stritch University",NA,NA,258,177,81,39,14,25,0.141,0.151,0.173,20000,162
"13413",238430,2009,1,0,"Cardinal Stritch University",NA,NA,209,119,90,19,4,15,0.126,0.091,0.044,21280,101
"13414",238430,2010,1,0,"Cardinal Stritch University",NA,NA,213,128,85,37,14,23,0.18,0.174,0.165,22240,124
"13415",238458,1991,1,0,"CARROLL COLLEGE",NA,NA,275,168,107,132,35,97,0.577,0.48,0.327,11068,250
"13416",238458,1992,1,0,"CARROLL COLLEGE",NA,NA,298,193,105,93,27,66,0.342,0.312,0.257,11432,258
"13417",238458,1993,1,0,"CARROLL COLLEGE",NA,NA,345,211,134,130,45,85,0.403,0.377,0.336,11790,309
"13418",238458,1995,1,0,"CARROLL COLLEGE",NA,NA,429,296,133,202,41,161,0.544,0.471,0.308,12880,378
"13419",238458,1996,1,0,"CARROLL COLLEGE",NA,NA,450,295,155,214,67,147,0.498,0.476,0.432,13190,401
"13420",238458,1997,1,0,"CARROLL COLLEGE",NA,NA,459,287,172,232,65,167,0.582,0.505,0.378,13670,404
"13421",238458,1998,1,0,"CARROLL COLLEGE",NA,NA,414,296,118,156,31,125,0.422,0.377,0.263,14200,390
"13422",238458,1999,1,0,"CARROLL COLLEGE",NA,NA,482,327,155,219,63,156,0.477,0.454,0.406,14740,446
"13423",238458,2000,1,0,"CARROLL COLLEGE",NA,NA,500,334,166,220,58,162,0.485,0.44,0.349,15250,465
"13424",238458,2001,1,0,"CARROLL COLLEGE",NA,NA,471,319,152,197,48,149,0.467,0.418,0.316,15860,424
"13425",238458,2002,1,0,"CARROLL COLLEGE",NA,NA,529,324,205,240,70,170,0.525,0.454,0.341,16400,492
"13426",238458,2003,1,0,"CARROLL COLLEGE",NA,NA,501,329,172,220,62,158,0.48,0.439,0.36,17020,468
"13427",238458,2004,1,0,"CARROLL COLLEGE",NA,NA,616,405,211,234,61,173,0.427,0.38,0.289,17800,543
"13428",238458,2005,1,0,"Carroll College",NA,NA,598,383,215,231,63,168,0.439,0.386,0.293,18650,530
"13429",238458,2006,1,0,"Carroll College",NA,NA,675,485,190,284,58,226,0.466,0.421,0.305,19500,585
"13430",238458,2007,1,0,"Carroll College",NA,NA,652,440,212,277,88,189,0.43,0.425,0.415,20400,561
"13431",238458,2008,1,0,"Carroll University",NA,NA,655,447,208,263,77,186,0.416,0.402,0.37,21410,577
"13432",238458,2009,1,0,"Carroll University",NA,NA,738,482,256,311,102,209,0.434,0.421,0.398,22470,644
"13433",238458,2010,1,0,"Carroll University",NA,NA,751,502,249,386,115,271,0.54,0.514,0.462,23582,654
"13434",238476,1991,1,0,"CARTHAGE COLLEGE",NA,NA,401,227,174,183,65,118,0.52,0.456,0.374,10640,358
"13435",238476,1992,1,0,"CARTHAGE COLLEGE",NA,NA,406,233,173,196,80,116,0.498,0.483,0.462,11525,367
"13436",238476,1993,1,0,"CARTHAGE COLLEGE",NA,NA,441,227,214,216,99,117,0.515,0.49,0.463,12400,399
"13437",238476,1995,1,0,"CARTHAGE COLLEGE",NA,NA,395,175,220,190,89,101,0.577,0.481,0.405,13850,369
"13438",238476,1996,1,0,"CARTHAGE COLLEGE",NA,NA,401,210,191,215,87,128,0.61,0.536,0.455,14600,383
"13439",238476,1997,1,0,"CARTHAGE COLLEGE",NA,NA,395,201,194,174,75,99,0.492,0.441,0.387,15365,364
"13440",238476,1998,1,0,"CARTHAGE COLLEGE",NA,NA,432,216,216,190,86,104,0.482,0.44,0.398,16060,405
"13441",238476,1999,1,0,"CARTHAGE COLLEGE",NA,NA,427,216,211,190,78,112,0.519,0.445,0.37,16690,389
"13442",238476,2000,1,0,"CARTHAGE COLLEGE",NA,NA,532,295,237,232,91,141,0.478,0.436,0.384,17350,462
"13443",238476,2001,1,0,"CARTHAGE COLLEGE",NA,NA,578,280,298,237,112,125,0.446,0.41,0.376,18205,478
"13444",238476,2002,1,0,"CARTHAGE COLLEGE",NA,NA,618,351,267,236,84,152,0.433,0.382,0.315,19150,511
"13445",238476,2003,1,0,"CARTHAGE COLLEGE",NA,NA,575,307,268,249,103,146,0.476,0.433,0.384,20150,469
"13446",238476,2004,1,0,"CARTHAGE COLLEGE",NA,NA,579,344,235,277,101,176,0.512,0.478,0.43,21250,469
"13447",238476,2005,1,0,"Carthage College",NA,NA,593,315,278,281,120,161,0.511,0.474,0.432,22500,507
"13448",238476,2006,1,0,"Carthage College",NA,NA,653,368,285,337,136,201,0.546,0.516,0.477,23650,538
"13449",238476,2007,1,0,"Carthage College",NA,NA,683,350,333,371,145,226,0.646,0.543,0.435,25000,575
"13450",238476,2008,1,0,"Carthage College",NA,NA,753,359,394,405,192,213,0.593,0.538,0.487,26500,620
"13451",238476,2009,1,0,"Carthage College",NA,NA,721,351,370,359,158,201,0.573,0.498,0.427,28250,597
"13452",238476,2010,1,0,"Carthage College",NA,NA,730,384,346,398,164,234,0.609,0.545,0.474,29750,628
"13453",238616,1991,1,0,"CONCORDIA UNIVERSITY-WISCONSIN",NA,NA,205,104,101,64,27,37,0.356,0.312,0.267,7400,171
"13454",238616,1992,1,0,"CONCORDIA UNIVERSITY-WISCONSIN",NA,NA,183,103,80,69,31,38,0.369,0.377,0.388,8100,158
"13455",238616,1993,1,0,"CONCORDIA UNIVERSITY-WISCONSIN",NA,NA,289,139,150,81,37,44,0.316,0.28,0.247,8700,246
"13456",238616,1995,1,0,"CONCORDIA UNIVERSITY-WISCONSIN",NA,NA,234,132,102,59,21,38,0.288,0.252,0.206,10000,208
"13457",238616,1996,1,0,"CONCORDIA UNIVERSITY-WISCONSIN",NA,NA,254,138,116,117,44,73,0.529,0.461,0.379,10700,213
"13458",238616,1997,1,0,"CONCORDIA UNIVERSITY-WISCONSIN",NA,NA,253,147,106,128,45,83,0.565,0.506,0.425,11300,237
"13459",238616,1998,1,0,"CONCORDIA UNIVERSITY-WISCONSIN",NA,NA,337,187,150,126,46,80,0.428,0.374,0.307,11900,249
"13460",238616,1999,1,0,"CONCORDIA UNIVERSITY-WISCONSIN",NA,NA,321,197,124,104,38,66,0.335,0.324,0.306,12400,260
"13461",238616,2000,1,0,"CONCORDIA UNIVERSITY-WISCONSIN",NA,NA,285,169,116,106,43,63,0.373,0.372,0.371,12900,239
"13462",238616,2001,1,0,"CONCORDIA UNIVERSITY-WISCONSIN",NA,NA,351,169,182,158,82,76,0.45,0.45,0.451,13550,218
"13463",238616,2002,1,0,"CONCORDIA UNIVERSITY-WISCONSIN",NA,NA,287,139,148,96,42,54,0.388,0.334,0.284,14500,217
"13464",238616,2003,1,0,"CONCORDIA UNIVERSITY-WISCONSIN",NA,NA,352,192,160,111,35,76,0.396,0.315,0.219,15590,272
"13465",238616,2004,1,0,"CONCORDIA UNIVERSITY-WISCONSIN",NA,NA,363,198,165,145,57,88,0.444,0.399,0.345,16370,309
"13466",238616,2005,1,0,"Concordia University-Wisconsin",NA,NA,386,207,179,134,52,82,0.396,0.347,0.291,17190,315
"13467",238616,2006,1,0,"Concordia University-Wisconsin",NA,NA,391,214,177,135,53,82,0.383,0.345,0.299,18050,320
"13468",238616,2007,1,0,"Concordia University-Wisconsin",NA,NA,422,232,190,143,46,97,0.418,0.339,0.242,18950,363
"13469",238616,2008,1,0,"Concordia University-Wisconsin",NA,NA,402,222,180,139,59,80,0.36,0.346,0.328,19900,330
"13470",238616,2009,1,0,"Concordia University-Wisconsin",NA,NA,468,266,202,171,63,108,0.406,0.365,0.312,20900,401
"13471",238616,2010,1,0,"Concordia University-Wisconsin",NA,NA,537,317,220,198,71,127,0.401,0.369,0.323,21940,436
"13472",238661,1991,1,0,"EDGEWOOD COLLEGE",NA,NA,126,96,30,17,1,16,0.167,0.135,0.033,6950,105
"13473",238661,1992,1,0,"EDGEWOOD COLLEGE",NA,NA,131,90,41,25,7,18,0.2,0.191,0.171,7500,98
"13474",238661,1993,1,0,"EDGEWOOD COLLEGE",NA,NA,161,121,40,42,7,35,0.289,0.261,0.175,8000,127
"13475",238661,1995,1,0,"EDGEWOOD COLLEGE",NA,NA,231,155,76,44,10,34,0.219,0.19,0.132,9000,178
"13476",238661,1996,1,0,"EDGEWOOD COLLEGE",NA,NA,210,152,58,40,4,36,0.237,0.19,0.069,9500,141
"13477",238661,1997,1,0,"EDGEWOOD COLLEGE",NA,NA,222,164,58,53,11,42,0.256,0.239,0.19,10100,151
"13478",238661,1998,1,0,"EDGEWOOD COLLEGE",NA,NA,213,157,56,55,13,42,0.268,0.258,0.232,10884,134
"13479",238661,1999,1,0,"EDGEWOOD COLLEGE",NA,NA,196,132,64,49,9,40,0.303,0.25,0.141,11450,108
"13480",238661,2000,1,0,"EDGEWOOD COLLEGE",NA,NA,274,203,71,81,13,68,0.335,0.296,0.183,12250,128
"13481",238661,2001,1,0,"EDGEWOOD COLLEGE",NA,NA,291,203,88,70,21,49,0.241,0.241,0.239,13300,145
"13482",238661,2002,1,0,"EDGEWOOD COLLEGE",NA,NA,271,205,66,70,10,60,0.293,0.258,0.152,14200,237
"13483",238661,2003,1,0,"EDGEWOOD COLLEGE",NA,NA,307,229,78,85,14,71,0.31,0.277,0.179,15100,260
"13484",238661,2004,1,0,"EDGEWOOD COLLEGE",NA,NA,298,214,84,95,20,75,0.35,0.319,0.238,16050,270
"13485",238661,2005,1,0,"Edgewood College",NA,NA,281,210,71,77,21,56,0.267,0.274,0.296,17000,256
"13486",238661,2006,1,0,"Edgewood College",NA,NA,293,220,73,101,21,80,0.364,0.345,0.288,18000,258
"13487",238661,2007,1,0,"Edgewood College",NA,NA,302,202,100,98,28,70,0.346,0.325,0.28,19080,261
"13488",238661,2008,1,0,"Edgewood College",NA,NA,298,219,79,108,29,79,0.361,0.362,0.367,20040,259
"13489",238661,2009,1,0,"Edgewood College",NA,NA,285,213,72,110,27,83,0.39,0.386,0.375,21042,228
"13490",238661,2010,1,0,"Edgewood College",NA,NA,324,243,81,130,36,94,0.387,0.401,0.444,21988,284
"13491",239080,1991,1,0,"MARIAN COLLEGE OF FOND DU LAC",NA,NA,146,105,41,52,10,42,0.4,0.356,0.244,7500,141
"13492",239080,1992,1,0,"MARIAN COLLEGE OF FOND DU LAC",NA,NA,190,125,65,52,14,38,0.304,0.274,0.215,8120,177
"13493",239080,1993,1,0,"MARIAN COLLEGE OF FOND DU LAC",NA,NA,170,115,55,47,12,35,0.304,0.276,0.218,8650,154
"13494",239080,1995,1,0,"MARIAN COLLEGE OF FOND DU LAC",NA,NA,184,117,67,44,15,29,0.248,0.239,0.224,10120,170
"13495",239080,1996,1,0,"MARIAN COLLEGE OF FOND DU LAC",NA,NA,199,126,73,53,21,32,0.254,0.266,0.288,10730,189
"13496",239080,1997,1,0,"MARIAN COLLEGE OF FOND DU LAC",NA,NA,208,119,89,62,16,46,0.387,0.298,0.18,11370,184
"13497",239080,1998,1,0,"MARIAN COLLEGE OF FOND DU LAC",NA,NA,204,137,67,64,20,44,0.321,0.314,0.299,11785,174
"13498",239080,1999,1,0,"MARIAN COLLEGE OF FOND DU LAC",NA,NA,224,156,68,71,17,54,0.346,0.317,0.25,11966,195
"13499",239080,2000,1,0,"MARIAN COLLEGE OF FOND DU LAC",NA,NA,245,180,65,85,18,67,0.372,0.347,0.277,12624,212
"13500",239080,2001,1,0,"MARIAN COLLEGE OF FOND DU LAC",NA,NA,227,149,78,65,18,47,0.315,0.286,0.231,13230,196
"13501",239080,2002,1,0,"MARIAN COLLEGE OF FOND DU LAC",NA,NA,247,176,71,52,13,39,0.222,0.211,0.183,13880,203
"13502",239080,2003,1,0,"MARIAN COLLEGE OF FOND DU LAC",NA,NA,251,170,81,72,17,55,0.324,0.287,0.21,14700,221
"13503",239080,2004,1,0,"MARIAN COLLEGE OF FOND DU LAC",NA,NA,270,191,79,84,16,68,0.356,0.311,0.203,15500,227
"13504",239080,2005,1,0,"Marian College of Fond du Lac",NA,NA,262,190,72,78,17,61,0.321,0.298,0.236,16380,235
"13505",239080,2006,1,0,"Marian College of Fond du Lac",NA,NA,245,172,73,61,15,46,0.267,0.249,0.205,17300,217
"13506",239080,2007,1,0,"Marian College of Fond du Lac",NA,NA,266,191,75,80,8,72,0.377,0.301,0.107,18330,220
"13507",239080,2008,1,0,"Marian University-Wisconsin",NA,NA,284,210,74,103,15,88,0.419,0.363,0.203,19590,232
"13508",239080,2009,1,0,"Marian University",NA,NA,316,228,88,88,19,69,0.303,0.278,0.216,20550,221
"13509",239080,2010,1,0,"Marian University",NA,NA,309,219,90,92,12,80,0.365,0.298,0.133,21140,236
"13510",239105,1991,1,0,"MARQUETTE UNIVERSITY",NA,NA,1598,852,746,870,349,521,0.612,0.544,0.468,9000,1366
"13511",239105,1992,1,0,"MARQUETTE UNIVERSITY",NA,NA,1651,846,805,804,322,482,0.57,0.487,0.4,9900,1370
"13512",239105,1993,1,0,"MARQUETTE UNIVERSITY",NA,NA,1684,895,789,880,339,541,0.605,0.523,0.43,10700,1433
"13513",239105,1995,1,0,"MARQUETTE UNIVERSITY",NA,NA,1627,883,744,870,327,543,0.615,0.535,0.44,13010,1380
"13514",239105,1996,1,0,"MARQUETTE UNIVERSITY",NA,NA,1420,799,621,803,303,500,0.626,0.565,0.488,14710,1191
"13515",239105,1997,1,0,"MARQUETTE UNIVERSITY",NA,NA,1573,830,743,876,351,525,0.633,0.557,0.472,15160,1321
"13516",239105,1998,1,0,"MARQUETTE UNIVERSITY",NA,NA,1730,952,778,960,355,605,0.635,0.555,0.456,15620,1488
"13517",239105,1999,1,0,"MARQUETTE UNIVERSITY",NA,NA,1715,963,752,1064,414,650,0.675,0.62,0.551,16280,1497
"13518",239105,2000,1,0,"MARQUETTE UNIVERSITY",NA,NA,1675,926,749,963,404,559,0.604,0.575,0.539,17080,1426
"13519",239105,2001,1,0,"MARQUETTE UNIVERSITY",NA,NA,1658,950,708,947,374,573,0.603,0.571,0.528,18180,1410
"13520",239105,2002,1,0,"MARQUETTE UNIVERSITY",NA,NA,1856,1034,822,1052,433,619,0.599,0.567,0.527,19400,1574
"13521",239105,2003,1,0,"MARQUETTE UNIVERSITY",NA,NA,1882,1042,840,1125,462,663,0.636,0.598,0.55,20350,1648
"13522",239105,2004,1,0,"MARQUETTE UNIVERSITY",NA,NA,1802,979,823,1118,454,664,0.678,0.62,0.552,21550,1558
"13523",239105,2005,1,0,"Marquette University",NA,NA,1775,967,808,1083,448,635,0.657,0.61,0.554,22950,1488
"13524",239105,2006,1,0,"Marquette University",NA,NA,1842,1025,817,1096,445,651,0.635,0.595,0.545,24670,1494
"13525",239105,2007,1,0,"Marquette University",NA,NA,1811,966,845,1038,442,596,0.617,0.573,0.523,26270,1500
"13526",239105,2008,1,0,"Marquette University",NA,NA,1950,1043,907,1153,481,672,0.644,0.591,0.53,27720,1630
"13527",239105,2009,1,0,"Marquette University",NA,NA,1945,1005,940,1135,505,630,0.627,0.584,0.537,28680,1583
"13528",239105,2010,1,0,"Marquette University",NA,NA,1929,1015,914,1161,504,657,0.647,0.602,0.551,30040,1524
"13529",239628,1991,1,0,"RIPON COLLEGE",NA,NA,164,84,80,86,35,51,0.607,0.524,0.438,12900,144
"13530",239628,1992,1,0,"RIPON COLLEGE",NA,NA,180,92,88,88,32,56,0.609,0.489,0.364,13170,163
"13531",239628,1993,1,0,"RIPON COLLEGE",NA,NA,211,102,109,113,47,66,0.647,0.536,0.431,14340,195
"13532",239628,1995,1,0,"RIPON COLLEGE",NA,NA,184,101,83,99,42,57,0.564,0.538,0.506,16110,168
"13533",239628,1996,1,0,"RIPON COLLEGE",NA,NA,169,97,72,81,28,53,0.546,0.479,0.389,17000,146
"13534",239628,1997,1,0,"RIPON COLLEGE",NA,NA,135,62,73,71,35,36,0.581,0.526,0.479,17580,116
"13535",239628,1998,1,0,"RIPON COLLEGE",NA,NA,162,66,96,99,55,44,0.667,0.611,0.573,18240,150
"13536",239628,1999,1,0,"RIPON COLLEGE",NA,NA,283,156,127,174,73,101,0.647,0.615,0.575,18000,247
"13537",239628,2000,1,0,"RIPON COLLEGE",NA,NA,280,166,114,171,64,107,0.645,0.611,0.561,18000,242
"13538",239628,2001,1,0,"RIPON COLLEGE",NA,NA,200,108,92,119,48,71,0.657,0.595,0.522,19260,178
"13539",239628,2002,1,0,"RIPON COLLEGE",NA,NA,250,116,134,139,75,64,0.552,0.556,0.56,19260,214
"13540",239628,2003,1,0,"RIPON COLLEGE",NA,NA,259,130,129,156,72,84,0.646,0.602,0.558,19700,225
"13541",239628,2004,1,0,"RIPON COLLEGE",NA,NA,202,114,88,115,53,62,0.544,0.569,0.602,20490,165
"13542",239628,2005,1,0,"Ripon College",NA,NA,261,119,142,148,70,78,0.655,0.567,0.493,21310,216
"13543",239628,2006,1,0,"Ripon College",NA,NA,264,154,110,153,57,96,0.623,0.58,0.518,22162,229
"13544",239628,2007,1,0,"Ripon College",NA,NA,262,124,138,158,78,80,0.645,0.603,0.565,23048,232
"13545",239628,2008,1,0,"Ripon College",NA,NA,282,143,139,145,59,86,0.601,0.514,0.424,23970,239
"13546",239628,2009,1,0,"Ripon College",NA,NA,248,123,125,148,68,80,0.65,0.597,0.544,25170,189
"13547",239628,2010,1,0,"Ripon College",NA,NA,289,162,127,167,66,101,0.624,0.578,0.52,26806,253
"13548",239716,1991,1,0,"SAINT NORBERT COLLEGE",NA,NA,442,262,180,288,95,193,0.737,0.652,0.528,10225,430
"13549",239716,1992,1,0,"SAINT NORBERT COLLEGE",NA,NA,496,275,221,328,142,186,0.676,0.661,0.643,10805,479
"13550",239716,1993,1,0,"SAINT NORBERT COLLEGE",NA,NA,569,320,249,352,142,210,0.656,0.619,0.57,11465,538
"13551",239716,1995,1,0,"SAINT NORBERT COLLEGE",NA,NA,520,296,224,319,112,207,0.699,0.613,0.5,12940,487
"13552",239716,1996,1,0,"SAINT NORBERT COLLEGE",NA,NA,508,321,187,339,121,218,0.679,0.667,0.647,13700,489
"13553",239716,1997,1,0,"SAINT NORBERT COLLEGE",NA,NA,480,288,192,324,121,203,0.705,0.675,0.63,14234,447
"13554",239716,1998,1,0,"SAINT NORBERT COLLEGE",NA,NA,460,247,213,282,106,176,0.713,0.613,0.498,14789,418
"13555",239716,1999,1,0,"SAINT NORBERT COLLEGE",NA,NA,519,296,223,332,136,196,0.662,0.64,0.61,15600,480
"13556",239716,2000,1,0,"SAINT NORBERT COLLEGE",NA,NA,548,321,227,364,128,236,0.735,0.664,0.564,16570,505
"13557",239716,2001,1,0,"SAINT NORBERT COLLEGE",NA,NA,558,306,252,359,142,217,0.709,0.643,0.563,17757,514
"13558",239716,2002,1,0,"SAINT NORBERT COLLEGE",NA,NA,495,273,222,345,134,211,0.773,0.697,0.604,18834,457
"13559",239716,2003,1,0,"SAINT NORBERT COLLEGE",NA,NA,529,289,240,336,128,208,0.72,0.635,0.533,19822,493
"13560",239716,2004,1,0,"SAINT NORBERT COLLEGE",NA,NA,520,298,222,364,138,226,0.758,0.7,0.622,21210,464
"13561",239716,2005,1,0,"Saint Norbert College",NA,NA,504,282,222,328,147,181,0.642,0.651,0.662,22209,467
"13562",239716,2006,1,0,"Saint Norbert College",NA,NA,551,305,246,356,140,216,0.708,0.646,0.569,23097,502
"13563",239716,2007,1,0,"Saint Norbert College",NA,NA,542,328,214,372,130,242,0.738,0.686,0.607,24253,489
"13564",239716,2008,1,0,"Saint Norbert College",NA,NA,531,293,238,335,131,204,0.696,0.631,0.55,25526,486
"13565",239716,2009,1,0,"Saint Norbert College",NA,NA,543,308,235,359,135,224,0.727,0.661,0.574,26522,483
"13566",239716,2010,1,0,"Saint Norbert College",NA,NA,603,367,236,408,144,264,0.719,0.677,0.61,27583,534
"13567",240107,1991,1,0,"VITERBO COLLEGE",NA,NA,201,145,56,63,14,49,0.338,0.313,0.25,7960,187
"13568",240107,1992,1,0,"VITERBO COLLEGE",NA,NA,218,151,67,61,12,49,0.324,0.28,0.179,8360,214
"13569",240107,1993,1,0,"VITERBO COLLEGE",NA,NA,270,205,65,67,14,53,0.258,0.248,0.215,8770,257
"13570",240107,1995,1,0,"VITERBO COLLEGE",NA,NA,335,224,111,92,24,68,0.304,0.275,0.216,9850,308
"13571",240107,1996,1,0,"VITERBO COLLEGE",NA,NA,284,195,89,70,10,60,0.308,0.246,0.112,10560,271
"13572",240107,1997,1,0,"VITERBO COLLEGE",NA,NA,331,240,91,96,18,78,0.325,0.29,0.198,11150,313
"13573",240107,1998,1,0,"VITERBO COLLEGE",NA,NA,318,220,98,88,21,67,0.304,0.277,0.214,11690,290
"13574",240107,1999,1,0,"VITERBO COLLEGE",NA,NA,311,235,76,111,22,89,0.379,0.357,0.289,12220,290
"13575",240107,2000,1,0,"VITERBO UNIVERSITY",NA,NA,327,252,75,98,16,82,0.325,0.3,0.213,12770,308
"13576",240107,2001,1,0,"VITERBO UNIVERSITY",NA,NA,335,254,81,97,20,77,0.303,0.29,0.247,13350,313
"13577",240107,2002,1,0,"VITERBO UNIVERSITY",NA,NA,321,236,85,91,19,72,0.305,0.283,0.224,14020,298
"13578",240107,2003,1,0,"VITERBO UNIVERSITY",NA,NA,355,261,94,107,18,89,0.341,0.301,0.191,14900,330
"13579",240107,2004,1,0,"VITERBO UNIVERSITY",NA,NA,308,210,98,82,19,63,0.3,0.266,0.194,15570,286
"13580",240107,2005,1,0,"Viterbo University",NA,NA,289,207,82,82,11,71,0.343,0.284,0.134,16240,271
"13581",240107,2006,1,0,"Viterbo University",NA,NA,308,223,85,100,21,79,0.354,0.325,0.247,17220,275
"13582",240107,2007,1,0,"Viterbo University",NA,NA,361,252,109,108,26,82,0.325,0.299,0.239,18170,341
"13583",240107,2008,1,0,"Viterbo University",NA,NA,357,250,107,102,27,75,0.3,0.286,0.252,19000,337
"13584",240107,2009,1,0,"Viterbo University",NA,NA,405,287,118,119,24,95,0.331,0.294,0.203,19670,373
"13585",240107,2010,1,0,"Viterbo University",NA,NA,340,242,98,103,21,82,0.339,0.303,0.214,20360,309
"13586",240189,1991,1,0,"UNIVERSITY OF WISCONSIN-WHITEWATER",NA,NA,1765,990,775,200,60,140,0.141,0.113,0.077,1914,1596
"13587",240189,1992,1,0,"UNIVERSITY OF WISCONSIN-WHITEWATER",NA,NA,1746,933,813,204,68,136,0.146,0.117,0.084,2039,1575
"13588",240189,1993,1,0,"UNIVERSITY OF WISCONSIN-WHITEWATER",NA,NA,1823,1019,804,251,78,173,0.17,0.138,0.097,2178,1671
"13589",240189,1995,1,0,"UNIVERSITY OF WISCONSIN-WHITEWATER",NA,NA,1856,989,867,294,108,186,0.188,0.158,0.125,2474,1712
"13590",240189,1996,1,0,"UNIVERSITY OF WISCONSIN-WHITEWATER",NA,NA,1825,995,830,369,137,232,0.233,0.202,0.165,2586,1704
"13591",240189,1997,1,0,"UNIVERSITY OF WISCONSIN-WHITEWATER",NA,NA,1881,944,937,349,138,211,0.224,0.186,0.147,2772,1745
"13592",240189,1998,1,0,"UNIVERSITY OF WISCONSIN-WHITEWATER",NA,NA,1901,965,936,354,122,232,0.24,0.186,0.13,2919,1756
"13593",240189,1999,1,0,"UNIVERSITY OF WISCONSIN-WHITEWATER",NA,NA,1877,1017,860,357,119,238,0.234,0.19,0.138,2594,1718
"13594",240189,2000,1,0,"UNIVERSITY OF WISCONSIN-WHITEWATER",NA,NA,2052,1051,1001,423,155,268,0.255,0.206,0.155,2594,1829
"13595",240189,2001,1,0,"UNIVERSITY OF WISCONSIN-WHITEWATER",NA,NA,1857,936,921,379,153,226,0.242,0.204,0.166,2776,1681
"13596",240189,2002,1,0,"UNIVERSITY OF WISCONSIN-WHITEWATER",NA,NA,2004,1095,909,463,176,287,0.262,0.231,0.194,3106,1827
"13597",240189,2003,1,0,"UNIVERSITY OF WISCONSIN-WHITEWATER",NA,NA,1825,975,850,459,199,260,0.267,0.252,0.234,3623,1604
"13598",240189,2004,1,0,"UNIVERSITY OF WISCONSIN-WHITEWATER",NA,NA,1745,836,909,427,193,234,0.28,0.245,0.212,4150,1474
"13599",240189,2005,1,0,"University of Wisconsin-Whitewater",NA,NA,1701,823,878,437,196,241,0.293,0.257,0.223,4427,1509
"13600",240189,2006,1,0,"University of Wisconsin-Whitewater",NA,NA,1780,836,944,533,233,300,0.359,0.299,0.247,4728,1615
"13601",240189,2007,1,0,"University of Wisconsin-Whitewater",NA,NA,2048,993,1055,564,258,306,0.308,0.275,0.245,4988,1815
"13602",240189,2008,1,0,"University of Wisconsin-Whitewater",NA,NA,2132,1025,1107,575,276,299,0.292,0.27,0.249,5262,1859
"13603",240189,2009,1,0,"University of Wisconsin-Whitewater",NA,NA,1941,941,1000,542,250,292,0.31,0.279,0.25,5551,1655
"13604",240189,2010,1,0,"University of Wisconsin-Whitewater",NA,NA,2033,973,1060,590,267,323,0.332,0.29,0.252,5857,1750
"13605",240277,1991,1,0,"UNIVERSITY OF WISCONSIN-GREEN BAY",NA,NA,775,506,269,75,21,54,0.107,0.097,0.078,1806,725
"13606",240277,1992,1,0,"UNIVERSITY OF WISCONSIN-GREEN BAY",NA,NA,780,487,293,85,22,63,0.129,0.109,0.075,1995,715
"13607",240277,1993,1,0,"UNIVERSITY OF WISCONSIN-GREEN BAY",NA,NA,703,438,265,96,29,67,0.153,0.137,0.109,2104,678
"13608",240277,1995,1,0,"UNIVERSITY OF WISCONSIN-GREEN BAY",NA,NA,780,522,258,98,30,68,0.13,0.126,0.116,2427,755
"13609",240277,1996,1,0,"UNIVERSITY OF WISCONSIN-GREEN BAY",NA,NA,939,581,358,138,48,90,0.155,0.147,0.134,2548,895
"13610",240277,1997,1,0,"UNIVERSITY OF WISCONSIN-GREEN BAY",NA,NA,895,568,327,141,39,102,0.18,0.158,0.119,2736,859
"13611",240277,1998,1,0,"UNIVERSITY OF WISCONSIN-GREEN BAY",NA,NA,946,612,334,155,53,102,0.167,0.164,0.159,2916,906
"13612",240277,1999,1,0,"UNIVERSITY OF WISCONSIN-GREEN BAY",NA,NA,879,578,301,164,45,119,0.206,0.187,0.15,2594,828
"13613",240277,2000,1,0,"UNIVERSITY OF WISCONSIN-GREEN BAY",NA,NA,929,631,298,216,55,161,0.255,0.233,0.185,2594,890
"13614",240277,2001,1,0,"UNIVERSITY OF WISCONSIN-GREEN BAY",NA,NA,866,608,258,214,45,169,0.278,0.247,0.174,2776,824
"13615",240277,2002,1,0,"UNIVERSITY OF WISCONSIN-GREEN BAY",NA,NA,896,595,301,204,55,149,0.25,0.228,0.183,3000,825
"13616",240277,2003,1,0,"UNIVERSITY OF WISCONSIN-GREEN BAY",NA,NA,960,640,320,241,70,171,0.267,0.251,0.219,3500,896
"13617",240277,2004,1,0,"UNIVERSITY OF WISCONSIN-GREEN BAY",NA,NA,989,636,353,228,71,157,0.247,0.231,0.201,4000,910
"13618",240277,2005,1,0,"University of Wisconsin-Green Bay",NA,NA,904,587,317,198,45,153,0.261,0.219,0.142,4277,838
"13619",240277,2006,1,0,"University of Wisconsin-Green Bay",NA,NA,1019,667,352,226,63,163,0.244,0.222,0.179,4568,928
"13620",240277,2007,1,0,"University of Wisconsin-Green Bay",NA,NA,987,644,343,201,42,159,0.247,0.204,0.122,4819,904
"13621",240277,2008,1,0,"University of Wisconsin-Green Bay",NA,NA,1000,614,386,236,67,169,0.275,0.236,0.174,5084,918
"13622",240277,2009,1,0,"University of Wisconsin-Green Bay",NA,NA,1037,647,390,248,58,190,0.294,0.239,0.149,5364,928
"13623",240277,2010,1,0,"University of Wisconsin-Green Bay",NA,NA,894,572,322,214,46,168,0.294,0.239,0.143,5659,804
"13624",240329,1991,1,0,"UNIVERSITY OF WISCONSIN-LA CROSSE",NA,NA,1648,959,689,159,57,102,0.106,0.096,0.083,1945,1580
"13625",240329,1992,1,0,"UNIVERSITY OF WISCONSIN-LA CROSSE",NA,NA,1486,921,565,161,42,119,0.129,0.108,0.074,2076,1390
"13626",240329,1993,1,0,"UNIVERSITY OF WISCONSIN-LA CROSSE",NA,NA,1695,1008,687,243,83,160,0.159,0.143,0.121,2217,1595
"13627",240329,1995,1,0,"UNIVERSITY OF WISCONSIN-LA CROSSE",NA,NA,1731,1035,696,324,104,220,0.213,0.187,0.149,2513,1643
"13628",240329,1996,1,0,"UNIVERSITY OF WISCONSIN-LA CROSSE",NA,NA,1721,1074,647,393,109,284,0.264,0.228,0.168,2633,1650
"13629",240329,1997,1,0,"UNIVERSITY OF WISCONSIN-LA CROSSE",NA,NA,1700,1042,658,386,108,278,0.267,0.227,0.164,2857,1620
"13630",240329,1998,1,0,"UNIVERSITY OF WISCONSIN-LA CROSSE",NA,NA,1740,1123,617,450,128,322,0.287,0.259,0.207,3009,1649
"13631",240329,1999,1,0,"UNIVERSITY OF WISCONSIN-LA CROSSE",NA,NA,1631,1035,596,395,128,267,0.258,0.242,0.215,2594,1544
"13632",240329,2000,1,0,"UNIVERSITY OF WISCONSIN-LA CROSSE",NA,NA,1609,1009,600,420,131,289,0.286,0.261,0.218,2594,1501
"13633",240329,2001,1,0,"UNIVERSITY OF WISCONSIN-LA CROSSE",NA,NA,1596,1022,574,444,138,306,0.299,0.278,0.24,2776,1504
"13634",240329,2002,1,0,"UNIVERSITY OF WISCONSIN-LA CROSSE",NA,NA,1555,1006,549,463,128,335,0.333,0.298,0.233,3000,1456
"13635",240329,2003,1,0,"UNIVERSITY OF WISCONSIN-LA CROSSE",NA,NA,1506,984,522,507,153,354,0.36,0.337,0.293,3540,1398
"13636",240329,2004,1,0,"UNIVERSITY OF WISCONSIN-LA CROSSE",NA,NA,1539,958,581,498,157,341,0.356,0.324,0.27,4040,1411
"13637",240329,2005,1,0,"University of Wisconsin-La Crosse",NA,NA,1755,1056,699,579,176,403,0.382,0.33,0.252,4331,1611
"13638",240329,2006,1,0,"University of Wisconsin-La Crosse",NA,NA,1751,1098,653,633,190,443,0.404,0.362,0.291,4623,1585
"13639",240329,2007,1,0,"University of Wisconsin-La Crosse",NA,NA,1750,1084,666,621,196,425,0.392,0.355,0.294,4876,1558
"13640",240329,2008,1,0,"University of Wisconsin-La Crosse",NA,NA,1779,1081,698,577,192,385,0.356,0.324,0.275,5643,1573
"13641",240329,2009,1,0,"University of Wisconsin-La Crosse",NA,NA,1826,1128,698,660,193,467,0.414,0.361,0.277,6425,1608
"13642",240329,2010,1,0,"University of Wisconsin-La Crosse",NA,NA,1836,1093,743,660,209,451,0.413,0.359,0.281,6809,1648
"13643",240338,1991,1,0,"WISCONSIN LUTHERAN COLLEGE",NA,NA,71,45,26,20,8,12,0.267,0.282,0.308,7500,69
"13644",240338,1992,1,0,"WISCONSIN LUTHERAN COLLEGE",NA,NA,77,45,32,22,7,15,0.333,0.286,0.219,8280,73
"13645",240338,1993,1,0,"WISCONSIN LUTHERAN COLLEGE",NA,NA,80,55,25,31,10,21,0.382,0.388,0.4,8600,74
"13646",240338,1995,1,0,"WISCONSIN LUTHERAN COLLEGE",NA,NA,109,63,46,51,18,33,0.524,0.468,0.391,9940,105
"13647",240338,1996,1,0,"WISCONSIN LUTHERAN COLLEGE",NA,NA,101,71,30,55,12,43,0.606,0.545,0.4,11000,95
"13648",240338,1997,1,0,"WISCONSIN LUTHERAN COLLEGE",NA,NA,109,61,48,50,21,29,0.475,0.459,0.438,11450,104
"13649",240338,1998,1,0,"WISCONSIN LUTHERAN COLLEGE",NA,NA,124,80,44,60,20,40,0.5,0.484,0.455,11960,120
"13650",240338,1999,1,0,"WISCONSIN LUTHERAN COLLEGE",NA,NA,161,92,69,79,23,56,0.609,0.491,0.333,12460,149
"13651",240338,2000,1,0,"WISCONSIN LUTHERAN COLLEGE",NA,NA,194,125,69,91,33,58,0.464,0.469,0.478,12980,184
"13652",240338,2001,1,0,"WISCONSIN LUTHERAN COLLEGE",NA,NA,200,124,76,96,31,65,0.524,0.48,0.408,13990,194
"13653",240338,2002,1,0,"WISCONSIN LUTHERAN COLLEGE",NA,NA,158,88,70,79,31,48,0.545,0.5,0.443,14970,147
"13654",240338,2003,1,0,"WISCONSIN LUTHERAN COLLEGE",NA,NA,207,126,81,110,31,79,0.627,0.531,0.383,15720,196
"13655",240338,2004,1,0,"WISCONSIN LUTHERAN COLLEGE",NA,NA,186,112,74,79,28,51,0.455,0.425,0.378,16510,173
"13656",240338,2005,1,0,"Wisconsin Lutheran College",NA,NA,180,110,70,81,33,48,0.436,0.45,0.471,17340,172
"13657",240338,2006,1,0,"Wisconsin Lutheran College",NA,NA,198,116,82,81,31,50,0.431,0.409,0.378,18520,184
"13658",240338,2007,1,0,"Wisconsin Lutheran College",NA,NA,181,97,84,82,34,48,0.495,0.453,0.405,19430,155
"13659",240338,2008,1,0,"Wisconsin Lutheran College",NA,NA,223,128,95,110,43,67,0.523,0.493,0.453,20420,190
"13660",240338,2009,1,0,"Wisconsin Lutheran College",NA,NA,202,104,98,89,33,56,0.538,0.441,0.337,21040,176
"13661",240338,2010,1,0,"Wisconsin Lutheran College",NA,NA,246,136,110,108,32,76,0.559,0.439,0.291,21820,206
"13662",240365,1991,1,0,"UNIVERSITY OF WISCONSIN-OSHKOSH",NA,NA,1411,787,624,136,31,105,0.133,0.096,0.05,1821,1314
"13663",240365,1992,1,0,"UNIVERSITY OF WISCONSIN-OSHKOSH",NA,NA,1461,834,627,172,32,140,0.168,0.118,0.051,1927,1356
"13664",240365,1993,1,0,"UNIVERSITY OF WISCONSIN-OSHKOSH",NA,NA,1465,833,632,200,53,147,0.176,0.137,0.084,2037,1368
"13665",240365,1995,1,0,"UNIVERSITY OF WISCONSIN-OSHKOSH",NA,NA,1487,844,643,211,74,137,0.162,0.142,0.115,2300,1428
"13666",240365,1996,1,0,"UNIVERSITY OF WISCONSIN-OSHKOSH",NA,NA,1501,855,646,227,65,162,0.19,0.151,0.101,2417,1432
"13667",240365,1997,1,0,"UNIVERSITY OF WISCONSIN-OSHKOSH",NA,NA,1719,994,725,242,69,173,0.174,0.141,0.095,2607,1656
"13668",240365,1998,1,0,"UNIVERSITY OF WISCONSIN-OSHKOSH",NA,NA,1894,1095,799,252,67,185,0.169,0.133,0.084,2780,1820
"13669",240365,1999,1,0,"UNIVERSITY OF WISCONSIN-OSHKOSH",NA,NA,1834,1084,750,284,85,199,0.184,0.155,0.113,2594,1750
"13670",240365,2000,1,0,"UNIVERSITY OF WISCONSIN-OSHKOSH",NA,NA,1624,969,655,236,65,171,0.176,0.145,0.099,2594,1550
"13671",240365,2001,1,0,"UNIVERSITY OF WISCONSIN-OSHKOSH",NA,NA,1822,994,828,249,86,163,0.164,0.137,0.104,2776,1726
"13672",240365,2002,1,0,"UNIVERSITY OF WISCONSIN-OSHKOSH",NA,NA,1775,1045,730,259,71,188,0.18,0.146,0.097,3000,1669
"13673",240365,2003,1,0,"UNIVERSITY OF WISCONSIN-OSHKOSH",NA,NA,1765,1077,688,261,67,194,0.18,0.148,0.097,3551,1641
"13674",240365,2004,1,0,"UNIVERSITY OF WISCONSIN-OSHKOSH",NA,NA,1708,1033,675,250,78,172,0.166,0.146,0.116,4110,1577
"13675",240365,2005,1,0,"University of Wisconsin-Oshkosh",NA,NA,1617,982,635,234,81,153,0.156,0.145,0.128,4387,1471
"13676",240365,2006,1,0,"University of Wisconsin-Oshkosh",NA,NA,1726,1024,702,272,83,189,0.185,0.158,0.118,4678,1575
"13677",240365,2007,1,0,"University of Wisconsin-Oshkosh",NA,NA,1723,1018,705,300,96,204,0.2,0.174,0.136,4929,1576
"13678",240365,2008,1,0,"University of Wisconsin-Oshkosh",NA,NA,1807,1048,759,294,112,182,0.174,0.163,0.148,5194,1618
"13679",240365,2009,1,0,"University of Wisconsin-Oshkosh",NA,NA,1874,1061,813,274,95,179,0.169,0.146,0.117,5477,1680
"13680",240365,2010,1,0,"University of Wisconsin-Oshkosh",NA,NA,1817,1039,778,328,116,212,0.204,0.181,0.149,5775,1610
"13681",240374,1991,1,0,"UNIVERSITY OF WISCONSIN-PARKSIDE",NA,NA,627,333,294,29,11,18,0.054,0.046,0.037,1863,556
"13682",240374,1992,1,0,"UNIVERSITY OF WISCONSIN-PARKSIDE",NA,NA,633,321,312,32,14,18,0.056,0.051,0.045,1990,549
"13683",240374,1993,1,0,"UNIVERSITY OF WISCONSIN-PARKSIDE",NA,NA,668,355,313,51,17,34,0.096,0.076,0.054,2113,566
"13684",240374,1995,1,0,"UNIVERSITY OF WISCONSIN-PARKSIDE",NA,NA,637,369,268,42,13,29,0.079,0.066,0.049,2406,532
"13685",240374,1996,1,0,"UNIVERSITY OF WISCONSIN-PARKSIDE",NA,NA,606,354,252,49,14,35,0.099,0.081,0.056,2523,530
"13686",240374,1997,1,0,"UNIVERSITY OF WISCONSIN-PARKSIDE",NA,NA,726,440,286,87,24,63,0.143,0.12,0.084,2705,583
"13687",240374,1998,1,0,"UNIVERSITY OF WISCONSIN-PARKSIDE",NA,NA,790,441,349,83,24,59,0.134,0.105,0.069,2840,644
"13688",240374,1999,1,0,"UNIVERSITY OF WISCONSIN-PARKSIDE",NA,NA,811,419,392,78,30,48,0.115,0.096,0.077,2594,644
"13689",240374,2000,1,0,"UNIVERSITY OF WISCONSIN-PARKSIDE",NA,NA,747,413,334,82,31,51,0.124,0.11,0.093,2594,578
"13690",240374,2001,1,0,"UNIVERSITY OF WISCONSIN-PARKSIDE",NA,NA,854,486,368,84,21,63,0.13,0.098,0.057,2776,678
"13691",240374,2002,1,0,"UNIVERSITY OF WISCONSIN-PARKSIDE",NA,NA,760,418,342,70,24,46,0.11,0.092,0.07,3000,627
"13692",240374,2003,1,0,"UNIVERSITY OF WISCONSIN-PARKSIDE",NA,NA,863,469,394,68,27,41,0.087,0.079,0.069,3500,713
"13693",240374,2004,1,0,"UNIVERSITY OF WISCONSIN-PARKSIDE",NA,NA,890,491,399,87,34,53,0.108,0.098,0.085,4000,670
"13694",240374,2005,1,0,"University of Wisconsin-Parkside",NA,NA,783,442,341,61,27,34,0.077,0.078,0.079,4277,582
"13695",240374,2006,1,0,"University of Wisconsin-Parkside",NA,NA,814,442,372,60,18,42,0.095,0.074,0.048,4568,587
"13696",240374,2007,1,0,"University of Wisconsin-Parkside",NA,NA,833,418,415,75,38,37,0.088,0.09,0.092,4819,600
"13697",240374,2008,1,0,"University of Wisconsin-Parkside",NA,NA,833,420,413,70,36,34,0.081,0.084,0.087,5084,544
"13698",240374,2009,1,0,"University of Wisconsin-Parkside",NA,NA,788,427,361,88,31,57,0.134,0.112,0.086,5364,557
"13699",240374,2010,1,0,"University of Wisconsin-Parkside",NA,NA,711,355,356,40,14,26,0.073,0.056,0.039,5659,492
"13700",240417,1991,1,0,"UNIVERSITY OF WISCONSIN-STOUT",NA,NA,1158,606,552,77,19,58,0.096,0.066,0.034,1933,1086
"13701",240417,1992,1,0,"UNIVERSITY OF WISCONSIN-STOUT",NA,NA,988,530,458,114,25,89,0.168,0.115,0.055,2054,909
"13702",240417,1993,1,0,"UNIVERSITY OF WISCONSIN-STOUT",NA,NA,1023,488,535,143,36,107,0.219,0.14,0.067,2175,962
"13703",240417,1995,1,0,"UNIVERSITY OF WISCONSIN-STOUT",NA,NA,1133,542,591,143,36,107,0.197,0.126,0.061,2461,1085
"13704",240417,1996,1,0,"UNIVERSITY OF WISCONSIN-STOUT",NA,NA,1275,644,631,194,61,133,0.206,0.152,0.097,2619,1226
"13705",240417,1997,1,0,"UNIVERSITY OF WISCONSIN-STOUT",NA,NA,1241,604,637,170,47,123,0.204,0.137,0.074,2806,1185
"13706",240417,1998,1,0,"UNIVERSITY OF WISCONSIN-STOUT",NA,NA,1333,614,719,209,74,135,0.22,0.157,0.103,2938,1287
"13707",240417,1999,1,0,"UNIVERSITY OF WISCONSIN-STOUT",NA,NA,1317,661,656,185,57,128,0.194,0.14,0.087,2724,1259
"13708",240417,2000,1,0,"UNIVERSITY OF WISCONSIN-STOUT",NA,NA,1307,668,639,195,58,137,0.205,0.149,0.091,2724,1258
"13709",240417,2001,1,0,"UNIVERSITY OF WISCONSIN-STOUT",NA,NA,1272,652,620,202,62,140,0.215,0.159,0.1,2916,1225
"13710",240417,2002,1,0,"UNIVERSITY OF WISCONSIN-STOUT",NA,NA,1303,658,645,219,51,168,0.255,0.168,0.079,3150,1243
"13711",240417,2003,1,0,"UNIVERSITY OF WISCONSIN-STOUT",NA,NA,1267,654,613,244,75,169,0.258,0.193,0.122,5024,1216
"13712",240417,2004,1,0,"UNIVERSITY OF WISCONSIN-STOUT",NA,NA,1277,649,628,254,67,187,0.288,0.199,0.107,5580,1178
"13713",240417,2005,1,0,"University of Wisconsin-Stout",NA,NA,1699,863,836,322,103,219,0.254,0.19,0.123,4745,1565
"13714",240417,2006,1,0,"University of Wisconsin-Stout",NA,NA,1507,792,715,275,90,185,0.234,0.182,0.126,5087,1394
"13715",240417,2007,1,0,"University of Wisconsin-Stout",NA,NA,1489,763,726,309,108,201,0.263,0.208,0.149,5367,1375
"13716",240417,2008,1,0,"University of Wisconsin-Stout",NA,NA,1633,837,796,313,103,210,0.251,0.192,0.129,5662,1502
"13717",240417,2009,1,0,"University of Wisconsin-Stout",NA,NA,1517,788,729,350,111,239,0.303,0.231,0.152,5974,1395
"13718",240417,2010,1,0,"University of Wisconsin-Stout",NA,NA,1571,756,815,324,124,200,0.265,0.206,0.152,6302,1428
"13719",240426,1991,1,0,"UNIVERSITY OF WISCONSIN-SUPERIOR",NA,NA,443,220,223,24,10,14,0.064,0.054,0.045,1806,420
"13720",240426,1992,1,0,"UNIVERSITY OF WISCONSIN-SUPERIOR",NA,NA,350,189,161,35,14,21,0.111,0.1,0.087,1917,319
"13721",240426,1993,1,0,"UNIVERSITY OF WISCONSIN-SUPERIOR",NA,NA,323,182,141,41,14,27,0.148,0.127,0.099,2036,306
"13722",240426,1995,1,0,"UNIVERSITY OF WISCONSIN-SUPERIOR",NA,NA,288,173,115,52,17,35,0.202,0.181,0.148,2335,268
"13723",240426,1996,1,0,"UNIVERSITY OF WISCONSIN-SUPERIOR",NA,NA,308,158,150,42,13,29,0.184,0.136,0.087,2463,286
"13724",240426,1997,1,0,"UNIVERSITY OF WISCONSIN-SUPERIOR",NA,NA,326,182,144,36,13,23,0.126,0.11,0.09,2652,300
"13725",240426,1998,1,0,"UNIVERSITY OF WISCONSIN-SUPERIOR",NA,NA,376,218,158,55,16,39,0.179,0.146,0.101,2770,356
"13726",240426,1999,1,0,"UNIVERSITY OF WISCONSIN-SUPERIOR",NA,NA,406,241,165,38,6,32,0.133,0.094,0.036,2594,387
"13727",240426,2000,1,0,"UNIVERSITY OF WISCONSIN-SUPERIOR",NA,NA,395,234,161,57,21,36,0.154,0.144,0.13,2594,367
"13728",240426,2001,1,0,"UNIVERSITY OF WISCONSIN-SUPERIOR",NA,NA,339,192,147,53,24,29,0.151,0.156,0.163,2776,297
"13729",240426,2002,1,0,"UNIVERSITY OF WISCONSIN-SUPERIOR",NA,NA,286,150,136,37,15,22,0.147,0.129,0.11,3000,254
"13730",240426,2003,1,0,"UNIVERSITY OF WISCONSIN-SUPERIOR",NA,NA,336,213,123,66,14,52,0.244,0.196,0.114,3650,303
"13731",240426,2004,1,0,"UNIVERSITY OF WISCONSIN-SUPERIOR",NA,NA,329,190,139,54,20,34,0.179,0.164,0.144,4150,293
"13732",240426,2005,1,0,"University of Wisconsin-Superior",NA,NA,336,208,128,61,11,50,0.24,0.182,0.086,4427,290
"13733",240426,2006,1,0,"University of Wisconsin-Superior",NA,NA,293,143,150,53,26,27,0.189,0.181,0.173,4718,255
"13734",240426,2007,1,0,"University of Wisconsin-Superior",NA,NA,343,197,146,47,14,33,0.168,0.137,0.096,4969,307
"13735",240426,2008,1,0,"University of Wisconsin-Superior",NA,NA,303,168,135,59,15,44,0.262,0.195,0.111,5291,259
"13736",240426,2009,1,0,"University of Wisconsin-Superior",NA,NA,364,194,170,58,22,36,0.186,0.159,0.129,5571,297
"13737",240426,2010,1,0,"University of Wisconsin-Superior",NA,NA,369,197,172,80,27,53,0.269,0.217,0.157,5866,303
"13738",240444,1991,1,0,"UNIVERSITY OF WISCONSIN-MADISON",NA,NA,4582,2387,2195,1516,589,927,0.388,0.331,0.268,2188,4138
"13739",240444,1992,1,0,"UNIVERSITY OF WISCONSIN-MADISON",NA,NA,4390,2244,2146,1514,599,915,0.408,0.345,0.279,2346,3910
"13740",240444,1993,1,0,"UNIVERSITY OF WISCONSIN-MADISON",NA,NA,4585,2396,2189,1686,659,1027,0.429,0.368,0.301,2540,4052
"13741",240444,1995,1,0,"UNIVERSITY OF WISCONSIN-MADISON",NA,NA,5101,2779,2322,2037,768,1269,0.457,0.399,0.331,2881,4547
"13742",240444,1996,1,0,"UNIVERSITY OF WISCONSIN-MADISON",NA,NA,5394,2954,2440,2090,769,1321,0.447,0.387,0.315,3030,4772
"13743",240444,1997,1,0,"UNIVERSITY OF WISCONSIN-MADISON",NA,NA,5828,3156,2672,2303,835,1468,0.465,0.395,0.312,3241,5148
"13744",240444,1998,1,0,"UNIVERSITY OF WISCONSIN-MADISON",NA,NA,5548,3038,2510,2190,844,1346,0.443,0.395,0.336,3408,4850
"13745",240444,1999,1,0,"UNIVERSITY OF WISCONSIN-MADISON",NA,NA,5520,2985,2535,2263,847,1416,0.474,0.41,0.334,3290,4831
"13746",240444,2000,1,0,"UNIVERSITY OF WISCONSIN-MADISON",NA,NA,5636,3120,2516,2500,963,1537,0.493,0.444,0.383,3290,4979
"13747",240444,2001,1,0,"UNIVERSITY OF WISCONSIN-MADISON",NA,NA,6050,3370,2680,2758,1046,1712,0.508,0.456,0.39,3658,5223
"13748",240444,2002,1,0,"UNIVERSITY OF WISCONSIN-MADISON",NA,NA,5488,3016,2472,2729,1037,1692,0.561,0.497,0.419,3854,4742
"13749",240444,2003,1,0,"UNIVERSITY OF WISCONSIN-MADISON",NA,NA,5553,2968,2585,2689,1114,1575,0.531,0.484,0.431,4554,4649
"13750",240444,2004,1,0,"UNIVERSITY OF WISCONSIN-MADISON",NA,NA,5617,3124,2493,2792,1096,1696,0.543,0.497,0.44,5254,4607
"13751",240444,2005,1,0,"University of Wisconsin-Madison",NA,NA,6118,3434,2684,3174,1255,1919,0.559,0.519,0.468,5618,4942
"13752",240444,2006,1,0,"University of Wisconsin-Madison",NA,NA,5633,3033,2600,2965,1202,1763,0.581,0.526,0.462,6000,4458
"13753",240444,2007,1,0,"University of Wisconsin-Madison",NA,NA,5980,3197,2783,3291,1332,1959,0.613,0.55,0.479,6330,4658
"13754",240444,2008,1,0,"University of Wisconsin-Madison",NA,NA,5759,3027,2732,3148,1333,1815,0.6,0.547,0.488,6678,4465
"13755",240444,2009,1,0,"University of Wisconsin-Madison",NA,NA,5673,3033,2640,3179,1277,1902,0.627,0.56,0.484,7296,4394
"13756",240444,2010,1,0,"University of Wisconsin-Madison",NA,NA,5920,3108,2812,3337,1328,2009,0.646,0.564,0.472,7933,4676
"13757",240453,1991,1,0,"UNIVERSITY OF WISCONSIN-MILWAUKEE",NA,NA,1392,730,662,145,53,92,0.126,0.104,0.08,2231,1241
"13758",240453,1992,1,0,"UNIVERSITY OF WISCONSIN-MILWAUKEE",NA,NA,1187,566,621,113,40,73,0.129,0.095,0.064,2391,1056
"13759",240453,1993,1,0,"UNIVERSITY OF WISCONSIN-MILWAUKEE",NA,NA,1712,849,863,117,51,66,0.078,0.068,0.059,2548,1411
"13760",240453,1995,1,0,"UNIVERSITY OF WISCONSIN-MILWAUKEE",NA,NA,1785,926,859,186,75,111,0.12,0.104,0.087,2947,1467
"13761",240453,1996,1,0,"UNIVERSITY OF WISCONSIN-MILWAUKEE",NA,NA,2033,1113,920,233,88,145,0.13,0.115,0.096,3102,1690
"13762",240453,1997,1,0,"UNIVERSITY OF WISCONSIN-MILWAUKEE",NA,NA,2272,1263,1009,327,124,203,0.161,0.144,0.123,3327,1866
"13763",240453,1998,1,0,"UNIVERSITY OF WISCONSIN-MILWAUKEE",NA,NA,2513,1367,1146,273,102,171,0.125,0.109,0.089,3482,2019
"13764",240453,1999,1,0,"UNIVERSITY OF WISCONSIN-MILWAUKEE",NA,NA,2694,1523,1171,356,127,229,0.15,0.132,0.108,3194,2243
"13765",240453,2000,1,0,"UNIVERSITY OF WISCONSIN-MILWAUKEE",NA,NA,2663,1449,1214,395,142,253,0.175,0.148,0.117,3194,2187
"13766",240453,2001,1,0,"UNIVERSITY OF WISCONSIN-MILWAUKEE",NA,NA,2884,1532,1352,423,160,263,0.172,0.147,0.118,3462,2335
"13767",240453,2002,1,0,"UNIVERSITY OF WISCONSIN-MILWAUKEE",NA,NA,3178,1736,1442,457,175,282,0.162,0.144,0.121,3738,2633
"13768",240453,2003,1,0,"UNIVERSITY OF WISCONSIN-MILWAUKEE",NA,NA,3716,2023,1693,552,217,335,0.166,0.149,0.128,4439,3089
"13769",240453,2004,1,0,"UNIVERSITY OF WISCONSIN-MILWAUKEE",NA,NA,3714,2000,1714,555,216,339,0.169,0.149,0.126,5138,3051
"13770",240453,2005,1,0,"University of Wisconsin-Milwaukee",NA,NA,4218,2233,1985,604,258,346,0.155,0.143,0.13,5494,3456
"13771",240453,2006,1,0,"University of Wisconsin-Milwaukee",NA,NA,3977,2064,1913,554,247,307,0.149,0.139,0.129,5868,3280
"13772",240453,2007,1,0,"University of Wisconsin-Milwaukee",NA,NA,4465,2228,2237,585,259,326,0.146,0.131,0.116,6191,3619
"13773",240453,2008,1,0,"University of Wisconsin-Milwaukee",NA,NA,4002,2100,1902,572,246,326,0.155,0.143,0.129,6531,3124
"13774",240453,2009,1,0,"University of Wisconsin-Milwaukee",NA,NA,4051,2020,2031,578,250,328,0.162,0.143,0.123,6890,3138
"13775",240453,2010,1,0,"University of Wisconsin-Milwaukee",NA,NA,3731,1876,1855,506,225,281,0.15,0.136,0.121,7269,2737
"13776",240462,1991,1,0,"UNIVERSITY OF WISCONSIN-PLATTEVILLE",NA,NA,986,339,647,110,56,54,0.159,0.112,0.087,1955,939
"13777",240462,1992,1,0,"UNIVERSITY OF WISCONSIN-PLATTEVILLE",NA,NA,878,304,574,98,48,50,0.164,0.112,0.084,2087,843
"13778",240462,1993,1,0,"UNIVERSITY OF WISCONSIN-PLATTEVILLE",NA,NA,917,276,641,109,51,58,0.21,0.119,0.08,2207,871
"13779",240462,1995,1,0,"UNIVERSITY OF WISCONSIN-PLATTEVILLE",NA,NA,926,315,611,125,59,66,0.21,0.135,0.097,2485,883
"13780",240462,1996,1,0,"UNIVERSITY OF WISCONSIN-PLATTEVILLE",NA,NA,933,300,633,120,59,61,0.203,0.129,0.093,2591,907
"13781",240462,1997,1,0,"UNIVERSITY OF WISCONSIN-PLATTEVILLE",NA,NA,978,304,674,138,69,69,0.227,0.141,0.102,2775,940
"13782",240462,1998,1,0,"UNIVERSITY OF WISCONSIN-PLATTEVILLE",NA,NA,1118,369,749,134,63,71,0.192,0.12,0.084,2916,1070
"13783",240462,1999,1,0,"UNIVERSITY OF WISCONSIN-PLATTEVILLE",NA,NA,1093,377,716,148,61,87,0.231,0.135,0.085,2594,1059
"13784",240462,2000,1,0,"UNIVERSITY OF WISCONSIN-PLATTEVILLE",NA,NA,958,340,618,129,53,76,0.224,0.135,0.086,2594,925
"13785",240462,2001,1,0,"UNIVERSITY OF WISCONSIN-PLATTEVILLE",NA,NA,1039,373,666,176,85,91,0.244,0.169,0.128,2776,1010
"13786",240462,2002,1,0,"UNIVERSITY OF WISCONSIN-PLATTEVILLE",NA,NA,1120,395,725,184,75,109,0.276,0.164,0.103,3000,1076
"13787",240462,2003,1,0,"UNIVERSITY OF WISCONSIN-PLATTEVILLE",NA,NA,1116,406,710,203,105,98,0.241,0.182,0.148,3500,1081
"13788",240462,2004,1,0,"UNIVERSITY OF WISCONSIN-PLATTEVILLE",NA,NA,1164,398,766,205,90,115,0.289,0.176,0.117,4000,1103
"13789",240462,2005,1,0,"University of Wisconsin-Platteville",NA,NA,1218,426,792,187,83,104,0.244,0.154,0.105,4277,1152
"13790",240462,2006,1,0,"University of Wisconsin-Platteville",NA,NA,1387,467,920,259,145,114,0.244,0.187,0.158,4568,1292
"13791",240462,2007,1,0,"University of Wisconsin-Platteville",NA,NA,1466,500,966,275,127,148,0.296,0.188,0.131,4819,1371
"13792",240462,2008,1,0,"University of Wisconsin-Platteville",NA,NA,1468,496,972,235,117,118,0.238,0.16,0.12,5184,1353
"13793",240462,2009,1,0,"University of Wisconsin-Platteville",NA,NA,1531,512,1019,304,166,138,0.27,0.199,0.163,5466,1409
"13794",240462,2010,1,0,"University of Wisconsin-Platteville",NA,NA,1534,508,1026,297,170,127,0.25,0.194,0.166,5766,1428
"13795",240471,1991,1,0,"UNIVERSITY OF WISCONSIN-RIVER FALLS",NA,NA,1022,557,465,122,48,74,0.133,0.119,0.103,2199,966
"13796",240471,1992,1,0,"UNIVERSITY OF WISCONSIN-RIVER FALLS",NA,NA,1009,543,466,151,68,83,0.153,0.15,0.146,2024,962
"13797",240471,1993,1,0,"UNIVERSITY OF WISCONSIN-RIVER FALLS",NA,NA,838,443,395,162,64,98,0.221,0.193,0.162,2145,776
"13798",240471,1995,1,0,"UNIVERSITY OF WISCONSIN-RIVER FALLS",NA,NA,957,548,409,204,73,131,0.239,0.213,0.178,2445,909
"13799",240471,1996,1,0,"UNIVERSITY OF WISCONSIN-RIVER FALLS",NA,NA,1149,688,461,249,82,167,0.243,0.217,0.178,2565,1106
"13800",240471,1997,1,0,"UNIVERSITY OF WISCONSIN-RIVER FALLS",NA,NA,1144,698,446,269,79,190,0.272,0.235,0.177,2750,1100
"13801",240471,1998,1,0,"UNIVERSITY OF WISCONSIN-RIVER FALLS",NA,NA,1199,773,426,287,87,200,0.259,0.239,0.204,2890,1149
"13802",240471,1999,1,0,"UNIVERSITY OF WISCONSIN-RIVER FALLS",NA,NA,1104,684,420,277,95,182,0.266,0.251,0.226,2594,1038
"13803",240471,2000,1,0,"UNIVERSITY OF WISCONSIN-RIVER FALLS",NA,NA,1096,669,427,259,81,178,0.266,0.236,0.19,2594,1018
"13804",240471,2001,1,0,"UNIVERSITY OF WISCONSIN-RIVER FALLS",NA,NA,1108,680,428,265,86,179,0.263,0.239,0.201,2776,1028
"13805",240471,2002,1,0,"UNIVERSITY OF WISCONSIN-RIVER FALLS",NA,NA,1045,642,403,277,81,196,0.305,0.265,0.201,3000,971
"13806",240471,2003,1,0,"UNIVERSITY OF WISCONSIN-RIVER FALLS",NA,NA,1220,757,463,305,98,207,0.273,0.25,0.212,3500,1113
"13807",240471,2004,1,0,"UNIVERSITY OF WISCONSIN-RIVER FALLS",NA,NA,1197,722,475,311,109,202,0.28,0.26,0.229,4000,1086
"13808",240471,2005,1,0,"University of Wisconsin-River Falls",NA,NA,1192,734,458,268,80,188,0.256,0.225,0.175,4277,1076
"13809",240471,2006,1,0,"University of Wisconsin-River Falls",NA,NA,1289,773,516,281,77,204,0.264,0.218,0.149,4568,1176
"13810",240471,2007,1,0,"University of Wisconsin-River Falls",NA,NA,1276,743,533,297,103,194,0.261,0.233,0.193,4891,1184
"13811",240471,2008,1,0,"University of Wisconsin-River Falls",NA,NA,1332,783,549,365,136,229,0.292,0.274,0.248,5156,1228
"13812",240471,2009,1,0,"University of Wisconsin-River Falls",NA,NA,1325,836,489,382,108,274,0.328,0.288,0.221,5436,1214
"13813",240471,2010,1,0,"University of Wisconsin-River Falls",NA,NA,1230,758,472,360,112,248,0.327,0.293,0.237,5731,1104
"13814",240480,1991,1,0,"UNIVERSITY OF WISCONSIN-STEVENS POINT",NA,NA,1494,763,731,183,62,121,0.159,0.122,0.085,1955,1434
"13815",240480,1992,1,0,"UNIVERSITY OF WISCONSIN-STEVENS POINT",NA,NA,1388,772,616,229,61,168,0.218,0.165,0.099,2078,1315
"13816",240480,1993,1,0,"UNIVERSITY OF WISCONSIN-STEVENS POINT",NA,NA,1359,702,657,201,72,129,0.184,0.148,0.11,2218,1298
"13817",240480,1995,1,0,"UNIVERSITY OF WISCONSIN-STEVENS POINT",NA,NA,1474,817,657,285,82,203,0.249,0.193,0.125,2488,1392
"13818",240480,1996,1,0,"UNIVERSITY OF WISCONSIN-STEVENS POINT",NA,NA,1555,806,749,301,97,204,0.253,0.194,0.13,2601,1485
"13819",240480,1997,1,0,"UNIVERSITY OF WISCONSIN-STEVENS POINT",NA,NA,1527,837,690,262,78,184,0.22,0.172,0.113,2790,1445
"13820",240480,1998,1,0,"UNIVERSITY OF WISCONSIN-STEVENS POINT",NA,NA,1503,868,635,310,85,225,0.259,0.206,0.134,2929,1442
"13821",240480,1999,1,0,"UNIVERSITY OF WISCONSIN-STEVENS POINT",NA,NA,1490,849,641,285,99,186,0.219,0.191,0.154,2594,1409
"13822",240480,2000,1,0,"UNIVERSITY OF WISCONSIN-STEVENS POINT",NA,NA,1518,925,593,333,107,226,0.244,0.219,0.18,2594,1438
"13823",240480,2001,1,0,"UNIVERSITY OF WISCONSIN-STEVENS POINT",NA,NA,1505,849,656,297,108,189,0.223,0.197,0.165,2776,1424
"13824",240480,2002,1,0,"UNIVERSITY OF WISCONSIN-STEVENS POINT",NA,NA,1464,806,658,286,109,177,0.22,0.195,0.166,3000,1369
"13825",240480,2003,1,0,"UNIVERSITY OF WISCONSIN-STEVENS POINT",NA,NA,1498,853,645,335,101,234,0.274,0.224,0.157,3500,1403
"13826",240480,2004,1,0,"UNIVERSITY OF WISCONSIN-STEVENS POINT",NA,NA,1525,857,668,322,118,204,0.238,0.211,0.177,4000,1413
"13827",240480,2005,1,0,"University of Wisconsin-Stevens Point",NA,NA,1521,832,689,365,136,229,0.275,0.24,0.197,4277,1414
"13828",240480,2006,1,0,"University of Wisconsin-Stevens Point",NA,NA,1640,888,752,395,153,242,0.272,0.241,0.203,4568,1529
"13829",240480,2007,1,0,"University of Wisconsin-Stevens Point",NA,NA,1611,892,719,358,145,213,0.239,0.222,0.202,4819,1458
"13830",240480,2008,1,0,"University of Wisconsin-Stevens Point",NA,NA,1608,882,726,412,145,267,0.303,0.256,0.2,5084,1441
"13831",240480,2009,1,0,"University of Wisconsin-Stevens Point",NA,NA,1632,835,797,422,156,266,0.319,0.259,0.196,5364,1454
"13832",240480,2010,1,0,"University of Wisconsin-Stevens Point",NA,NA,1644,881,763,499,213,286,0.325,0.304,0.279,5659,1479
"13833",240727,1991,1,0,"UNIVERSITY OF WYOMING",NA,NA,1257,534,723,174,73,101,0.189,0.138,0.101,1293,1105
"13834",240727,1992,1,0,"UNIVERSITY OF WYOMING",NA,NA,1281,640,641,221,73,148,0.231,0.173,0.114,1430,1134
"13835",240727,1993,1,0,"UNIVERSITY OF WYOMING",NA,NA,1212,560,652,207,79,128,0.229,0.171,0.121,1648,1080
"13836",240727,1995,1,0,"UNIVERSITY OF WYOMING",NA,NA,1267,661,606,276,88,188,0.284,0.218,0.145,2005,1076
"13837",240727,1996,1,0,"UNIVERSITY OF WYOMING",NA,NA,1203,628,575,297,101,196,0.312,0.247,0.176,2144,1035
"13838",240727,1997,1,0,"UNIVERSITY OF WYOMING",NA,NA,1119,562,557,276,97,179,0.318,0.247,0.174,2326,956
"13839",240727,1998,1,0,"UNIVERSITY OF WYOMING",NA,NA,1225,660,565,306,104,202,0.306,0.25,0.184,2330,1042
"13840",240727,1999,1,0,"UNIVERSITY OF WYOMING",NA,NA,1194,654,540,352,124,228,0.349,0.295,0.23,2016,1042
"13841",240727,2000,1,0,"UNIVERSITY OF WYOMING",NA,NA,1313,658,655,337,126,211,0.321,0.257,0.192,2166,1138
"13842",240727,2001,1,0,"UNIVERSITY OF WYOMING",NA,NA,1411,724,687,369,135,234,0.323,0.262,0.197,2316,1256
"13843",240727,2002,1,0,"UNIVERSITY OF WYOMING",NA,NA,1443,733,710,328,113,215,0.293,0.227,0.159,2400,1284
"13844",240727,2003,1,0,"UNIVERSITY OF WYOMING",NA,NA,1388,709,679,310,102,208,0.293,0.223,0.15,2520,1224
"13845",240727,2004,1,0,"UNIVERSITY OF WYOMING",NA,NA,1496,754,742,336,133,203,0.269,0.225,0.179,2088,1302
"13846",240727,2005,1,0,"University of Wyoming",NA,NA,1399,739,660,320,107,213,0.288,0.229,0.162,2208,1219
"13847",240727,2006,1,0,"University of Wyoming",NA,NA,1543,761,782,359,118,241,0.317,0.233,0.151,2256,1283
"13848",240727,2007,1,0,"University of Wyoming",NA,NA,1614,831,783,389,132,257,0.309,0.241,0.169,2256,1356
"13849",240727,2008,1,0,"University of Wyoming",NA,NA,1674,851,823,408,148,260,0.306,0.244,0.18,2256,1406
"13850",240727,2009,1,0,"University of Wyoming",NA,NA,1568,799,769,405,136,269,0.337,0.258,0.177,2256,1331
"13851",240727,2010,1,0,"University of Wyoming",NA,NA,1451,711,740,386,144,242,0.34,0.266,0.195,2376,1210
"13852",243443,1991,1,0,"UNIVERSITY OF SACRED HEART",NA,NA,518,370,148,1,0,1,0.003,0.002,0,2795,0
"13853",243443,1992,1,0,"UNIVERSITY OF SACRED HEART",NA,NA,584,396,188,47,7,40,0.101,0.08,0.037,3245,0
"13854",243443,1993,1,0,"UNIVERSITY OF SACRED HEART",NA,NA,796,541,255,44,8,36,0.066,0.055,0.031,3245,0
"13855",243443,1995,1,0,"UNIVERSITY OF SACRED HEART",NA,NA,728,466,262,33,8,25,0.054,0.045,0.031,3745,0
"13856",243443,1996,1,0,"UNIVERSITY OF SACRED HEART",NA,NA,780,483,297,46,11,35,0.072,0.059,0.037,3800,0
"13857",243443,1997,1,0,"UNIVERSITY OF SACRED HEART",NA,NA,723,471,252,50,6,44,0.093,0.069,0.024,4000,0
"13858",243443,1998,1,0,"UNIVERSITY OF SACRED HEART",NA,NA,885,567,318,76,10,66,0.116,0.086,0.031,4000,0
"13859",243443,1999,1,0,"UNIVERSITY OF SACRED HEART",NA,NA,799,506,293,63,13,50,0.099,0.079,0.044,3900,0
"13860",243443,2000,1,0,"UNIVERSITY OF SACRED HEART",NA,NA,540,350,190,59,10,49,0.14,0.109,0.053,4050,0
"13861",243443,2001,1,0,"UNIVERSITY OF SACRED HEART",NA,NA,478,333,145,52,7,45,0.135,0.109,0.048,4200,0
"13862",243443,2002,1,0,"UNIVERSITY OF SACRED HEART",NA,NA,496,320,176,43,8,35,0.109,0.087,0.045,4200,0
"13863",243443,2003,1,0,"UNIVERSITY OF SACRED HEART",NA,NA,425,274,151,10,3,7,0.025,0.024,0.02,4350,0
"13864",243443,2004,1,0,"UNIVERSITY OF SACRED HEART",NA,NA,519,340,179,50,11,39,0.115,0.096,0.061,4350,0
"13865",243443,2005,1,0,"University of Sacred Heart",NA,NA,796,500,296,66,8,58,0.116,0.083,0.027,4500,0
"13866",243443,2006,1,0,"University of Sacred Heart",NA,NA,764,532,232,66,13,53,0.1,0.086,0.056,4650,0
"13867",243443,2007,1,0,"University of Sacred Heart",NA,NA,690,422,268,41,10,31,0.074,0.059,0.037,3840,0
"13868",243443,2008,1,0,"University of Sacred Heart",NA,NA,750,435,315,43,9,34,0.078,0.057,0.029,3960,0
"13869",243443,2009,1,0,"University of Sacred Heart",NA,NA,726,461,265,43,12,31,0.067,0.059,0.045,4080,0
"13870",243443,2010,1,0,"University of Sacred Heart",NA,NA,933,541,392,63,19,44,0.081,0.068,0.048,4200,0
"13871",243780,1991,1,0,"PURDUE UNIVERSITY MAIN CAMPUS",NA,NA,5754,2516,3238,1682,790,892,0.355,0.292,0.244,2324,5057
"13872",243780,1992,1,0,"PURDUE UNIVERSITY MAIN CAMPUS",NA,NA,5583,2396,3187,1589,761,828,0.346,0.285,0.239,2520,4886
"13873",243780,1993,1,0,"PURDUE UNIVERSITY-MAIN CAMPUS",NA,NA,5725,2560,3165,1625,773,852,0.333,0.284,0.244,2696,5059
"13874",243780,1995,1,0,"PURDUE UNIVERSITY-MAIN CAMPUS",NA,NA,6064,2696,3368,1625,786,839,0.311,0.268,0.233,3056,5375
"13875",243780,1996,1,0,"PURDUE UNIVERSITY-MAIN CAMPUS",NA,NA,6339,2713,3626,1843,903,940,0.346,0.291,0.249,3208,5548
"13876",243780,1997,1,0,"PURDUE UNIVERSITY-MAIN CAMPUS",NA,NA,6369,2806,3563,1994,953,1041,0.371,0.313,0.267,3352,5521
"13877",243780,1998,1,0,"PURDUE UNIVERSITY-MAIN CAMPUS",NA,NA,6625,2825,3800,2040,998,1042,0.369,0.308,0.263,3532,5820
"13878",243780,1999,1,0,"PURDUE UNIVERSITY-MAIN CAMPUS",NA,NA,6895,2945,3950,2083,974,1109,0.377,0.302,0.247,3409,5965
"13879",243780,2000,1,0,"PURDUE UNIVERSITY-MAIN CAMPUS",NA,NA,6403,2646,3757,2209,1046,1163,0.44,0.345,0.278,3552,5548
"13880",243780,2001,1,0,"PURDUE UNIVERSITY-MAIN CAMPUS",NA,NA,6567,2601,3966,2218,1059,1159,0.446,0.338,0.267,3830,5611
"13881",243780,2002,1,0,"PURDUE UNIVERSITY-MAIN CAMPUS",NA,NA,6294,2535,3759,2230,1046,1184,0.467,0.354,0.278,5228,5139
"13882",243780,2003,1,0,"PURDUE UNIVERSITY-MAIN CAMPUS",NA,NA,6459,2559,3900,2254,1121,1133,0.443,0.349,0.287,5498,5345
"13883",243780,2004,1,0,"PURDUE UNIVERSITY-MAIN CAMPUS",NA,NA,6766,2781,3985,2419,1066,1353,0.486,0.358,0.268,5962,5604
"13884",243780,2005,1,0,"Purdue University-Main Campus",NA,NA,7167,2860,4307,2547,1189,1358,0.475,0.355,0.276,6320,5851
"13885",243780,2006,1,0,"Purdue University-Main Campus",NA,NA,7430,3019,4411,2764,1350,1414,0.468,0.372,0.306,6700,5954
"13886",243780,2007,1,0,"Purdue University-Main Campus",NA,NA,6830,2882,3948,2702,1260,1442,0.5,0.396,0.319,7002,5431
"13887",243780,2008,1,0,"Purdue University-Main Campus",NA,NA,7058,3083,3975,3028,1409,1619,0.525,0.429,0.354,7317,5628
"13888",243780,2009,1,0,"Purdue University-Main Campus",NA,NA,6308,2660,3648,2868,1412,1456,0.547,0.455,0.387,8183,4560
"13889",243780,2010,1,0,"Purdue University-Main Campus",NA,NA,6454,2706,3748,3133,1579,1554,0.574,0.485,0.421,8592,4593
